"","time_point","participant","RPRE","kmeans_group","acceptance","emotion_experience_group","VPOST","APOST","FPOST","DPOST","VPRE","APRE","FPRE","DPRE","reward_given","RPE","VPE","APE","FPE","DPE"
"1","1",1,6,1,0,1,-221,56,-3,1,140,146,2,2,0,-6,-361,-90,-5,-1
"2","1",395,8,3,0,1,204,35,3,3,181,75,-2,3,0,-8,23,-40,5,0
"3","1",318,1,2,0,2,-213,-66,-4,-4,204,-201,0,2,0,-1,-417,135,-4,-6
"4","1",241,1,4,1,2,-168,-24,-2,-4,174,172,2,0,0,-1,-342,-196,-4,-4
"5","1",165,2,1,0,1,-161,-3,-3,-3,124,84,1,1,0,-2,-285,-87,-4,-4
"6","1",460,3,1,0,0,-193,-45,-4,-2,205,77,-2,3,0,-3,-398,-122,-2,-5
"7","1",307,6,4,1,2,-234,93,-3,1,-60,53,-1,-2,0,-6,-174,40,-2,3
"8","1",230,7,1,0,0,-234,56,-3,2,-68,16,-2,2,0,-7,-166,40,-1,0
"9","1",98,1,3,0,0,-224,40,-4,-4,104,-159,1,1,0,-1,-328,199,-5,-5
"10","1",154,5,4,0,3,-19,23,0,0,44,107,0,0,0,-5,-63,-84,0,0
"11","1",297,9,3,0,2,201,196,4,4,80,105,3,3,0,-9,121,91,1,1
"12","1",223,5,1,0,1,-157,-1,-1,0,165,0,-1,0,0,-5,-322,-1,0,0
"13","1",22,5,3,0,1,6,-6,0,0,237,-16,1,1,0,-5,-231,10,-1,-1
"14","1",143,6,1,0,3,210,18,1,1,185,0,3,3,0,-6,25,18,-2,-2
"15","1",362,1,4,1,3,-175,166,4,-4,129,122,-3,-4,0,-1,-304,44,7,0
"16","1",212,4,1,1,1,101,44,0,-1,60,26,2,-1,0,-4,41,18,-2,0
"17","1",209,3,4,1,3,-205,1,-1,-2,209,-2,3,3,0,-3,-414,3,-4,-5
"18","1",132,3,4,1,1,56,28,-1,-2,-2,149,1,2,0,-3,58,-121,-2,-4
"19","1",428,1,1,0,0,-239,241,-4,-4,195,163,3,-3,0,-1,-434,78,-7,-1
"20","1",351,1,1,0,0,-244,-244,-4,-4,132,119,-4,-4,0,-1,-376,-363,0,0
"21","1",199,1,4,0,2,-208,204,-4,-4,139,110,1,1,0,-1,-347,94,-5,-5
"22","1",65,8,1,0,3,-48,82,-1,3,90,98,1,2,0,-8,-138,-16,-2,1
"23","1",121,1,1,0,0,-238,242,-4,-4,238,-235,4,-4,0,-1,-476,477,-8,0
"24","1",340,4,1,0,1,-118,1,0,-1,71,12,0,0,0,-4,-189,-11,0,-1
"25","1",264,1,4,0,2,-245,-74,-4,-4,232,241,0,-2,0,-1,-477,-315,-4,-2
"26","1",114,2,4,1,1,-237,-245,-2,-3,120,103,0,-3,0,-2,-357,-348,-2,0
"27","1",110,2,1,0,1,-96,91,-3,-3,167,138,3,3,0,-2,-263,-47,-6,-6
"28","1",33,6,3,1,1,-239,-14,-4,1,15,-239,-3,1,0,-6,-254,225,-1,0
"29","1",257,1,1,0,0,-227,-237,-4,-4,184,192,3,-4,0,-1,-411,-429,-7,0
"30","1",253,9,3,0,3,-21,1,4,4,216,216,4,4,0,-9,-237,-215,0,0
"31","1",10,4,3,0,1,1,-17,-1,-1,-109,3,-1,-1,0,-4,110,-20,0,0
"32","1",396,1,1,0,1,-240,196,4,-4,70,-81,-2,2,0,-1,-310,277,6,-6
"33","1",319,2,1,0,1,-231,0,3,-3,57,98,2,1,0,-2,-288,-98,1,-4
"34","1",242,3,4,0,2,-195,44,-1,-2,89,0,2,0,0,-3,-284,44,-3,-2
"35","1",166,1,4,1,2,-216,210,-3,-4,169,193,0,0,0,-1,-385,17,-3,-4
"36","1",461,4,4,0,2,74,31,1,-1,179,48,-3,-4,0,-4,-105,-17,4,3
"37","1",308,5,4,0,0,-222,-111,-4,0,116,97,0,1,0,-5,-338,-208,-4,-1
"38","1",231,5,4,0,0,-241,6,-4,0,63,120,0,0,0,-5,-304,-114,-4,0
"39","1",99,5,4,1,3,0,8,0,0,225,-19,4,4,0,-5,-225,27,-4,-4
"40","1",155,5,2,0,1,3,0,0,0,-2,-15,0,0,0,-5,5,15,0,0
"41","1",298,1,1,0,0,-245,14,-2,-4,225,25,1,2,0,-1,-470,-11,-3,-6
"42","1",224,3,2,0,2,-154,-73,-2,-2,140,90,2,1,0,-3,-294,-163,-4,-3
"43","1",220,1,4,0,2,-236,226,-4,-4,128,102,-2,-2,0,-1,-364,124,-2,-2
"44","1",144,3,3,0,0,-19,-232,-1,-2,250,248,3,1,0,-3,-269,-480,-4,-3
"45","1",363,2,3,1,3,-250,2,-3,-3,249,0,3,3,0,-2,-499,2,-6,-6
"46","1",213,3,2,0,1,-115,0,-2,-2,-2,117,1,1,0,-3,-113,-117,-3,-3
"47","1",21,2,4,0,2,-109,-89,-3,-3,87,119,3,2,0,-2,-196,-208,-6,-5
"48","1",133,3,2,0,1,-198,-32,0,-2,194,17,2,-1,0,-3,-392,-49,-2,-1
"49","1",429,1,2,0,0,-232,-208,-4,-4,90,46,0,-4,0,-1,-322,-254,-4,0
"50","1",352,5,2,0,1,7,-9,0,0,10,-9,0,0,0,-5,-3,0,0,0
"51","1",2,7,4,1,1,-9,-54,0,2,-68,-76,-1,0,0,-7,59,22,1,2
"52","1",66,5,1,0,1,-235,1,-1,0,171,1,3,1,0,-5,-406,0,-4,-1
"53","1",122,1,1,0,0,-200,-221,-4,-4,-235,-241,-4,-4,0,-1,35,20,0,0
"54","1",341,9,1,1,3,127,-12,4,4,233,-32,4,4,0,-9,-106,20,0,0
"55","1",265,4,1,1,3,-236,-29,-3,-1,3,2,0,0,0,-4,-239,-31,-3,-1
"56","1",115,5,3,0,3,0,0,0,0,86,3,0,0,0,-5,-86,-3,0,0
"57","1",111,1,1,0,0,-244,-237,-4,-4,-57,68,-1,0,0,-1,-187,-305,-3,-4
"58","1",330,4,2,0,2,-238,90,0,-1,215,203,2,1,0,-4,-453,-113,-2,-2
"59","1",258,1,3,1,0,-82,6,-3,-4,30,2,2,-2,0,-1,-112,4,-5,-2
"60","1",254,5,2,0,3,-26,-27,-1,0,194,-187,-3,1,0,-5,-220,160,2,-1
"61","1",100,8,4,1,3,189,4,3,3,3,198,2,2,0,-8,186,-194,1,1
"62","1",397,2,4,0,3,139,66,-3,-3,144,126,3,3,0,-2,-5,-60,-6,-6
"63","1",32,1,1,1,1,-236,-23,-4,-4,163,-198,1,-4,0,-1,-399,175,-5,0
"64","1",243,5,2,0,2,0,0,-3,0,249,86,3,4,0,-5,-249,-86,-6,-4
"65","1",167,7,1,0,3,124,-129,2,2,147,-130,2,2,0,-7,-23,1,0,0
"66","1",462,9,3,0,3,0,242,4,4,222,226,-4,-4,0,-9,-222,16,8,8
"67","1",309,3,4,0,2,-199,-70,-2,-2,140,139,3,-1,0,-3,-339,-209,-5,-1
"68","1",232,1,1,0,0,-239,-43,-4,-4,-158,-26,-1,-4,0,-1,-81,-17,-3,0
"69","1",16,1,1,0,0,-243,239,-4,-4,112,-8,2,0,0,-1,-355,247,-6,-4
"70","1",156,4,2,1,1,-118,17,-1,-1,57,3,1,1,0,-4,-175,14,-2,-2
"71","1",299,3,4,1,1,-177,-99,-1,-2,145,172,2,2,0,-3,-322,-271,-3,-4
"72","1",225,1,2,0,2,-209,-5,-4,-4,35,-230,3,4,0,-1,-244,225,-7,-8
"73","1",221,1,4,1,1,-249,0,-4,-4,1,10,1,1,0,-1,-250,-10,-5,-5
"74","1",145,5,1,0,1,189,0,2,0,-45,-116,1,2,0,-5,234,116,1,-2
"75","1",364,5,3,0,1,64,-2,0,0,-106,-4,-1,-1,0,-5,170,2,1,1
"76","1",214,9,1,0,3,103,27,1,4,115,148,1,4,0,-9,-12,-121,0,0
"77","1",210,6,4,1,2,-51,-16,1,1,89,-64,4,0,0,-6,-140,48,-3,1
"78","1",134,1,2,0,2,-227,-2,-1,-4,-137,-6,-1,-4,0,-1,-90,4,0,0
"79","1",43,4,3,1,0,-58,22,1,-1,-4,-3,0,0,0,-4,-54,25,1,-1
"80","1",353,4,2,0,2,213,126,-4,-1,227,-223,-4,0,0,-4,-14,349,0,-1
"81","1",20,3,3,0,0,-230,-230,-4,-2,-45,-26,-1,1,0,-3,-185,-204,-3,-3
"82","1",67,2,1,1,0,-22,8,-3,-3,161,-171,2,2,0,-2,-183,179,-5,-5
"83","1",123,3,4,0,2,-154,-38,-2,-2,32,-90,-1,1,0,-3,-186,52,-1,-3
"84","1",342,3,3,0,1,-204,15,-1,-2,11,-116,1,-1,0,-3,-215,131,-2,-1
"85","1",266,5,1,0,1,-3,0,0,0,68,1,1,1,0,-5,-71,-1,-1,-1
"86","1",116,9,2,0,3,76,-9,4,4,77,-21,1,2,0,-9,-1,12,3,2
"87","1",112,3,4,0,3,-232,2,-1,-2,6,243,3,3,0,-3,-238,-241,-4,-5
"88","1",331,6,1,1,0,-69,163,-3,1,129,-58,0,0,0,-6,-198,221,-3,1
"89","1",259,2,3,0,1,-175,1,4,-3,56,67,0,0,0,-2,-231,-66,4,-3
"90","1",255,3,3,0,1,-111,-141,-2,-2,179,99,2,2,0,-3,-290,-240,-4,-4
"91","1",101,1,3,0,0,-235,236,-4,-4,184,197,-3,-3,0,-1,-419,39,-1,-1
"92","1",398,7,4,0,2,-248,-1,2,2,-209,-107,-1,-1,0,-7,-39,106,3,3
"93","1",320,4,2,0,2,-123,133,-2,-1,13,122,1,2,0,-4,-136,11,-3,-3
"94","1",244,3,4,1,2,-126,-123,-1,-2,200,216,0,-1,0,-3,-326,-339,-1,-1
"95","1",168,7,1,1,3,95,-103,1,2,130,-77,2,2,0,-7,-35,-26,-1,0
"96","1",463,8,4,1,3,-245,-2,-3,3,2,-225,3,-2,0,-8,-247,223,-6,5
"97","1",31,6,1,1,0,78,-46,1,1,-95,-15,-2,-2,0,-6,173,-31,3,3
"98","1",233,4,2,0,2,-153,15,-3,-1,112,34,1,1,0,-4,-265,-19,-4,-2
"99","1",160,8,2,1,0,-169,37,-4,3,4,-234,-2,2,0,-8,-173,271,-2,1
"100","1",157,1,3,1,2,-24,-232,-4,-4,71,56,-2,0,0,-1,-95,-288,-2,-4
"101","1",3,1,3,0,0,-212,-3,-4,-4,-126,134,-4,-4,0,-1,-86,-137,0,0
"102","1",226,1,1,0,0,-34,0,-1,-4,194,2,2,-3,0,-1,-228,-2,-3,-1
"103","1",222,2,1,0,0,-246,3,-4,-3,42,-4,0,0,0,-2,-288,7,-4,-3
"104","1",146,2,2,0,0,-130,-143,-3,-3,-162,-117,-3,-3,0,-2,32,-26,0,0
"105","1",365,5,3,0,1,27,4,0,0,144,0,0,0,0,-5,-117,4,0,0
"106","1",215,5,1,0,0,1,15,0,0,-172,36,-2,-3,0,-5,173,-21,2,3
"107","1",211,3,3,0,1,-239,-238,-4,-2,95,127,-1,-2,0,-3,-334,-365,-3,0
"108","1",135,5,1,0,1,-181,70,-3,0,182,-96,2,2,0,-5,-363,166,-5,-2
"109","1",430,5,2,1,1,24,-34,0,0,212,-124,0,0,0,-5,-188,90,0,0
"110","1",354,3,1,0,0,-203,120,1,-2,229,235,4,4,0,-3,-432,-115,-3,-6
"111","1",200,1,3,0,0,-221,13,-4,-4,240,99,-3,-3,0,-1,-461,-86,-1,-1
"112","1",68,2,4,0,0,-239,1,-4,-3,209,12,2,-2,0,-2,-448,-11,-6,-1
"113","1",124,7,1,0,3,241,4,3,2,250,24,3,2,0,-7,-9,-20,0,0
"114","1",343,4,2,0,2,-38,0,-1,-1,-34,6,-1,-1,0,-4,-4,-6,0,0
"115","1",267,5,3,0,1,-49,-3,0,0,177,32,2,1,0,-5,-226,-35,-2,-1
"116","1",117,1,4,1,2,-250,-4,-4,-4,-103,-1,-1,-1,0,-1,-147,-3,-3,-3
"117","1",113,4,2,1,2,-249,20,0,-1,12,30,2,4,0,-4,-261,-10,-2,-5
"118","1",332,5,1,0,0,-234,40,-2,0,40,12,1,3,0,-5,-274,28,-3,-3
"119","1",26,1,1,0,0,-221,218,-4,-4,43,39,-2,-3,0,-1,-264,179,-2,-1
"120","1",256,5,3,1,1,-1,0,0,0,-1,0,0,0,0,-5,0,0,0,0
"121","1",102,6,4,1,3,101,-125,-4,1,67,-163,4,-1,0,-6,34,38,-8,2
"122","1",399,5,4,1,3,-143,6,-2,0,67,14,0,-1,0,-5,-210,-8,-2,1
"123","1",321,1,1,1,0,-187,-186,-4,-4,96,112,0,0,0,-1,-283,-298,-4,-4
"124","1",245,1,1,0,0,-124,106,-4,-4,79,-10,-2,-3,0,-1,-203,116,-2,-1
"125","1",169,1,3,0,0,-231,226,-4,-4,129,117,-4,-4,0,-1,-360,109,0,0
"126","1",464,6,1,0,1,-17,105,1,1,119,20,1,1,0,-6,-136,85,0,0
"127","1",310,3,4,0,2,-155,2,-2,-2,237,70,2,2,0,-3,-392,-68,-4,-4
"128","1",234,4,3,0,3,99,52,-1,-1,163,58,1,0,0,-4,-64,-6,-2,-1
"129","1",161,1,2,1,2,-245,244,-4,-4,127,101,1,-2,0,-1,-372,143,-5,-2
"130","1",158,2,3,0,0,-241,-31,-3,-3,234,-212,0,-1,0,-2,-475,181,-3,-2
"131","1",30,6,2,1,2,136,-1,1,1,-65,17,-1,1,0,-6,201,-18,2,0
"132","1",227,5,3,0,3,-119,-30,2,0,155,71,2,-1,0,-5,-274,-101,0,1
"133","1",150,5,3,0,1,1,-2,0,0,165,-1,1,1,0,-5,-164,-1,-1,-1
"134","1",147,4,2,1,3,-84,-96,-1,-1,152,186,3,3,0,-4,-236,-282,-4,-4
"135","1",366,4,4,0,3,143,-108,2,-1,211,43,3,3,0,-4,-68,-151,-1,-4
"136","1",216,5,3,0,1,51,5,-1,0,5,0,-2,-1,0,-5,46,5,1,1
"137","1",14,5,3,0,1,-5,1,0,0,226,-17,2,2,0,-5,-231,18,-2,-2
"138","1",136,1,1,0,0,-230,245,-4,-4,213,-215,-3,-2,0,-1,-443,460,-1,-2
"139","1",431,2,3,0,0,-207,95,-3,-3,179,158,-1,0,0,-2,-386,-63,-2,-3
"140","1",355,2,2,0,2,-195,161,-4,-3,27,-38,0,-1,0,-2,-222,199,-4,-2
"141","1",201,1,3,0,1,-62,-2,-3,-4,176,1,2,-2,0,-1,-238,-3,-5,-2
"142","1",69,3,4,0,1,134,19,-1,-2,23,-30,1,1,0,-3,111,49,-2,-3
"143","1",125,2,4,1,0,-52,-40,-3,-3,243,-246,0,-2,0,-2,-295,206,-3,-1
"144","1",344,6,4,1,3,203,-25,2,1,-105,-61,1,2,0,-6,308,36,1,-1
"145","1",268,7,4,1,3,159,75,3,2,141,106,4,4,0,-7,18,-31,-1,-2
"146","1",118,6,3,0,1,-23,17,-1,1,80,28,-1,1,0,-6,-103,-11,0,0
"147","1",337,9,2,0,3,7,-4,4,4,239,-20,4,4,0,-9,-232,16,0,0
"148","1",333,6,4,1,1,130,-109,2,1,-148,91,2,1,0,-6,278,-200,0,0
"149","1",260,3,3,1,0,-195,-200,-3,-2,25,24,-1,1,0,-3,-220,-224,-2,-3
"150","1",107,8,2,1,3,-96,37,1,3,137,-113,3,-1,0,-8,-233,150,-2,4
"151","1",103,7,2,1,3,81,-1,1,2,5,6,1,1,0,-7,76,-7,0,1
"152","1",4,3,3,0,1,-240,10,-3,-2,-226,221,3,3,0,-3,-14,-211,-6,-5
"153","1",322,5,4,0,3,-3,-1,0,0,142,-133,2,1,0,-5,-145,132,-2,-1
"154","1",246,6,4,0,3,118,-3,3,1,168,2,2,-1,0,-6,-50,-5,1,2
"155","1",17,1,3,0,0,-203,2,-3,-4,111,79,-1,-4,0,-1,-314,-77,-2,0
"156","1",465,8,4,1,3,208,-22,3,3,23,-240,3,3,0,-8,185,218,0,0
"157","1",311,1,2,0,2,7,-8,-4,-4,200,64,3,-4,0,-1,-193,-72,-7,0
"158","1",235,4,3,0,0,-244,-230,-4,-1,-244,2,-1,-1,0,-4,0,-232,-3,0
"159","1",162,9,3,0,3,-205,103,-3,4,140,125,2,2,0,-9,-345,-22,-5,2
"160","1",159,1,3,0,2,-248,10,-4,-4,241,2,4,4,0,-1,-489,8,-8,-8
"161","1",300,3,1,0,0,-118,23,-1,-2,23,27,1,2,0,-3,-141,-4,-2,-4
"162","1",228,5,4,0,2,-111,-168,-3,0,104,131,4,3,0,-5,-215,-299,-7,-3
"163","1",151,1,2,0,1,-247,9,4,-4,-152,3,4,-4,0,-1,-95,6,0,0
"164","1",148,2,1,0,1,-246,-96,0,-3,-72,64,1,-2,0,-2,-174,-160,-1,-1
"165","1",367,4,3,0,1,-143,-54,3,-1,-43,-51,2,-1,0,-4,-100,-3,1,0
"166","1",217,2,4,0,2,-69,30,-1,-3,-38,25,-1,-3,0,-2,-31,5,0,0
"167","1",140,3,1,0,1,-11,21,-1,-2,52,3,0,-1,0,-3,-63,18,-1,-1
"168","1",137,8,1,0,1,-221,-79,-3,3,140,69,3,3,0,-8,-361,-148,-6,0
"169","1",432,5,2,0,1,-3,1,0,0,-1,8,0,0,0,-5,-2,-7,0,0
"170","1",356,2,4,0,1,-150,3,-2,-3,114,19,1,-1,0,-2,-264,-16,-3,-2
"171","1",202,4,1,0,1,-13,40,3,-1,-43,83,2,1,0,-4,30,-43,1,-2
"172","1",7,1,1,0,3,149,13,2,-4,25,63,-2,1,0,-1,124,-50,4,-5
"173","1",126,3,2,1,2,-3,-4,-2,-2,87,163,-1,-1,0,-3,-90,-167,-1,-1
"174","1",345,1,1,0,0,-245,245,-4,-4,-4,-114,-2,-3,0,-1,-241,359,-2,-1
"175","1",269,3,4,1,2,-250,151,1,-2,249,45,0,0,0,-3,-499,106,1,-2
"176","1",119,3,3,1,3,-218,97,-2,-2,152,201,3,3,0,-3,-370,-104,-5,-5
"177","1",338,9,3,0,2,236,242,4,4,234,239,-4,-4,0,-9,2,3,8,8
"178","1",334,1,4,1,0,-249,239,-4,-4,114,-140,-4,-4,0,-1,-363,379,0,0
"179","1",261,8,1,1,3,202,177,4,3,224,230,2,4,0,-8,-22,-53,2,-1
"180","1",108,9,2,1,3,234,17,4,4,219,34,4,4,0,-9,15,-17,0,0
"181","1",104,1,1,0,0,-244,3,3,-4,240,3,2,-3,0,-1,-484,0,1,-1
"182","1",40,5,1,1,2,-123,45,4,0,241,39,4,0,0,-5,-364,6,0,0
"183","1",323,5,4,0,1,129,-4,0,0,35,-2,0,0,0,-5,94,-2,0,0
"184","1",247,3,3,0,0,-227,-4,-2,-2,182,-16,1,1,0,-3,-409,12,-3,-3
"185","1",170,1,2,0,0,-236,-231,-4,-4,22,27,0,0,0,-1,-258,-258,-4,-4
"186","1",466,4,3,0,0,-119,-76,-1,-1,81,-109,3,3,0,-4,-200,33,-4,-4
"187","1",312,5,4,0,1,-3,0,0,0,133,93,0,0,0,-5,-136,-93,0,0
"188","1",236,5,1,0,1,9,-9,0,0,19,-22,0,0,0,-5,-10,13,0,0
"189","1",163,5,3,1,1,-73,16,2,0,133,-3,1,3,0,-5,-206,19,1,-3
"190","1",305,5,4,1,3,-126,-140,0,0,111,137,3,3,0,-5,-237,-277,-3,-3
"191","1",301,4,4,1,1,-213,-1,-1,-1,186,1,2,2,0,-4,-399,-2,-3,-3
"192","1",229,2,1,0,1,-240,242,-3,-3,-109,55,-1,-1,0,-2,-131,187,-2,-2
"193","1",152,3,1,0,0,1,-3,0,-2,0,-3,0,-2,0,-3,1,0,0,0
"194","1",149,6,3,0,1,-237,36,-3,1,193,0,0,2,0,-6,-430,36,-3,-1
"195","1",368,1,3,0,3,150,-121,-4,-4,-103,176,4,4,0,-1,253,-297,-8,-8
"196","1",218,8,4,1,3,-69,-51,3,3,78,51,2,1,0,-8,-147,-102,1,2
"197","1",141,1,1,0,0,-246,-8,-4,-4,176,15,2,2,0,-1,-422,-23,-6,-6
"198","1",138,5,3,0,1,168,-10,0,0,145,-27,1,1,0,-5,23,17,-1,-1
"199","1",433,1,1,0,0,-183,-211,-4,-4,171,171,3,-3,0,-1,-354,-382,-7,-1
"200","1",357,3,4,0,2,-211,-57,4,-2,119,137,0,4,0,-3,-330,-194,4,-6
"201","1",203,4,4,1,3,-233,15,-4,-1,-12,238,4,4,0,-4,-221,-223,-8,-5
"202","1",70,1,2,0,2,-141,-69,0,-4,211,211,3,-3,0,-1,-352,-280,-3,-1
"203","1",127,1,1,0,0,-235,-2,-4,-4,204,195,0,0,0,-1,-439,-197,-4,-4
"204","1",346,8,3,0,0,-245,1,0,3,241,91,1,3,0,-8,-486,-90,-1,0
"205","1",27,5,2,0,2,-34,-15,0,0,14,-24,0,0,0,-5,-48,9,0,0
"206","1",12,9,4,0,3,-2,3,4,4,-1,-1,4,4,0,-9,-1,4,0,0
"207","1",339,4,3,0,1,103,88,-1,-1,133,148,1,2,0,-4,-30,-60,-2,-3
"208","1",335,3,2,0,1,-227,-82,2,-2,-43,22,1,-1,0,-3,-184,-104,1,-1
"209","1",262,7,4,1,3,208,-12,2,2,44,-5,0,0,0,-7,164,-7,2,2
"210","1",109,2,1,0,1,-3,-200,1,-3,-2,-205,2,-3,0,-2,-1,5,-1,0
"211","1",105,3,1,0,0,-214,25,-4,-2,223,37,-2,1,0,-3,-437,-12,-2,-3
"212","1",400,4,4,0,2,-68,60,-1,-1,160,32,3,3,0,-4,-228,28,-4,-4
"213","1",324,1,2,0,0,-236,-2,-4,-4,1,5,0,0,0,-1,-237,-7,-4,-4
"214","1",248,5,4,1,3,7,6,0,0,216,118,1,0,0,-5,-209,-112,-1,0
"215","1",171,5,1,0,1,27,3,0,0,7,22,0,0,0,-5,20,-19,0,0
"216","1",467,5,1,0,3,163,132,3,0,144,191,4,0,0,-5,19,-59,-1,0
"217","1",313,1,3,0,0,-247,-242,-4,-4,233,231,4,4,0,-1,-480,-473,-8,-8
"218","1",237,4,2,0,2,-250,50,-4,-1,85,0,0,1,0,-4,-335,50,-4,-2
"219","1",164,4,2,0,2,-20,1,-1,-1,55,44,1,1,0,-4,-75,-43,-2,-2
"220","1",306,5,3,0,3,116,109,1,0,69,51,1,0,0,-5,47,58,0,0
"221","1",302,3,1,0,0,-142,-18,-3,-2,239,241,-4,-2,0,-3,-381,-259,1,0
"222","1",23,1,1,1,3,202,184,4,-4,187,165,4,-4,0,-1,15,19,0,0
"223","1",153,7,1,0,3,-74,81,2,2,-72,-84,1,0,0,-7,-2,165,1,2
"224","1",15,7,4,0,3,90,-5,1,2,73,49,2,3,0,-7,17,-54,-1,-1
"225","1",369,4,4,0,0,-27,1,0,-1,114,-2,2,2,0,-4,-141,3,-2,-3
"226","1",219,4,4,0,3,249,1,4,-1,249,3,4,-2,0,-4,0,-2,0,1
"227","1",142,5,2,0,2,-17,-35,2,0,53,-145,1,0,0,-5,-70,110,1,0
"228","1",139,1,4,1,2,-243,-6,-4,-4,-3,213,4,4,0,-1,-240,-219,-8,-8
"229","1",434,7,4,1,3,-238,-9,2,2,220,-2,2,4,0,-7,-458,-7,0,-2
"230","1",358,1,4,0,2,-242,67,-4,-4,223,46,0,0,0,-1,-465,21,-4,-4
"231","1",204,4,3,0,1,-119,173,-4,-1,133,-103,1,0,0,-4,-252,276,-5,-1
"232","1",71,4,3,0,1,-97,27,1,-1,21,24,-1,0,0,-4,-118,3,2,-1
"233","1",128,5,1,0,3,-32,8,0,0,169,-193,3,1,0,-5,-201,201,-3,-1
"234","1",347,5,1,0,3,-146,111,-4,0,113,142,2,3,0,-5,-259,-31,-6,-3
"235","1",270,5,3,0,1,-1,-2,0,0,202,1,3,3,0,-5,-203,-3,-3,-3
"236","1",120,4,3,0,1,-80,-69,-1,-1,-79,-141,-1,-1,0,-4,-1,72,0,0
"237","1",34,4,4,0,2,-32,26,1,-1,-21,17,-1,-2,0,-4,-11,9,2,1
"238","1",336,3,4,0,3,150,151,2,-2,183,129,3,-2,0,-3,-33,22,-1,0
"239","1",263,3,4,1,0,-185,-1,-3,-2,0,-3,-1,-1,0,-3,-185,2,-2,-1
"240","1",11,5,4,0,1,-1,-3,0,0,110,44,1,1,0,-5,-111,-47,-1,-1
"241","1",106,6,2,0,1,-68,9,1,1,-69,29,1,1,0,-6,1,-20,0,0
"242","1",401,4,2,0,1,-48,1,0,-1,98,53,1,0,0,-4,-146,-52,-1,-1
"243","1",325,9,1,0,1,-11,-12,0,4,207,196,4,4,0,-9,-218,-208,-4,0
"244","1",249,1,3,1,0,-208,-179,-3,-4,148,-39,4,-2,0,-1,-356,-140,-7,-2
"245","1",172,1,2,1,3,-220,216,-4,-4,197,183,4,4,0,-1,-417,33,-8,-8
"246","1",468,6,1,0,3,-116,-41,0,1,88,82,2,1,0,-6,-204,-123,-2,0
"247","1",314,1,4,1,1,-244,10,4,-4,-239,7,4,-4,0,-1,-5,3,0,0
"248","1",238,1,3,0,1,-154,99,1,-4,113,84,1,1,0,-1,-267,15,0,-5
"249","1",388,4,4,1,0,63,249,-4,-1,242,-4,4,3,0,-4,-179,253,-8,-4
"250","1",384,1,1,0,0,-230,-224,4,-4,125,124,-2,-4,0,-1,-355,-348,6,0
"251","1",303,2,3,0,2,-190,-40,-3,-3,-24,-39,-1,-1,0,-2,-166,-1,-2,-2
"252","1",380,6,4,0,1,-34,-174,3,1,-173,36,2,-3,0,-6,139,-210,1,4
"253","1",377,5,1,0,0,-243,7,-4,0,-36,14,-4,-4,0,-5,-207,-7,0,4
"254","1",373,5,3,0,0,232,213,3,0,220,211,4,1,0,-5,12,2,-1,-1
"255","1",37,2,1,0,0,-132,-53,-2,-3,-1,-47,-2,-3,0,-2,-131,-6,0,0
"256","1",90,1,4,0,0,-239,2,-4,-4,0,7,0,0,0,-1,-239,-5,-4,-4
"257","1",87,9,4,1,3,-2,-249,4,4,-1,-249,4,4,0,-9,-1,0,0,0
"258","1",439,1,2,1,1,0,-245,-4,-4,40,-3,1,1,0,-1,-40,-242,-5,-5
"259","1",435,4,4,0,1,-117,-30,-1,-1,-65,24,0,0,0,-4,-52,-54,-1,-1
"260","1",359,3,4,0,3,-119,-111,3,-2,161,190,4,4,0,-3,-280,-301,-1,-6
"261","1",205,1,1,0,2,-155,6,-2,-4,249,4,4,3,0,-1,-404,2,-6,-7
"262","1",72,3,1,1,0,-228,33,-2,-2,134,154,2,2,0,-3,-362,-121,-4,-4
"263","1",129,5,4,1,1,9,-5,0,0,185,19,3,2,0,-5,-176,-24,-3,-2
"264","1",348,3,3,0,1,-119,-3,0,-2,156,132,0,-1,0,-3,-275,-135,0,-1
"265","1",271,3,3,0,1,-230,-1,-2,-2,220,-1,4,4,0,-3,-450,0,-6,-6
"266","1",420,5,4,1,3,-174,-2,-1,0,2,54,1,2,0,-5,-176,-56,-2,-2
"267","1",417,4,2,0,2,-70,-75,-2,-1,-140,-141,-3,-3,0,-4,70,66,1,2
"268","1",195,1,1,0,1,-250,249,4,-4,15,-19,2,0,0,-1,-265,268,2,-4
"269","1",191,3,1,0,0,-189,23,-2,-2,115,33,1,1,0,-3,-304,-10,-3,-3
"270","1",188,8,2,1,3,150,7,3,3,125,0,2,3,0,-8,25,7,1,0
"271","1",406,2,2,0,2,-188,-94,-1,-3,76,22,2,1,0,-2,-264,-116,-3,-4
"272","1",402,1,3,0,0,-244,-2,-4,-4,-192,2,-2,-2,0,-1,-52,-4,-2,-2
"273","1",326,2,4,1,2,-199,-197,-3,-3,144,111,2,2,0,-2,-343,-308,-5,-5
"274","1",25,6,4,0,2,4,-6,1,1,4,2,0,-1,0,-6,0,-8,1,2
"275","1",173,5,4,0,3,-218,6,-1,0,220,69,4,4,0,-5,-438,-63,-5,-4
"276","1",469,2,4,0,0,-149,0,-2,-3,139,147,-1,-1,0,-2,-288,-147,-1,-2
"277","1",315,9,3,1,3,0,0,4,4,242,25,4,4,0,-9,-242,-25,0,0
"278","1",239,4,1,0,1,-225,6,-1,-1,246,2,4,4,0,-4,-471,4,-5,-5
"279","1",389,5,3,0,2,-166,-61,0,0,116,-73,0,0,0,-5,-282,12,0,0
"280","1",385,6,4,0,1,-109,-187,-2,1,163,100,4,-2,0,-6,-272,-287,-6,3
"281","1",304,1,2,0,2,-224,-15,-4,-4,179,36,2,2,0,-1,-403,-51,-6,-6
"282","1",381,1,2,0,2,-248,-1,-4,-4,85,68,0,-4,0,-1,-333,-69,-4,0
"283","1",378,1,4,1,1,124,-2,-4,-4,131,17,2,2,0,-1,-7,-19,-6,-6
"284","1",374,5,4,0,2,5,8,0,0,21,39,0,0,0,-5,-16,-31,0,0
"285","1",370,1,1,0,3,-237,-17,-4,-4,241,-8,0,-4,0,-1,-478,-9,-4,0
"286","1",91,4,2,1,3,-19,1,-1,-1,7,-5,2,1,0,-4,-26,6,-3,-2
"287","1",88,2,4,0,2,-239,-18,-2,-3,223,227,3,3,0,-2,-462,-245,-5,-6
"288","1",44,1,2,0,2,-227,226,-2,-4,239,-234,0,-3,0,-1,-466,460,-2,-1
"289","1",436,1,4,0,3,62,-43,-2,-4,106,-134,2,-2,0,-1,-44,91,-4,-2
"290","1",36,3,3,0,3,-90,203,2,-2,142,168,2,2,0,-3,-232,35,0,-4
"291","1",206,3,4,0,0,155,-45,2,-2,166,72,2,4,0,-3,-11,-117,0,-6
"292","1",73,4,4,1,2,-126,160,4,-1,-121,159,1,-1,0,-4,-5,1,3,0
"293","1",13,6,4,1,1,-170,-125,4,1,182,-107,4,3,0,-6,-352,-18,0,-2
"294","1",349,6,4,1,1,-84,-122,0,1,207,80,1,2,0,-6,-291,-202,-1,-1
"295","1",272,4,4,1,2,64,63,0,-1,73,69,-1,-1,0,-4,-9,-6,1,0
"296","1",421,8,3,0,1,-189,-76,-2,3,101,100,-1,-1,0,-8,-290,-176,-1,4
"297","1",418,2,2,1,2,-182,90,-2,-3,135,85,-1,-2,0,-2,-317,5,-1,-1
"298","1",196,1,3,0,0,-240,-1,-4,-4,48,77,1,1,0,-1,-288,-78,-5,-5
"299","1",192,3,4,1,1,0,-85,-2,-2,121,-2,1,2,0,-3,-121,-83,-3,-4
"300","1",189,3,1,0,1,-239,30,2,-2,-125,116,2,-2,0,-3,-114,-86,0,0
"301","1",407,1,2,0,2,-190,-31,-4,-4,191,74,2,2,0,-1,-381,-105,-6,-6
"302","1",403,3,1,0,0,-34,-5,0,-2,74,-30,2,1,0,-3,-108,25,-2,-3
"303","1",327,5,4,1,3,141,0,1,0,134,3,1,-1,0,-5,7,-3,0,1
"304","1",250,6,1,0,3,82,22,1,1,46,30,1,1,0,-6,36,-8,0,0
"305","1",174,6,4,0,3,101,30,1,1,106,49,1,1,0,-6,-5,-19,0,0
"306","1",47,8,4,1,3,219,-8,2,3,174,3,4,2,0,-8,45,-11,-2,1
"307","1",316,5,3,0,0,-115,-106,0,0,-119,-129,0,0,0,-5,4,23,0,0
"308","1",24,5,2,0,2,-227,-1,-2,0,241,1,2,4,0,-5,-468,-2,-4,-4
"309","1",39,5,3,1,1,61,56,1,0,115,114,3,2,0,-5,-54,-58,-2,-2
"310","1",386,1,1,0,0,-245,-250,-4,-4,59,38,1,0,0,-1,-304,-288,-5,-4
"311","1",208,1,4,1,2,-207,-191,-4,-4,185,129,2,2,0,-1,-392,-320,-6,-6
"312","1",382,2,4,0,2,-213,4,-2,-3,224,-3,3,2,0,-2,-437,7,-5,-5
"313","1",379,5,3,0,1,-82,-34,2,0,232,111,3,1,0,-5,-314,-145,-1,-1
"314","1",375,4,3,0,1,-48,1,-1,-1,-1,2,0,0,0,-4,-47,-1,-1,-1
"315","1",371,1,3,0,0,-214,-198,-4,-4,106,-195,-1,1,0,-1,-320,-3,-3,-5
"316","1",92,5,4,1,2,-215,-208,-4,0,35,32,1,1,0,-5,-250,-240,-5,-1
"317","1",89,5,3,0,0,96,2,-4,0,-2,-54,-1,-3,0,-5,98,56,-3,3
"318","1",440,4,3,0,0,-104,-35,0,-1,46,2,0,0,0,-4,-150,-37,0,-1
"319","1",437,3,1,0,0,-187,1,-2,-2,-196,-1,-2,-2,0,-3,9,2,0,0
"320","1",360,1,3,0,0,-164,-116,0,-4,220,219,2,-4,0,-1,-384,-335,-2,0
"321","1",207,5,1,0,0,-188,70,-4,0,-1,-248,4,4,0,-5,-187,318,-8,-4
"322","1",74,1,3,0,0,-218,1,-4,-4,68,2,0,0,0,-1,-286,-1,-4,-4
"323","1",130,1,1,0,3,-77,60,4,-4,59,48,-4,-1,0,-1,-136,12,8,-3
"324","1",35,3,1,0,3,110,195,4,-2,200,202,4,-2,0,-3,-90,-7,0,0
"325","1",273,4,1,0,0,-166,4,-1,-1,215,227,4,3,0,-4,-381,-223,-5,-4
"326","1",422,6,3,0,1,-74,-246,4,1,-107,-234,4,-4,0,-6,33,-12,0,5
"327","1",419,7,4,0,3,-55,-98,-2,2,58,77,1,1,0,-7,-113,-175,-3,1
"328","1",197,9,4,1,3,146,-122,0,4,0,1,0,4,0,-9,146,-123,0,0
"329","1",193,2,1,0,0,-195,-203,-4,-3,114,51,3,2,0,-2,-309,-254,-7,-5
"330","1",19,2,2,0,2,-211,-163,1,-3,118,-75,1,-1,0,-2,-329,-88,0,-2
"331","1",408,1,1,0,0,-222,-1,-2,-4,1,1,0,1,0,-1,-223,-2,-2,-5
"332","1",404,4,1,0,1,62,-47,0,-1,66,-70,1,0,0,-4,-4,23,-1,-1
"333","1",328,4,3,0,1,-40,8,-1,-1,21,11,1,1,0,-4,-61,-3,-2,-2
"334","1",251,7,3,0,1,-152,-4,-4,2,183,37,0,-2,0,-7,-335,-41,-4,4
"335","1",175,7,4,0,1,-76,153,1,2,111,110,1,0,0,-7,-187,43,0,2
"336","1",470,4,1,0,1,-93,32,-1,-1,34,58,1,1,0,-4,-127,-26,-2,-2
"337","1",317,4,4,0,2,-111,93,3,-1,153,-27,3,3,0,-4,-264,120,0,-4
"338","1",240,5,2,1,1,197,2,2,0,161,-16,2,-1,0,-5,36,18,0,1
"339","1",390,3,2,0,2,-120,23,-1,-2,117,-174,0,3,0,-3,-237,197,-1,-5
"340","1",387,3,3,1,1,22,48,-1,-2,57,58,2,1,0,-3,-35,-10,-3,-3
"341","1",286,6,1,0,3,90,9,1,1,65,-2,1,1,0,-6,25,11,0,0
"342","1",383,8,4,0,1,2,-249,2,3,-1,1,4,0,0,-8,3,-250,-2,3
"343","1",38,9,4,1,3,7,-3,4,4,9,-2,0,0,0,-9,-2,-1,4,4
"344","1",376,3,4,1,1,-34,-112,-2,-2,36,-95,-2,-2,0,-3,-70,-17,0,0
"345","1",372,5,3,0,0,3,-243,-4,0,221,239,4,2,0,-5,-218,-482,-8,-2
"346","1",93,6,1,0,1,-187,71,-2,1,33,-31,-1,0,0,-6,-220,102,-1,1
"347","1",9,4,4,0,2,-12,-154,-1,-1,55,-28,0,0,0,-4,-67,-126,-1,-1
"348","1",441,2,4,1,2,-143,1,-3,-3,1,-4,0,0,0,-2,-144,5,-3,-3
"349","1",438,8,4,1,3,2,2,0,3,99,-3,4,1,0,-8,-97,5,-4,2
"350","1",361,1,1,0,0,-248,-1,0,-4,247,5,4,4,0,-1,-495,-6,-4,-8
"351","1",41,6,2,0,3,79,51,2,1,73,27,2,1,0,-6,6,24,0,0
"352","1",75,1,4,1,2,-175,33,0,-4,126,149,2,-3,0,-1,-301,-116,-2,-1
"353","1",131,8,4,0,3,-90,21,3,3,37,-8,1,1,0,-8,-127,29,2,2
"354","1",350,9,4,1,1,-246,-6,4,4,249,4,-1,-1,0,-9,-495,-10,5,5
"355","1",274,4,4,0,2,-58,48,-1,-1,127,106,-1,-1,0,-4,-185,-58,0,0
"356","1",423,6,1,1,3,50,-80,4,1,216,-4,2,-1,0,-6,-166,-76,2,2
"357","1",42,5,3,0,1,3,2,2,0,68,2,0,-3,0,-5,-65,0,2,3
"358","1",198,4,1,0,1,-55,-59,-1,-1,-108,62,0,-1,0,-4,53,-121,-1,0
"359","1",194,9,1,0,0,-161,52,-4,4,175,35,0,4,0,-9,-336,17,-4,0
"360","1",190,8,4,1,3,164,215,0,3,142,123,3,3,0,-8,22,92,-3,0
"361","1",409,6,4,0,2,-127,-111,2,1,99,83,1,1,0,-6,-226,-194,1,0
"362","1",405,7,4,0,1,-141,-65,-3,2,95,80,0,-1,0,-7,-236,-145,-3,3
"363","1",329,6,4,1,3,-37,4,1,1,164,16,-1,1,0,-6,-201,-12,2,0
"364","1",252,5,4,1,1,-117,-75,-1,0,134,81,1,1,0,-5,-251,-156,-2,-1
"365","1",176,9,1,0,1,-239,74,-4,4,184,62,1,2,0,-9,-423,12,-5,2
"366","1",471,5,3,0,2,-50,-85,1,0,-75,-172,-2,-1,0,-5,25,87,3,1
"367","1",447,6,4,0,2,117,7,2,1,67,6,2,2,0,-6,50,1,0,-1
"368","1",443,1,1,0,0,-168,-151,-4,-4,96,96,1,1,0,-1,-264,-247,-5,-5
"369","1",391,4,2,1,3,-129,129,-2,-1,175,144,0,1,0,-4,-304,-15,-2,-2
"370","1",290,4,1,0,1,-157,-161,-1,-1,127,142,2,-1,0,-4,-284,-303,-3,0
"371","1",287,1,4,0,3,197,4,4,-4,180,1,4,4,0,-1,17,3,0,-8
"372","1",77,4,3,0,1,-50,-2,-1,-1,-17,7,-1,-1,0,-4,-33,-9,0,0
"373","1",283,6,1,0,1,-134,97,-3,1,147,94,-1,3,0,-6,-281,3,-2,-2
"374","1",457,1,3,1,1,-84,-28,-4,-4,4,-219,2,3,0,-1,-88,191,-6,-7
"375","1",453,3,4,0,2,197,2,-2,-2,192,8,2,-1,0,-3,5,-6,-4,-1
"376","1",94,3,4,0,1,13,-97,0,-2,125,-137,0,-2,0,-3,-112,40,0,0
"377","1",446,5,4,1,1,-237,-17,-3,0,131,125,0,0,0,-5,-368,-142,-3,0
"378","1",442,7,4,0,1,47,41,2,2,91,67,3,3,0,-7,-44,-26,-1,-1
"379","1",293,1,4,0,0,-140,32,-4,-4,-173,19,-4,-4,0,-1,33,13,0,0
"380","1",29,1,4,1,0,-208,242,-4,-4,229,139,-1,-1,0,-1,-437,103,-3,-3
"381","1",410,1,1,0,0,-243,-154,-4,-4,5,4,1,-3,0,-1,-248,-158,-5,-1
"382","1",76,7,4,1,3,42,-3,0,2,12,1,1,1,0,-7,30,-4,-1,1
"383","1",282,9,3,0,3,242,-39,0,4,221,-118,0,4,0,-9,21,79,0,0
"384","1",279,7,4,0,3,29,28,1,2,73,104,2,2,0,-7,-44,-76,-1,0
"385","1",275,2,4,0,2,-236,5,3,-3,-2,-240,2,-3,0,-2,-234,245,1,0
"386","1",424,2,2,0,2,1,4,0,-3,141,82,1,1,0,-2,-140,-78,-1,-4
"387","1",449,3,4,0,3,-163,28,1,-2,-78,75,2,0,0,-3,-85,-47,-1,-2
"388","1",445,6,4,1,3,104,-37,1,1,121,-99,1,1,0,-6,-17,62,0,0
"389","1",393,1,1,0,0,-179,-208,-4,-4,179,-39,3,0,0,-1,-358,-169,-7,-4
"390","1",413,1,1,0,1,-242,-8,-1,-4,-21,0,-1,-2,0,-1,-221,-8,0,-2
"391","1",289,1,1,1,3,-240,-21,-4,-4,168,165,2,0,0,-1,-408,-186,-6,-4
"392","1",58,5,4,1,1,15,-249,0,0,3,242,4,4,0,-5,12,-491,-4,-4
"393","1",184,6,3,0,3,93,4,1,1,85,3,1,1,0,-6,8,1,0,0
"394","1",180,5,2,0,2,-2,-1,0,0,18,8,0,-1,0,-5,-20,-9,0,1
"395","1",177,1,4,1,1,-106,-81,-4,-4,38,198,2,-3,0,-1,-144,-279,-6,-1
"396","1",472,1,1,0,0,-244,15,-4,-4,-62,11,-4,-4,0,-1,-182,4,0,0
"397","1",448,1,2,0,2,-153,-3,-4,-4,230,0,0,0,0,-1,-383,-3,-4,-4
"398","1",444,7,2,0,2,-217,73,-3,2,89,-1,2,2,0,-7,-306,74,-5,0
"399","1",392,4,1,0,0,-101,-67,0,-1,112,39,1,1,0,-4,-213,-106,-1,-2
"400","1",291,1,4,0,2,-248,18,-4,-4,245,3,1,-3,0,-1,-493,15,-5,-1
"401","1",288,3,2,0,2,-250,-4,-3,-2,-126,72,-1,-2,0,-3,-124,-76,-2,0
"402","1",78,3,4,0,0,-175,-197,-2,-2,38,-3,-1,-2,0,-3,-213,-194,-1,0
"403","1",284,2,3,0,1,110,127,-3,-3,104,93,0,-3,0,-2,6,34,-3,0
"404","1",458,2,1,0,1,-31,-25,-1,-3,88,88,-1,-2,0,-2,-119,-113,0,-1
"405","1",454,9,4,1,3,250,1,4,4,108,0,1,1,0,-9,142,1,3,3
"406","1",95,1,4,0,2,-248,-10,-4,-4,2,4,0,0,0,-1,-250,-14,-4,-4
"407","1",450,3,4,1,3,242,1,2,-2,0,234,3,-2,0,-3,242,-233,-1,0
"408","1",83,6,1,0,3,114,-111,2,1,122,-110,2,1,0,-6,-8,-1,0,0
"409","1",294,9,1,0,3,-127,1,-1,4,163,5,2,2,0,-9,-290,-4,-3,2
"410","1",415,4,2,0,2,5,3,0,-1,166,204,0,1,0,-4,-161,-201,0,-2
"411","1",411,2,2,1,2,241,242,-3,-3,239,239,4,4,0,-2,2,3,-7,-7
"412","1",6,1,4,1,2,-134,0,-4,-4,24,-1,-1,-1,0,-1,-158,1,-3,-3
"413","1",186,2,2,1,2,0,-1,0,-3,125,52,0,-2,0,-2,-125,-53,0,-1
"414","1",28,1,4,0,1,-205,64,-4,-4,141,132,3,-1,0,-1,-346,-68,-7,-3
"415","1",276,4,4,0,3,-92,7,-1,-1,-1,5,1,1,0,-4,-91,2,-2,-2
"416","1",425,2,4,1,2,-151,-14,-2,-3,108,25,3,4,0,-2,-259,-39,-5,-7
"417","1",45,1,3,0,0,-198,225,-4,-4,160,153,-2,1,0,-1,-358,72,-2,-5
"418","1",86,7,4,0,3,170,-4,2,2,161,1,2,3,0,-7,9,-5,0,-1
"419","1",394,1,3,1,0,-182,31,-4,-4,132,-1,4,-4,0,-1,-314,32,-8,0
"420","1",414,3,1,0,0,-135,-145,-2,-2,84,67,2,2,0,-3,-219,-212,-4,-4
"421","1",459,1,3,0,1,-16,-179,3,-4,48,-57,1,-2,0,-1,-64,-122,2,-2
"422","1",59,3,1,0,0,-118,141,-2,-2,74,-50,3,3,0,-3,-192,191,-5,-5
"423","1",185,2,4,0,2,-244,-3,-4,-3,230,-181,2,0,0,-2,-474,178,-6,-3
"424","1",181,5,4,0,3,-74,-46,0,0,175,124,2,-1,0,-5,-249,-170,-2,1
"425","1",178,5,1,0,1,-3,-1,0,0,-1,-3,0,0,0,-5,-2,2,0,0
"426","1",473,3,3,1,0,-239,-13,-2,-2,-219,-19,0,-2,0,-3,-20,6,-2,0
"427","1",452,4,3,1,1,-76,3,-1,-1,2,5,1,0,0,-4,-78,-2,-2,-1
"428","1",412,9,1,0,0,-249,145,-4,4,244,12,4,4,0,-9,-493,133,-8,0
"429","1",296,7,1,0,3,2,173,2,2,-1,228,-1,2,0,-7,3,-55,3,0
"430","1",292,6,3,0,1,176,-54,1,1,-1,-168,1,0,0,-6,177,114,0,1
"431","1",280,6,2,0,1,-41,7,-1,1,230,-20,2,4,0,-6,-271,27,-3,-3
"432","1",79,1,4,1,2,202,175,-4,-4,-218,-186,-2,-2,0,-1,420,361,-2,-2
"433","1",285,1,2,0,1,-139,-37,-4,-4,73,89,-1,-4,0,-1,-212,-126,-3,0
"434","1",475,6,3,0,3,141,-153,1,1,61,-51,0,0,0,-6,80,-102,1,1
"435","1",455,8,2,0,2,133,4,3,3,181,-8,-2,2,0,-8,-48,12,5,1
"436","1",96,3,1,0,0,-4,-5,-2,-2,5,-12,0,0,0,-3,-9,7,-2,-2
"437","1",451,3,1,0,0,-174,-102,-2,-2,137,172,0,-3,0,-3,-311,-274,-2,1
"438","1",84,7,4,1,3,220,3,3,2,218,2,3,3,0,-7,2,1,0,-1
"439","1",295,5,1,0,1,-1,-2,0,0,-1,1,0,0,0,-5,0,-3,0,0
"440","1",416,1,4,1,0,-246,242,-4,-4,-152,-131,-4,-4,0,-1,-94,373,0,0
"441","1",182,6,4,1,3,4,-97,-1,1,-214,3,-4,-4,0,-6,218,-100,3,5
"442","1",60,8,1,0,3,223,4,3,3,231,4,3,3,0,-8,-8,0,0,0
"443","1",187,2,4,0,2,94,113,-3,-3,34,67,1,1,0,-2,60,46,-4,-4
"444","1",49,5,4,1,1,7,26,1,0,54,65,2,2,0,-5,-47,-39,-1,-2
"445","1",277,1,4,0,1,-59,74,-4,-4,29,-95,0,0,0,-1,-88,169,-4,-4
"446","1",426,7,4,0,3,-224,3,4,2,176,-2,2,2,0,-7,-400,5,2,0
"447","1",82,6,4,1,2,-238,-10,-4,1,241,8,4,4,0,-6,-479,-18,-8,-3
"448","1",281,1,4,0,2,-232,4,4,-4,-8,235,4,-4,0,-1,-224,-231,0,0
"449","1",8,7,3,0,1,-38,-74,-2,2,46,38,1,1,0,-7,-84,-112,-3,1
"450","1",427,3,4,0,1,-234,-141,4,-2,-145,-66,2,-2,0,-3,-89,-75,2,0
"451","1",46,9,1,0,0,-104,-240,-4,4,225,232,0,-3,0,-9,-329,-472,-4,7
"452","1",80,7,4,0,3,231,0,4,2,237,1,3,3,0,-7,-6,-1,1,-1
"453","1",97,1,1,0,1,-243,-63,4,-4,203,222,0,2,0,-1,-446,-285,4,-6
"454","1",48,1,3,0,0,0,0,-4,-4,95,-89,-4,-4,0,-1,-95,89,0,0
"455","1",179,5,1,0,1,-4,-1,0,0,-4,-1,0,0,0,-5,0,0,0,0
"456","1",474,1,1,0,0,13,-101,-4,-4,21,-125,-2,-4,0,-1,-8,24,-2,0
"457","1",64,1,1,0,1,-235,227,-4,-4,211,-201,3,3,0,-1,-446,428,-7,-7
"458","1",183,1,4,1,1,-179,-23,-2,-4,91,205,0,0,0,-1,-270,-228,-2,-4
"459","1",61,2,1,0,3,-249,30,4,-3,192,-8,4,-3,0,-2,-441,38,0,0
"460","1",53,7,4,1,3,188,5,2,2,208,0,2,2,0,-7,-20,5,0,0
"461","1",5,1,2,0,2,-244,3,-3,-4,-189,11,-3,-4,0,-1,-55,-8,0,0
"462","1",278,7,4,0,1,32,33,4,2,0,-1,4,-4,0,-7,32,34,0,6
"463","1",62,4,2,1,3,-242,-218,4,-1,237,240,0,4,0,-4,-479,-458,4,-5
"464","1",476,2,3,0,0,89,-9,-3,-3,140,106,1,1,0,-2,-51,-115,-4,-4
"465","1",456,1,1,0,0,-179,-167,-2,-4,152,190,2,-1,0,-1,-331,-357,-4,-3
"466","1",63,9,4,1,1,-245,-2,4,4,241,1,4,4,0,-9,-486,-3,0,0
"467","1",54,1,4,1,1,-243,-6,-4,-4,231,-12,2,-2,0,-1,-474,6,-6,-2
"468","1",85,5,2,0,2,114,132,2,0,105,-91,2,1,0,-5,9,223,0,-1
"469","1",81,1,1,0,0,-246,86,-4,-4,38,63,1,-2,0,-1,-284,23,-5,-2
"470","1",55,4,4,0,1,-223,7,-1,-1,82,-4,2,2,0,-4,-305,11,-3,-3
"471","1",51,1,4,0,1,-139,-75,-2,-4,138,108,0,-1,0,-1,-277,-183,-2,-3
"472","1",18,4,3,0,1,-92,-28,0,-1,125,24,1,0,0,-4,-217,-52,-1,-1
"473","1",56,4,3,1,1,28,-115,-3,-1,110,-123,-2,0,0,-4,-82,8,-1,-1
"474","1",52,2,3,0,0,-236,1,-2,-3,170,5,2,-1,0,-2,-406,-4,-4,-2
"475","1",50,5,2,0,1,2,-6,0,0,135,-58,0,0,0,-5,-133,52,0,0
"476","1",57,1,4,1,1,-227,241,2,-4,134,-234,-2,0,0,-1,-361,475,4,-4
"477","10",268,8,4,0,3,94,-172,3,3,103,-101,3,3,1,-7,-9,-71,0,0
"478","10",269,1,4,1,2,-250,181,0,-4,-250,145,0,-3,1,0,0,36,0,-1
"479","10",320,1,2,0,2,-245,115,-4,-4,-247,93,-4,-4,1,0,2,22,0,0
"480","10",271,4,3,1,1,112,2,-2,-1,98,-5,4,2,1,-3,14,7,-6,-3
"481","10",318,1,2,0,2,-187,-192,-4,-4,176,189,-4,0,1,0,-363,-381,0,-4
"482","10",27,3,2,0,2,-180,121,-2,-2,-13,210,0,-2,1,-2,-167,-89,-2,0
"483","10",272,4,4,1,2,15,4,-1,-1,14,12,-1,-1,1,-3,1,-8,0,0
"484","10",232,1,1,0,0,-234,-224,-4,-4,-243,-242,-4,-4,1,0,9,18,0,0
"485","10",319,7,1,0,1,114,0,2,2,-161,-6,1,1,1,-6,275,6,1,1
"486","10",395,3,3,1,1,-204,14,3,-2,163,30,-2,3,1,-2,-367,-16,5,-5
"487","10",233,5,2,1,2,-21,44,-3,0,-158,13,0,0,1,-4,137,31,-3,0
"488","10",266,5,1,0,1,-75,4,-2,0,-69,-2,-2,-2,1,-4,-6,6,0,2
"489","10",238,7,3,1,1,-76,-86,-4,2,110,67,2,2,1,-6,-186,-153,-6,0
"490","10",396,1,1,0,1,-250,247,4,-4,-244,243,4,-4,1,0,-6,4,0,0
"491","10",270,3,3,1,1,15,3,1,-2,248,3,4,4,1,-2,-233,0,-3,-6
"492","10",303,2,3,1,2,-204,-215,-3,-3,-184,-185,-3,-3,1,-1,-20,-30,0,0
"493","10",239,7,1,0,1,155,-6,2,2,143,-139,1,1,1,-6,12,133,1,1
"494","10",32,5,1,0,1,2,0,0,0,175,-191,2,-4,1,-4,-173,191,-2,4
"495","10",264,1,4,1,2,-243,-53,-4,-4,-234,-233,-4,-4,1,0,-9,180,0,0
"496","10",24,1,2,0,2,-246,249,0,-4,248,0,0,4,1,0,-494,249,0,-8
"497","10",398,1,4,0,2,-246,248,-3,-4,-213,109,-3,-3,1,0,-33,139,0,-1
"498","10",265,9,1,0,3,212,1,4,4,2,-1,0,0,1,-8,210,2,4,4
"499","10",240,2,2,0,1,195,6,2,-3,209,-214,3,-3,1,-1,-14,220,-1,0
"500","10",273,4,1,0,0,0,-5,-1,-1,-29,-13,1,0,1,-3,29,8,-2,-1
"501","10",321,1,1,0,0,-219,-203,-4,-4,-244,-220,-4,-4,1,0,25,17,0,0
"502","10",306,5,3,1,3,134,118,1,0,142,111,1,0,1,-4,-8,7,0,0
"503","10",241,4,4,1,2,166,46,1,-1,192,183,2,0,1,-3,-26,-137,-1,-1
"504","10",234,5,3,1,3,114,46,-1,0,79,33,0,1,1,-4,35,13,-1,-1
"505","10",267,5,3,1,1,-1,-1,0,0,-1,-1,0,0,1,-4,0,0,0,0
"506","10",460,1,1,0,0,-216,8,-4,-4,221,174,-4,3,1,0,-437,-166,0,-7
"507","10",397,6,4,0,3,156,76,1,1,160,-122,2,2,1,-5,-4,198,-1,-1
"508","10",65,7,1,0,3,72,57,2,2,52,40,1,2,1,-6,20,17,1,0
"509","10",304,3,2,0,2,-41,-42,-2,-2,76,-46,1,1,1,-2,-117,4,-3,-3
"510","10",340,4,1,0,1,-136,-24,0,-1,82,16,0,0,1,-3,-218,-40,0,-1
"511","10",37,1,1,0,0,-227,119,-4,-4,-232,88,-4,-4,1,0,5,31,0,0
"512","10",305,7,4,1,3,43,37,1,2,40,90,1,1,1,-6,3,-53,0,1
"513","10",362,6,4,1,3,88,106,3,1,64,101,3,-3,1,-5,24,5,0,4
"514","10",237,3,2,0,2,-236,48,-2,-2,86,-1,-1,0,1,-2,-322,49,-1,-2
"515","10",245,1,1,0,0,-240,-2,-4,-4,-245,2,-4,-4,1,0,5,-4,0,0
"516","10",8,2,3,0,1,-211,-123,0,-3,-80,82,-2,2,1,-1,-131,-205,2,-5
"517","10",274,5,4,1,2,-115,-25,0,0,-126,23,-1,-1,1,-4,11,-48,1,1
"518","10",322,5,4,1,3,211,-184,0,0,178,-181,2,2,1,-4,33,-3,-2,-2
"519","10",246,8,4,1,3,23,1,3,3,-137,-1,2,3,1,-7,160,2,1,0
"520","10",242,2,4,1,2,-43,-1,-1,-3,181,19,2,-2,1,-1,-224,-20,-3,-1
"521","10",235,1,3,0,0,-242,-238,-4,-4,233,1,4,4,1,0,-475,-239,-8,-8
"522","10",344,7,4,1,3,154,-98,1,2,48,94,0,1,1,-6,106,-192,1,1
"523","10",461,3,4,0,2,8,38,-2,-2,24,20,-3,-3,1,-2,-16,18,1,1
"524","10",236,5,1,0,1,-4,-10,0,0,-17,-18,0,0,1,-4,13,8,0,0
"525","10",366,7,4,1,3,98,-57,3,2,-113,59,1,2,1,-6,211,-116,2,0
"526","10",33,6,3,1,1,-61,16,-2,1,-124,-17,-2,1,1,-5,63,33,0,0
"527","10",399,4,4,1,3,122,16,-1,-1,104,61,1,-1,1,-3,18,-45,-2,0
"528","10",370,9,1,0,3,232,59,4,4,-237,-18,-4,-4,1,-8,469,77,8,8
"529","10",367,5,3,0,1,-88,-80,1,0,-106,-98,1,0,1,-4,18,18,0,0
"530","10",363,8,3,1,3,249,-48,3,3,250,-1,3,3,1,-7,-1,-47,0,0
"531","10",314,1,4,0,1,-236,11,4,-4,-239,12,4,-4,1,0,3,-1,0,0
"532","10",307,2,4,1,2,-30,190,-3,-3,-211,155,-3,-3,1,-1,181,35,0,0
"533","10",80,6,4,1,3,-151,-1,3,1,197,-1,3,-3,1,-5,-348,0,0,4
"534","10",384,1,1,0,0,-248,246,0,-4,-249,247,-4,-4,1,0,1,-1,4,0
"535","10",30,1,2,1,2,-247,-27,-4,-4,-191,-1,2,4,1,0,-56,-26,-6,-8
"536","10",297,2,3,1,2,-228,21,-3,-3,-240,14,-3,-3,1,-1,12,7,0,0
"537","10",276,7,4,1,3,162,1,2,2,151,1,4,2,1,-6,11,0,-2,0
"538","10",66,6,1,1,1,-109,2,-1,1,-3,-96,-3,-2,1,-5,-106,98,2,3
"539","10",345,8,1,0,0,-229,3,-4,3,-215,3,-4,3,1,-7,-14,0,0,0
"540","10",341,9,1,0,3,249,-37,4,4,250,-45,4,4,1,-8,-1,8,0,0
"541","10",338,2,3,1,2,46,-187,-3,-3,-117,-187,-2,-1,1,-1,163,0,-1,-2
"542","10",31,1,1,0,0,-136,104,-4,-4,-128,106,-4,-4,1,0,-8,-2,0,0
"543","10",330,4,2,0,2,-245,-1,0,-1,193,176,1,1,1,-3,-438,-177,-1,-2
"544","10",76,5,4,1,3,4,1,2,0,4,1,0,0,1,-4,0,0,2,0
"545","10",428,1,1,0,0,-241,243,-4,-4,-239,241,-4,-4,1,0,-2,2,0,0
"546","10",279,6,4,1,3,117,1,2,1,-83,-50,3,1,1,-5,200,51,-1,0
"547","10",275,1,4,0,2,-246,-3,1,-4,4,249,3,-2,1,0,-250,-252,-2,-2
"548","10",323,1,4,1,1,-1,-30,-4,-4,220,-3,0,0,1,0,-221,-27,-4,-4
"549","10",247,5,3,0,0,-201,-1,-2,0,118,-8,0,0,1,-4,-319,7,-2,0
"550","10",243,2,2,0,2,-249,-5,-4,-3,-247,-205,-3,-3,1,-1,-2,200,-1,0
"551","10",337,4,2,0,3,-162,70,-1,-1,221,-25,4,4,1,-3,-383,95,-5,-5
"552","10",309,3,4,1,2,-71,46,-2,-2,57,33,0,-1,1,-2,-128,13,-2,-1
"553","10",462,9,3,1,3,240,25,4,4,227,210,4,4,1,-8,13,-185,0,0
"554","10",386,1,1,0,0,-237,208,-4,-4,20,30,0,-1,1,0,-257,178,-4,-3
"555","10",301,5,4,0,1,2,-108,0,0,51,-4,2,2,1,-4,-49,-104,-2,-2
"556","10",299,7,4,0,1,192,-15,2,2,77,158,2,2,1,-6,115,-173,0,0
"557","10",4,3,3,0,1,216,3,0,-2,193,3,-3,2,1,-2,23,0,3,-4
"558","10",371,2,3,0,0,-200,119,-3,-3,46,-7,-4,-3,1,-1,-246,126,1,0
"559","10",368,9,3,1,3,-95,153,4,4,-179,149,4,4,1,-8,84,4,0,0
"560","10",364,3,3,1,1,-146,-2,-2,-2,-105,-5,0,0,1,-2,-41,3,-2,-2
"561","10",315,8,3,0,3,244,9,4,3,10,214,3,3,1,-7,234,-205,1,0
"562","10",308,1,4,0,0,-248,-247,-4,-4,140,134,1,2,1,0,-388,-381,-5,-6
"563","10",81,8,1,0,0,-230,214,4,3,-221,203,4,4,1,-7,-9,11,0,-1
"564","10",385,2,4,1,1,-87,-95,-2,-3,119,-4,-1,0,1,-1,-206,-91,-1,-3
"565","10",300,2,1,0,0,-193,38,-2,-3,-25,33,0,0,1,-1,-168,5,-2,-3
"566","10",298,3,1,0,0,-242,1,-1,-2,-1,-240,0,-2,1,-2,-241,241,-1,0
"567","10",277,1,4,0,1,-59,109,4,-4,13,-67,0,0,1,0,-72,176,4,-4
"568","10",67,3,1,0,0,-50,34,0,-2,166,-161,1,1,1,-2,-216,195,-1,-3
"569","10",346,8,3,0,0,-1,1,0,3,247,-1,4,4,1,-7,-248,2,-4,-1
"570","10",342,2,3,1,1,-88,-234,-1,-3,-87,-216,-2,-3,1,-1,-1,-18,1,0
"571","10",339,4,3,1,1,-84,-37,-2,-1,-54,-29,-2,-2,1,-3,-30,-8,0,1
"572","10",310,2,4,1,2,-241,-2,-3,-3,-216,10,-3,-4,1,-1,-25,-12,0,1
"573","10",331,1,1,0,0,-212,-245,-4,-4,-204,-244,-4,-4,1,0,-8,-1,0,0
"574","10",77,4,3,0,1,-88,9,-1,-1,-3,50,-1,-2,1,-3,-85,-41,0,1
"575","10",429,1,2,0,0,-214,-219,-4,-4,-243,-106,-4,-4,1,0,29,-113,0,0
"576","10",28,4,4,0,1,-87,64,-1,-1,-46,9,-1,-1,1,-3,-41,55,0,0
"577","10",400,5,4,1,2,-125,108,-2,0,135,-83,-2,-1,1,-4,-260,191,0,1
"578","10",324,1,2,0,0,-68,-231,-4,-4,-141,-242,-4,-4,1,0,73,11,0,0
"579","10",248,5,4,0,3,0,-1,1,0,17,25,1,-1,1,-4,-17,-26,0,1
"580","10",244,2,4,1,2,54,32,-3,-3,229,226,3,2,1,-1,-175,-194,-6,-5
"581","10",317,1,4,1,2,-197,178,-4,-4,-192,160,-4,-4,1,0,-5,18,0,0
"582","10",313,2,3,1,0,-201,-250,-3,-3,-215,-192,-3,-3,1,-1,14,-58,0,0
"583","10",463,7,4,0,3,-53,-27,-1,2,222,-3,0,-3,1,-6,-275,-24,-1,5
"584","10",387,1,3,1,1,-199,-187,-3,-4,178,131,1,0,1,0,-377,-318,-4,-4
"585","10",302,3,1,0,0,-188,-24,-3,-2,218,30,-2,-2,1,-2,-406,-54,-1,0
"586","10",3,1,3,0,0,-218,216,-4,-4,-61,60,-3,-3,1,0,-157,156,-1,-1
"587","10",40,1,1,1,2,-207,203,4,-4,-43,21,1,-2,1,0,-164,182,3,-2
"588","10",372,1,3,1,0,-242,-231,-4,-4,-34,-54,-4,-2,1,0,-208,-177,0,-2
"589","10",369,4,4,1,0,-127,1,-2,-1,-1,2,0,0,1,-3,-126,-1,-2,-1
"590","10",365,1,3,1,1,-218,-2,0,-4,-217,-4,0,-4,1,0,-1,2,0,0
"591","10",316,3,3,1,0,-146,-18,-2,-2,-109,-42,-2,-2,1,-2,-37,24,0,0
"592","10",312,5,4,1,1,-54,60,0,0,-55,-55,0,3,1,-4,1,115,0,-3
"593","10",82,1,4,1,2,-149,-79,4,-4,24,214,4,-4,1,0,-173,-293,0,0
"594","10",79,1,4,1,2,-228,26,-4,-4,-230,20,-4,-4,1,0,2,6,0,0
"595","10",430,5,2,0,1,31,-49,-1,0,157,-73,1,1,1,-4,-126,24,-2,-1
"596","10",281,1,4,1,2,-245,2,-4,-4,-248,-1,-3,-4,1,0,3,3,-1,0
"597","10",278,1,4,1,1,-236,-233,4,-4,-224,-232,4,-4,1,0,-12,-1,0,0
"598","10",68,2,4,1,0,-193,7,-3,-3,204,1,-2,-2,1,-1,-397,6,-1,-1
"599","10",347,8,1,0,3,-102,-178,-2,3,-185,155,3,4,1,-7,83,-333,-5,-1
"600","10",343,4,2,0,2,-95,8,-1,-1,-53,0,-1,-1,1,-3,-42,8,0,0
"601","10",34,2,4,0,2,-135,139,-2,-3,-123,122,-2,-3,1,-1,-12,17,0,0
"602","10",311,1,2,0,2,-213,7,-4,-4,184,10,4,-4,1,0,-397,-3,-8,0
"603","10",332,5,1,0,0,-249,-2,0,0,-248,51,-2,-2,1,-4,-1,-53,2,2
"604","10",78,2,4,0,0,-201,1,-2,-3,-215,2,-3,-3,1,-1,14,-1,1,0
"605","10",43,1,3,1,0,-234,1,-4,-4,66,18,-2,-3,1,0,-300,-17,-2,-1
"606","10",280,7,2,0,1,183,190,-2,2,21,47,2,2,1,-6,162,143,-4,0
"607","10",401,2,2,0,1,-23,6,2,-3,72,16,1,-1,1,-1,-95,-10,1,-2
"608","10",325,9,1,0,1,-107,-137,-3,4,-106,-93,-4,3,1,-8,-1,-44,1,1
"609","10",249,1,3,1,0,-97,-76,-3,-4,-55,-50,-3,-4,1,0,-42,-26,0,0
"610","10",471,5,3,1,2,-65,94,0,0,96,50,-2,-2,1,-4,-161,44,2,2
"611","10",1,3,1,0,1,-222,-211,-4,-2,-208,-192,-2,1,1,-2,-14,-19,-2,-3
"612","10",468,4,1,0,3,123,-88,1,-1,70,64,1,1,1,-3,53,-152,0,-2
"613","10",464,6,1,0,1,-43,17,1,1,-31,29,1,1,1,-5,-12,-12,0,0
"614","10",388,3,4,1,0,224,1,1,-2,-2,-245,1,-1,1,-2,226,246,0,-1
"615","10",165,3,1,0,1,-190,-33,-2,-2,128,124,2,1,1,-2,-318,-157,-4,-3
"616","10",98,1,3,0,0,-241,-38,-4,-4,-231,62,-2,-3,1,0,-10,-100,-2,-1
"617","10",377,1,1,0,0,-243,6,-4,-4,-246,10,-4,-4,1,0,3,-4,0,0
"618","10",373,1,3,1,0,-207,-218,1,-4,-221,-177,-1,-4,1,0,14,-41,2,0
"619","10",45,3,3,1,0,-90,-46,-1,-2,74,-50,-2,-3,1,-2,-164,4,1,1
"620","10",446,5,4,1,1,46,45,0,0,77,44,0,-1,1,-4,-31,1,0,1
"621","10",442,5,4,1,1,-29,-28,1,0,21,26,1,1,1,-4,-50,-54,0,-1
"622","10",439,5,2,0,1,0,-2,0,0,-1,-4,0,0,1,-4,1,2,0,0
"623","10",83,6,1,0,3,112,-121,1,1,111,-110,2,1,1,-5,1,-11,-1,0
"624","10",435,4,4,0,1,-63,4,-1,-1,-5,5,0,0,1,-3,-58,-1,-1,-1
"625","10",431,5,3,0,0,-16,3,-1,0,56,47,-1,0,1,-4,-72,-44,0,0
"626","10",282,9,3,0,3,48,-119,1,4,161,61,1,4,1,-8,-113,-180,0,0
"627","10",72,2,1,0,0,-152,14,-1,-3,211,215,3,3,1,-1,-363,-201,-4,-6
"628","10",69,6,4,1,1,-28,77,1,1,68,-45,-1,-2,1,-5,-96,122,2,3
"629","10",348,3,3,1,1,21,26,-2,-2,79,76,0,-2,1,-2,-58,-50,-2,0
"630","10",199,2,4,1,2,-222,-145,-3,-3,-225,-142,-2,-2,1,-1,3,-3,-1,-1
"631","10",420,5,4,1,3,0,2,1,0,0,3,0,-2,1,-4,0,-1,1,2
"632","10",417,5,2,0,2,4,2,0,0,-31,-29,-2,0,1,-4,35,31,2,0
"633","10",333,4,4,1,1,-115,34,-1,-1,-175,132,0,0,1,-3,60,-98,-1,-1
"634","10",41,6,2,0,3,12,82,3,1,15,72,3,1,1,-5,-3,10,0,0
"635","10",406,7,2,1,2,-177,-164,2,2,-17,-22,2,3,1,-6,-160,-142,0,-1
"636","10",54,5,4,1,1,-226,14,0,0,61,11,0,0,1,-4,-287,3,0,0
"637","10",402,3,3,1,0,-232,-65,-2,-2,-237,1,-3,-4,1,-2,5,-66,1,2
"638","10",326,3,4,1,2,-193,-187,-2,-2,-210,-158,-2,-2,1,-2,17,-29,0,0
"639","10",25,1,4,1,2,-200,-212,-4,-4,239,244,2,1,1,0,-439,-456,-6,-5
"640","10",472,1,1,0,0,-238,239,-4,-4,-234,217,-4,-4,1,0,-4,22,0,0
"641","10",10,2,3,1,1,-199,2,-3,-3,-128,2,-2,-2,1,-1,-71,0,-1,-1
"642","10",469,1,4,0,0,-201,88,-4,-4,-23,7,-1,-4,1,0,-178,81,-3,0
"643","10",465,5,4,1,3,230,12,2,0,12,-245,4,4,1,-4,218,257,-2,-4
"644","10",389,9,3,1,2,200,2,-4,4,45,-31,1,1,1,-8,155,33,-5,3
"645","10",166,1,4,1,2,-163,-121,-1,-4,219,215,-2,-2,1,0,-382,-336,1,-2
"646","10",99,7,4,1,3,229,4,2,2,234,-30,3,3,1,-6,-5,34,-1,-1
"647","10",378,4,4,1,1,-116,-7,0,-1,-162,-4,-2,-2,1,-3,46,-3,2,1
"648","10",374,4,4,1,2,-121,-18,-1,-1,62,17,1,1,1,-3,-183,-35,-2,-2
"649","10",450,3,4,0,3,70,-1,1,-2,-1,168,1,-2,1,-2,71,-169,0,0
"650","10",447,2,4,1,2,-94,2,-2,-3,-60,19,-2,-2,1,-1,-34,-17,0,-1
"651","10",443,3,1,0,0,-211,26,-3,-2,83,64,1,1,1,-2,-294,-38,-4,-3
"652","10",44,1,2,0,2,-229,186,-4,-4,153,-2,-1,-4,1,0,-382,188,-3,0
"653","10",84,7,4,1,3,196,2,3,2,245,1,4,4,1,-6,-49,1,-1,-2
"654","10",436,4,4,1,3,35,-224,1,-1,111,-135,2,0,1,-3,-76,-89,-1,-1
"655","10",432,5,2,0,1,32,-31,0,0,39,-38,0,0,1,-4,-7,7,0,0
"656","10",283,4,1,0,1,-122,61,-3,-1,-91,-92,-3,-1,1,-3,-31,153,0,0
"657","10",73,3,4,1,2,-96,116,2,-2,-102,20,2,-4,1,-2,6,96,0,2
"658","10",7,6,1,1,3,85,29,1,1,89,56,1,1,1,-5,-4,-27,0,0
"659","10",349,3,4,1,1,-46,-61,-3,-2,120,51,2,3,1,-2,-166,-112,-5,-5
"660","10",2,3,4,1,1,23,25,-2,-2,122,-150,0,1,1,-2,-99,175,-2,-3
"661","10",421,3,3,0,1,-143,38,-2,-2,85,70,0,-1,1,-2,-228,-32,-2,-1
"662","10",418,2,2,0,2,-218,205,-3,-3,-187,184,-3,-3,1,-1,-31,21,0,0
"663","10",334,1,4,1,0,-130,106,-4,-4,-197,-72,-4,-4,1,0,67,178,0,0
"664","10",410,2,1,0,0,-30,-9,1,-3,-35,-15,0,-4,1,-1,5,6,1,1
"665","10",407,2,2,0,2,-243,-2,-3,-3,230,15,2,2,1,-1,-473,-17,-5,-5
"666","10",55,5,4,1,1,7,4,0,0,14,-5,0,0,1,-4,-7,9,0,0
"667","10",403,2,1,0,0,-242,-10,-1,-3,-82,-18,2,0,1,-1,-160,8,-3,-3
"668","10",327,3,4,0,3,104,-17,2,-2,143,6,1,-1,1,-2,-39,-23,1,-1
"669","10",250,6,1,0,3,68,17,1,1,79,22,1,1,1,-5,-11,-5,0,0
"670","10",473,3,3,1,0,-207,-29,-2,-2,-221,-20,-3,-3,1,-2,14,-9,1,1
"671","10",100,9,4,1,3,189,1,3,4,1,-157,-1,-1,1,-8,188,158,4,5
"672","10",47,6,4,1,3,177,-63,2,1,79,-1,2,4,1,-5,98,-62,0,-3
"673","10",466,2,3,0,0,-100,46,-3,-3,-108,-76,-2,-2,1,-1,8,122,-1,-1
"674","10",39,1,3,0,1,-200,-1,-4,-4,113,111,2,0,1,0,-313,-112,-6,-4
"675","10",167,7,1,0,3,148,-113,2,2,166,-125,2,2,1,-6,-18,12,0,0
"676","10",382,6,4,1,2,60,-16,1,1,23,2,1,1,1,-5,37,-18,0,0
"677","10",379,1,3,1,1,-56,-127,3,-4,128,59,2,0,1,0,-184,-186,1,-4
"678","10",375,4,3,1,1,-11,1,-1,-1,0,-1,0,0,1,-3,-11,2,-1,-1
"679","10",451,1,1,0,0,-228,-239,-4,-4,-196,-182,-4,-4,1,0,-32,-57,0,0
"680","10",448,8,2,0,2,-4,44,-1,3,244,0,4,4,1,-7,-248,44,-5,-1
"681","10",444,1,2,0,2,-229,-127,-4,-4,-219,-151,-4,-4,1,0,-10,24,0,0
"682","10",440,2,3,1,0,-184,0,-3,-3,-140,-1,-3,-3,1,-1,-44,1,0,0
"683","10",85,1,2,0,2,-120,144,-3,-4,-94,-121,1,-1,1,0,-26,265,-4,-3
"684","10",437,3,1,0,0,-186,0,-2,-2,-144,-1,-3,-3,1,-2,-42,1,1,1
"685","10",433,1,1,0,0,-211,-218,-4,-4,227,241,3,4,1,0,-438,-459,-7,-8
"686","10",284,1,3,1,1,-144,-132,-2,-4,-159,-144,-3,-4,1,0,15,12,1,0
"687","10",74,4,3,0,0,-247,-205,-4,-1,225,225,3,0,1,-3,-472,-430,-7,-1
"688","10",70,1,2,0,2,-238,-79,4,-4,14,35,0,-4,1,0,-252,-114,4,0
"689","10",35,2,1,0,3,42,118,1,-3,133,124,2,-1,1,-1,-91,-6,-1,-2
"690","10",20,6,3,0,0,-201,-200,-4,1,70,77,0,2,1,-5,-271,-277,-4,-1
"691","10",422,1,3,1,1,-121,-201,4,-4,-2,-213,3,0,1,0,-119,12,1,-4
"692","10",419,6,4,1,3,27,56,1,1,54,64,0,1,1,-5,-27,-8,1,0
"693","10",335,3,2,0,1,-80,25,-2,-2,20,22,-1,-1,1,-2,-100,3,-1,-1
"694","10",411,1,2,0,2,-227,-222,-4,-4,-230,-219,-4,-4,1,0,3,-3,0,0
"695","10",408,2,1,0,0,-203,5,-3,-3,-175,2,0,-2,1,-1,-28,3,-3,-1
"696","10",56,4,3,1,1,14,-33,-2,-1,27,-65,-2,0,1,-3,-13,32,0,-1
"697","10",404,4,1,0,1,33,-40,1,-1,39,-51,1,0,1,-3,-6,11,0,-1
"698","10",328,4,3,1,1,-49,14,-1,-1,17,12,1,1,1,-3,-66,2,-2,-2
"699","10",251,4,3,1,1,1,-234,0,-1,9,9,-1,-4,1,-3,-8,-243,1,3
"700","10",474,1,1,0,0,3,-81,0,-4,4,-69,0,-4,1,0,-1,-12,0,0
"701","10",101,1,3,1,0,-237,240,-4,-4,229,234,-3,-3,1,0,-466,6,-1,-1
"702","10",470,6,1,1,1,-52,17,1,1,-50,26,-1,-1,1,-5,-2,-9,2,2
"703","10",467,2,1,0,3,-214,164,4,-3,137,124,4,0,1,-1,-351,40,0,-3
"704","10",390,3,2,0,2,-228,188,-4,-2,213,148,3,3,1,-2,-441,40,-7,-5
"705","10",168,6,1,0,3,66,-93,2,1,147,-92,1,2,1,-5,-81,-1,1,-1
"706","10",383,5,4,1,1,-4,2,0,0,-134,-112,0,0,1,-4,130,114,0,0
"707","10",38,6,4,1,3,40,-28,0,1,-6,-64,2,2,1,-5,46,36,-2,-1
"708","10",376,4,4,1,1,-33,-166,-1,-1,24,-155,-1,-1,1,-3,-57,-11,0,0
"709","10",452,4,3,0,1,-65,4,-1,-1,-159,4,-2,-2,1,-3,94,0,1,1
"710","10",449,6,4,1,3,-25,77,1,1,27,72,0,0,1,-5,-52,5,1,1
"711","10",445,7,4,1,3,183,-31,2,2,192,-65,2,2,1,-6,-9,34,0,0
"712","10",441,4,4,0,2,-106,7,-3,-1,-61,-30,-1,-1,1,-3,-45,37,-2,0
"713","10",86,8,4,0,3,148,-4,2,3,173,1,2,3,1,-7,-25,-5,0,0
"714","10",438,5,4,1,3,45,-1,4,0,0,-3,4,0,1,-4,45,2,0,0
"715","10",434,7,4,1,3,118,-4,1,2,114,14,2,2,1,-6,4,-18,-1,0
"716","10",285,8,2,0,1,-182,196,-4,3,-235,221,-2,-2,1,-7,53,-25,-2,5
"717","10",75,1,4,1,2,236,20,2,-4,207,67,0,-2,1,0,29,-47,2,-2
"718","10",71,4,3,1,1,-71,24,-1,-1,28,18,-1,0,1,-3,-99,6,0,-1
"719","10",350,4,4,0,1,-244,22,-2,-1,3,-244,2,1,1,-3,-247,266,-4,-2
"720","10",200,1,3,1,0,-226,-201,-4,-4,-230,-142,-4,-4,1,0,4,-59,0,0
"721","10",423,3,1,1,3,131,-19,1,-2,127,-20,0,1,1,-2,4,1,1,-3
"722","10",42,4,3,1,1,-48,-44,-1,-1,-50,-14,0,0,1,-3,2,-30,-1,-1
"723","10",336,2,4,1,3,-200,141,2,-3,177,118,3,-3,1,-1,-377,23,-1,0
"724","10",412,9,1,0,0,-249,2,-4,4,244,0,4,4,1,-8,-493,2,-8,0
"725","10",409,2,4,0,2,-108,-106,2,-3,135,117,2,1,1,-1,-243,-223,0,-4
"726","10",57,1,4,1,1,-6,-231,-2,-4,-18,-200,-4,-4,1,0,12,-31,2,0
"727","10",405,2,4,1,1,-180,116,1,-3,72,36,-1,-2,1,-1,-252,80,2,-1
"728","10",329,5,4,1,3,-135,143,-3,0,-185,66,-4,-4,1,-4,50,77,1,4
"729","10",252,4,4,0,1,-109,-162,-1,-1,145,-93,1,1,1,-3,-254,-69,-2,-2
"730","10",475,5,3,0,3,59,-37,1,0,-166,30,-2,-3,1,-4,225,-67,3,3
"731","10",102,9,4,1,3,-187,85,1,4,111,68,1,3,1,-8,-298,17,0,1
"732","10",18,2,3,1,1,0,26,1,-3,38,-29,1,-3,1,-1,-38,55,0,0
"733","10",176,7,1,0,1,-59,0,-2,2,230,8,-2,2,1,-6,-289,-8,0,0
"734","10",391,5,2,1,3,-37,-174,-1,0,155,-167,1,0,1,-4,-192,-7,-2,0
"735","10",169,5,3,1,0,68,-43,0,0,-35,29,-4,-4,1,-4,103,-72,4,4
"736","10",287,4,4,0,3,-67,0,-1,-1,-100,0,0,2,1,-3,33,0,-1,-3
"737","10",380,3,4,0,1,30,-91,3,-2,-63,-163,3,-2,1,-2,93,72,0,0
"738","10",230,4,1,0,0,-245,7,-4,-1,-242,0,-4,-1,1,-3,-3,7,0,0
"739","10",453,2,4,1,2,-1,-120,0,-3,-3,-114,0,-3,1,-1,2,-6,0,0
"740","10",158,1,3,0,0,-238,-13,-4,-4,-242,-16,-4,-4,1,0,4,3,0,0
"741","10",94,9,4,1,1,221,229,4,4,126,126,2,2,1,-8,95,103,2,2
"742","10",90,2,4,1,0,-210,4,-4,-3,-216,-3,-2,-2,1,-1,6,7,-2,-1
"743","10",87,8,4,1,3,0,0,3,3,246,0,0,3,1,-7,-246,0,3,0
"744","10",143,8,1,0,3,137,-14,3,3,136,-134,3,3,1,-7,1,120,0,0
"745","10",29,1,4,1,0,-245,245,-4,-4,-247,239,-4,-4,1,0,2,6,0,0
"746","10",286,7,1,0,3,82,0,4,2,59,-4,1,1,1,-6,23,4,3,1
"747","10",209,7,4,1,3,0,0,1,2,142,-11,2,2,1,-6,-142,11,-1,0
"748","10",132,6,4,1,1,-27,-126,0,1,-76,90,-1,1,1,-5,49,-216,1,0
"749","10",351,5,1,0,0,-246,-245,0,0,244,247,-4,-4,1,-4,-490,-492,4,4
"750","10",201,1,3,1,1,-25,-3,0,-4,9,0,1,-2,1,0,-34,-3,-1,-2
"751","10",424,3,2,0,2,-144,-5,-2,-2,42,4,1,-1,1,-2,-186,-9,-3,-1
"752","10",129,5,4,1,1,61,1,0,0,75,2,1,1,1,-4,-14,-1,-1,-1
"753","10",125,3,4,1,0,-200,4,-4,-2,-181,-30,-3,-1,1,-2,-19,34,-1,-1
"754","10",413,7,1,0,1,240,8,2,2,-126,-25,-2,-3,1,-6,366,33,4,5
"755","10",61,2,1,0,3,248,-9,4,-3,-128,113,3,-4,1,-1,376,-122,1,1
"756","10",58,6,4,1,1,-240,23,-3,1,-8,246,4,2,1,-5,-232,-223,-7,-1
"757","10",260,2,3,1,0,-248,-249,-3,-3,-238,-234,-3,-3,1,-1,-10,-15,0,0
"758","10",257,1,1,1,0,-247,-7,4,-4,-240,3,4,-4,1,0,-7,-10,0,0
"759","10",253,9,3,1,3,222,230,4,4,233,229,4,4,1,-8,-11,1,0,0
"760","10",476,5,3,1,0,-197,-185,0,0,-171,-187,0,0,1,-4,-26,2,0,0
"761","10",103,5,2,0,3,23,3,4,0,-236,7,-4,-4,1,-4,259,-4,8,4
"762","10",180,3,2,0,2,-88,-1,0,-2,0,-76,-1,-3,1,-2,-88,75,1,1
"763","10",177,6,4,1,1,-101,-173,4,1,-114,-140,-2,-2,1,-5,13,-33,6,3
"764","10",392,2,1,1,0,-232,235,-3,-3,-136,0,-1,-1,1,-1,-96,235,-2,-2
"765","10",17,1,3,1,0,15,2,0,-4,166,124,-2,-4,1,0,-151,-122,2,0
"766","10",288,4,2,0,2,-75,40,-2,-1,-126,59,-2,0,1,-3,51,-19,0,-1
"767","10",381,1,2,0,2,-232,2,-4,-4,188,174,4,4,1,0,-420,-172,-8,-8
"768","10",231,4,4,1,0,-238,-3,-4,-1,-199,0,0,0,1,-3,-39,-3,-4,-1
"769","10",454,7,4,1,3,175,-1,2,2,164,1,2,2,1,-6,11,-2,0,0
"770","10",159,1,3,0,2,-240,15,-4,-4,218,4,4,4,1,0,-458,11,-8,-8
"771","10",95,1,4,1,2,-246,3,-4,-4,-238,-8,-4,-4,1,0,-8,11,0,0
"772","10",91,4,2,0,3,-248,3,-1,-1,248,1,3,3,1,-3,-496,2,-4,-4
"773","10",88,1,4,1,2,-227,-6,-4,-4,230,-231,4,4,1,0,-457,225,-8,-8
"774","10",144,1,3,0,0,-235,6,-4,-4,1,-2,0,0,1,0,-236,8,-4,-4
"775","10",290,3,1,0,1,-127,-137,-2,-2,-170,85,1,0,1,-2,43,-222,-3,-2
"776","10",6,6,4,1,2,36,-5,1,1,15,0,1,1,1,-5,21,-5,0,0
"777","10",21,2,4,1,2,-83,-69,-3,-3,-26,-26,-1,-2,1,-1,-57,-43,-2,-1
"778","10",133,2,2,0,1,-225,13,0,-3,249,14,4,0,1,-1,-474,-1,-4,-3
"779","10",352,4,2,0,1,13,-24,0,-1,13,-80,0,-1,1,-3,0,56,0,0
"780","10",202,4,1,0,1,-38,68,-2,-1,85,26,-2,-1,1,-3,-123,42,0,0
"781","10",425,5,4,1,2,-24,-69,0,0,-10,-17,0,-1,1,-4,-14,-52,0,1
"782","10",13,1,4,0,1,-127,-110,0,-4,-94,69,0,-4,1,0,-33,-179,0,0
"783","10",126,2,2,0,2,-223,-229,-3,-3,-216,-123,-3,-3,1,-1,-7,-106,0,0
"784","10",414,3,1,0,0,-129,-112,-2,-2,16,20,0,0,1,-2,-145,-132,-2,-2
"785","10",62,9,2,0,3,222,234,0,4,235,229,4,4,1,-8,-13,5,-4,0
"786","10",59,2,1,0,0,-97,94,-3,-3,-35,-23,-1,-1,1,-1,-62,117,-2,-2
"787","10",261,9,1,0,3,130,74,4,4,94,80,4,4,1,-8,36,-6,0,0
"788","10",258,1,3,1,0,-34,-3,-4,-4,-17,-1,1,-1,1,0,-17,-2,-5,-3
"789","10",254,4,2,0,3,16,-15,1,-1,135,-37,-3,-1,1,-3,-119,22,4,0
"790","10",48,1,3,1,0,7,-8,-4,-4,87,-92,-4,-4,1,0,-80,84,0,0
"791","10",104,1,1,0,0,-235,1,-4,-4,-235,0,-3,-3,1,0,0,1,-1,-1
"792","10",181,5,4,1,3,-89,100,0,0,-135,-133,0,0,1,-4,46,233,0,0
"793","10",178,1,1,1,1,-232,-2,-4,-4,1,3,0,0,1,0,-233,-5,-4,-4
"794","10",393,1,1,0,0,-233,-23,-4,-4,-59,-96,-4,-4,1,0,-174,73,0,0
"795","10",170,1,2,0,0,-243,-241,-4,-4,9,9,0,0,1,0,-252,-250,-4,-4
"796","10",289,8,1,0,3,219,220,3,3,231,210,3,3,1,-7,-12,10,0,0
"797","10",211,7,3,1,1,13,17,1,2,54,86,-2,-1,1,-6,-41,-69,3,3
"798","10",459,1,3,1,1,-174,-202,3,-4,-182,-178,2,-4,1,0,8,-24,1,0
"799","10",455,2,2,1,2,-246,1,-3,-3,1,160,3,3,1,-1,-247,-159,-6,-6
"800","10",16,1,1,0,0,-226,233,-1,-4,94,16,1,-2,1,0,-320,217,-2,-2
"801","10",96,2,1,0,0,-238,-15,-3,-3,-225,7,-3,-3,1,-1,-13,-22,0,0
"802","10",92,4,4,1,2,-128,-153,-1,-1,-224,-209,-1,-1,1,-3,96,56,0,0
"803","10",89,1,3,1,0,-246,0,-3,-4,-78,0,-4,-4,1,0,-168,0,1,0
"804","10",145,6,1,0,1,126,6,0,1,-17,14,0,1,1,-5,143,-8,0,0
"805","10",291,2,4,1,2,-7,-40,-2,-3,134,174,2,1,1,-1,-141,-214,-4,-4
"806","10",60,5,1,0,3,-3,25,0,0,1,10,3,3,1,-4,-4,15,-3,-3
"807","10",210,4,4,1,2,7,-25,1,-1,-222,20,3,-4,1,-3,229,-45,-2,3
"808","10",134,7,2,0,2,5,-7,1,2,8,-6,1,0,1,-6,-3,-1,0,2
"809","10",353,5,2,0,2,-247,4,-4,0,247,183,-4,2,1,-4,-494,-179,0,-2
"810","10",203,9,4,1,3,-11,25,4,4,-17,31,4,4,1,-8,6,-6,0,0
"811","10",426,9,4,1,3,2,222,4,4,-244,1,-3,-2,1,-8,246,221,7,6
"812","10",130,6,1,0,3,-61,80,4,1,95,-32,4,4,1,-5,-156,112,0,-3
"813","10",127,1,1,0,0,-238,3,-4,-4,-2,1,-4,-4,1,0,-236,2,0,0
"814","10",415,3,2,0,2,-219,-210,0,-2,150,174,0,4,1,-2,-369,-384,0,-6
"815","10",63,5,4,1,1,3,-6,0,0,-2,6,0,0,1,-4,5,-12,0,0
"816","10",217,2,4,1,2,-91,25,-1,-3,-32,20,-1,-3,1,-1,-59,5,0,0
"817","10",262,7,4,1,3,115,45,1,2,42,85,0,1,1,-6,73,-40,1,1
"818","10",259,1,3,0,1,-230,2,4,-4,-2,3,4,-4,1,0,-228,-1,0,0
"819","10",255,5,3,1,1,-113,-150,0,0,-84,-132,0,0,1,-4,-29,-18,0,0
"820","10",49,7,4,1,1,192,46,1,2,204,51,3,3,1,-6,-12,-5,-2,-1
"821","10",105,1,1,0,0,-224,-17,-4,-4,-215,-21,-4,-4,1,0,-9,4,0,0
"822","10",182,8,4,0,3,-4,-129,2,3,0,-131,2,2,1,-7,-4,2,0,1
"823","10",179,5,1,0,1,222,1,2,0,-1,-2,0,2,1,-4,223,3,2,-2
"824","10",394,1,3,1,0,-245,246,-4,-4,-247,248,-4,-4,1,0,2,-2,0,0
"825","10",171,5,1,0,1,25,18,4,0,28,35,0,0,1,-4,-3,-17,4,0
"826","10",216,7,3,1,1,-90,-30,0,2,-75,-77,1,1,1,-6,-15,47,-1,1
"827","10",212,5,1,0,1,-177,-139,3,0,-185,-142,3,0,1,-4,8,3,0,0
"828","10",46,1,1,0,0,-110,-245,-4,-4,-9,-234,-2,-3,1,0,-101,-11,-2,-1
"829","10",456,1,1,0,0,-131,-158,-2,-4,99,20,0,-4,1,0,-230,-178,-2,0
"830","10",160,7,2,0,0,-182,-3,-4,2,-74,0,-4,2,1,-6,-108,-3,0,0
"831","10",97,2,1,0,1,-203,22,2,-3,68,10,3,-1,1,-1,-271,12,-1,-2
"832","10",93,5,1,0,1,-128,88,-2,0,-114,80,-2,0,1,-4,-14,8,0,0
"833","10",9,3,4,1,2,-149,30,0,-2,13,13,-1,-2,1,-2,-162,17,1,0
"834","10",146,2,2,1,0,-160,-183,-3,-3,-147,-141,-3,-3,1,-1,-13,-42,0,0
"835","10",292,3,3,1,1,-197,-1,-2,-2,-4,2,0,0,1,-2,-193,-3,-2,-2
"836","10",219,5,4,1,3,247,-13,4,0,249,1,4,0,1,-4,-2,-14,0,0
"837","10",118,6,3,0,1,-120,34,-2,1,24,18,-1,1,1,-5,-144,16,-1,0
"838","10",135,5,1,0,1,-146,-47,1,0,-133,-17,0,0,1,-4,-13,-30,1,0
"839","10",354,4,1,0,0,-239,33,0,-1,244,243,4,4,1,-3,-483,-210,-4,-5
"840","10",204,5,3,0,1,21,-109,0,0,73,-114,0,0,1,-4,-52,5,0,0
"841","10",427,1,4,1,1,-243,-35,4,-4,-248,-43,4,-4,1,0,5,8,0,0
"842","10",131,7,4,1,3,-1,2,0,2,48,30,0,2,1,-6,-49,-28,0,0
"843","10",128,7,1,0,3,154,-15,2,2,8,-101,1,1,1,-6,146,86,1,1
"844","10",416,1,4,1,0,-205,-218,-4,-4,-194,109,-4,-4,1,0,-11,-327,0,0
"845","10",64,9,1,0,1,224,-221,4,4,233,-3,4,4,1,-8,-9,-218,0,0
"846","10",218,8,4,1,3,-38,83,4,3,-43,124,4,3,1,-7,5,-41,0,0
"847","10",263,1,4,1,0,-241,-4,-4,-4,-238,1,-4,-4,1,0,-3,-5,0,0
"848","10",26,1,1,0,0,-242,-200,-4,-4,-93,-80,-3,-3,1,0,-149,-120,-1,-1
"849","10",256,5,3,1,1,41,-2,0,0,93,53,0,0,1,-4,-52,-55,0,0
"850","10",5,1,2,0,2,-244,218,-3,-4,-241,220,-2,-4,1,0,-3,-2,-1,0
"851","10",106,3,2,0,1,-157,-95,-2,-2,-179,-132,-2,-2,1,-2,22,37,0,0
"852","10",183,1,4,1,1,-83,27,1,-4,86,165,1,-3,1,0,-169,-138,0,-1
"853","10",151,1,2,0,1,-238,12,0,-4,-243,13,0,-4,1,0,5,-1,0,0
"854","10",148,1,1,0,1,-198,-81,2,-4,-197,-98,2,-4,1,0,-1,17,0,0
"855","10",172,6,2,0,3,64,97,1,1,-2,131,3,3,1,-5,66,-34,-2,-2
"856","10",220,1,4,1,2,-238,181,-4,-4,100,135,-2,-2,1,0,-338,46,-2,-2
"857","10",213,4,2,0,1,-54,1,-1,-1,120,2,1,1,1,-3,-174,-1,-2,-2
"858","10",137,3,1,0,1,-241,237,3,-2,45,-32,0,-1,1,-2,-286,269,3,-1
"859","10",457,2,3,0,1,-47,-8,-2,-3,152,-80,2,2,1,-1,-199,72,-4,-5
"860","10",161,1,2,0,2,-249,168,-4,-4,57,50,0,-4,1,0,-306,118,-4,0
"861","10",109,1,1,0,1,-42,-1,4,-4,-22,6,3,-4,1,0,-20,-7,1,0
"862","10",154,6,4,1,3,98,-3,1,1,129,10,1,1,1,-5,-31,-13,0,0
"863","10",150,5,3,0,1,-2,2,0,0,-2,2,0,0,1,-4,0,0,0,0
"864","10",147,7,2,0,3,96,87,1,2,120,134,1,1,1,-6,-24,-47,0,1
"865","10",293,1,4,1,0,-237,29,-4,-4,-210,12,-4,-4,1,0,-27,17,0,0
"866","10",22,5,3,0,1,-13,-12,0,0,234,6,2,2,1,-4,-247,-18,-2,-2
"867","10",119,4,3,1,3,-52,89,-1,-1,45,75,1,1,1,-3,-97,14,-2,-2
"868","10",136,1,1,0,0,-249,249,-4,-4,-245,236,-4,-4,1,0,-4,13,0,0
"869","10",355,1,2,0,2,-195,117,-4,-4,-199,150,-4,-4,1,0,4,-33,0,0
"870","10",205,2,1,1,2,-224,6,-3,-3,242,5,4,4,1,-1,-466,1,-7,-7
"871","10",108,9,2,0,3,216,29,4,4,176,55,4,4,1,-8,40,-26,0,0
"872","10",185,1,4,1,2,-215,-10,-4,-4,1,-9,-3,1,1,0,-216,-1,-1,-5
"873","10",153,5,1,0,3,-197,-30,3,0,-177,-125,1,1,1,-4,-20,95,2,-1
"874","10",15,9,4,1,3,191,96,3,4,76,60,2,-1,1,-8,115,36,1,5
"875","10",121,1,1,0,0,-224,179,-4,-4,224,-235,4,-4,1,0,-448,414,-8,0
"876","10",222,2,1,0,0,0,0,-3,-3,-239,2,-3,-3,1,-1,239,-2,0,0
"877","10",215,2,1,0,0,-153,77,-2,-3,-161,67,-2,-3,1,-1,8,10,0,0
"878","10",114,2,4,1,1,-12,-238,0,-3,84,95,1,-3,1,-1,-96,-333,-1,0
"879","10",110,7,1,0,1,-120,95,-3,2,46,-124,-4,2,1,-6,-166,219,1,0
"880","10",50,3,2,0,1,-63,0,0,-2,32,-85,0,-2,1,-2,-95,85,0,0
"881","10",107,1,2,1,3,203,168,-1,-4,56,-56,2,-1,1,0,147,224,-3,-3
"882","10",184,6,3,1,3,128,1,2,1,127,7,1,1,1,-5,1,-6,1,0
"883","10",152,1,1,0,0,-237,-2,-4,-4,99,-11,0,-4,1,0,-336,9,-4,0
"884","10",149,6,3,0,1,-246,5,-3,1,244,2,-2,1,1,-5,-490,3,-1,0
"885","10",173,5,4,0,3,197,8,0,0,248,23,2,0,1,-4,-51,-15,-2,0
"886","10",221,6,4,0,1,-4,23,1,1,-5,4,1,1,1,-5,1,19,0,0
"887","10",214,9,1,0,3,227,5,4,4,247,5,4,4,1,-8,-20,0,0,0
"888","10",138,4,3,0,1,-92,-51,-1,-1,81,-22,1,1,1,-3,-173,-29,-2,-2
"889","10",458,2,1,0,1,-56,-70,-1,-3,72,81,-1,-2,1,-1,-128,-151,0,-1
"890","10",162,9,3,0,3,249,15,4,4,249,1,4,4,1,-8,0,14,0,0
"891","10",11,3,4,0,1,-61,-11,-3,-2,-21,-5,-2,-2,1,-2,-40,-6,-1,0
"892","10",155,2,2,0,1,-238,-228,-3,-3,1,-3,0,0,1,-1,-239,-225,-3,-3
"893","10",358,1,4,0,2,-244,219,-4,-4,-244,214,-4,-4,1,0,0,5,0,0
"894","10",228,3,4,1,2,-94,-86,-3,-2,-2,-244,2,3,1,-2,-92,158,-5,-5
"895","10",294,7,1,0,3,185,2,2,2,-1,0,2,2,1,-6,186,2,0,0
"896","10",111,5,1,0,0,2,-5,0,0,-180,171,-2,-3,1,-4,182,-176,2,3
"897","10",12,9,4,1,3,0,2,4,4,-1,1,4,4,1,-8,1,1,0,0
"898","10",116,8,2,0,3,60,-17,1,3,18,-16,1,1,1,-7,42,-1,0,2
"899","10",356,6,4,1,1,113,-3,2,1,59,1,1,1,1,-5,54,-4,1,0
"900","10",206,2,4,1,0,-198,-135,-3,-3,161,82,2,3,1,-1,-359,-217,-5,-6
"901","10",19,3,2,0,2,-138,-191,-1,-2,92,-47,1,-1,1,-2,-230,-144,-2,-1
"902","10",186,5,2,0,2,-18,34,0,0,-12,15,0,0,1,-4,-6,19,0,0
"903","10",357,1,4,1,2,-211,-30,-4,-4,128,134,-2,-2,1,0,-339,-164,-2,-2
"904","10",227,7,3,1,3,-156,-131,1,2,44,18,1,2,1,-6,-200,-149,0,0
"905","10",122,1,1,0,0,-217,-225,-4,-4,228,234,0,0,1,0,-445,-459,-4,-4
"906","10",187,1,4,1,2,-233,-9,-4,-4,-231,-4,-3,-3,1,0,-2,-5,-1,-1
"907","10",163,6,3,0,1,129,78,-1,1,51,-61,2,1,1,-5,78,139,-3,0
"908","10",115,6,3,0,3,-6,-2,1,1,53,-1,1,0,1,-5,-59,-1,0,1
"909","10",156,6,2,0,1,33,-1,1,1,35,2,1,1,1,-5,-2,-3,0,0
"910","10",51,4,4,1,1,-98,-159,2,-1,85,61,1,-1,1,-3,-183,-220,1,0
"911","10",189,2,1,0,1,-220,24,3,-3,-184,34,2,-2,1,-1,-36,-10,1,-1
"912","10",157,1,3,1,2,-96,-121,-4,-4,144,104,-2,0,1,0,-240,-225,-2,-4
"913","10",112,7,4,1,3,124,-173,2,2,151,62,2,3,1,-6,-27,-235,0,-1
"914","10",23,9,1,0,3,216,195,4,4,214,205,4,4,1,-8,2,-10,0,0
"915","10",174,5,4,1,3,90,31,1,0,135,75,1,1,1,-4,-45,-44,0,-1
"916","10",296,7,1,0,3,195,19,2,2,195,19,2,2,1,-6,0,0,0,0
"917","10",207,4,1,0,0,-246,-31,-2,-1,0,241,4,4,1,-3,-246,-272,-6,-5
"918","10",139,1,4,1,2,-249,3,-4,-4,-245,0,-4,-4,1,0,-4,3,0,0
"919","10",175,2,4,1,1,-204,-6,-2,-3,-183,-94,-1,-2,1,-1,-21,88,-1,-1
"920","10",195,1,1,1,1,-233,235,4,-4,-236,230,4,-4,1,0,3,5,0,0
"921","10",188,8,2,0,3,200,-1,3,3,197,-4,3,3,1,-7,3,3,0,0
"922","10",123,2,4,1,2,-176,31,-3,-3,-195,44,-3,-3,1,-1,19,-13,0,0
"923","10",359,1,4,1,3,-182,-22,-4,-4,213,33,4,4,1,0,-395,-55,-8,-8
"924","10",229,3,1,0,1,-164,-43,-2,-2,-197,-75,-2,-3,1,-2,33,32,0,1
"925","10",295,5,1,0,1,-4,-1,0,0,1,3,0,0,1,-4,-5,-4,0,0
"926","10",124,8,1,0,3,184,-1,2,3,180,1,2,2,1,-7,4,-2,0,1
"927","10",120,6,3,0,1,79,10,1,1,118,52,1,1,1,-5,-39,-42,0,0
"928","10",117,2,4,1,2,-155,7,-2,-3,-169,-4,-2,-3,1,-1,14,11,0,0
"929","10",141,1,1,0,0,-195,16,-4,-4,-138,-235,-3,-4,1,0,-57,251,-1,0
"930","10",113,3,2,0,2,-166,126,-2,-2,-153,145,-2,-3,1,-2,-13,-19,0,1
"931","10",190,7,4,1,3,200,158,2,2,214,163,2,2,1,-6,-14,-5,0,0
"932","10",142,6,2,0,2,-179,25,-4,1,-191,37,-4,0,1,-5,12,-12,0,1
"933","10",223,5,1,0,1,-4,0,0,0,1,1,0,0,1,-4,-5,-1,0,0
"934","10",208,5,4,1,2,-10,-5,0,0,-2,-1,0,0,1,-4,-8,-4,0,0
"935","10",14,5,3,0,1,-5,1,0,0,173,-87,2,4,1,-4,-178,88,-2,-4
"936","10",224,3,2,0,2,-48,-27,-3,-2,186,70,2,1,1,-2,-234,-97,-5,-3
"937","10",164,3,2,1,2,-65,0,-1,-2,-3,9,0,0,1,-2,-62,-9,-1,-2
"938","10",140,4,1,0,1,-30,62,1,-1,6,-50,-1,-1,1,-3,-36,112,2,0
"939","10",226,1,1,0,0,-235,-1,-3,-4,122,-4,2,-4,1,0,-357,3,-5,0
"940","10",52,2,3,0,0,-129,3,-2,-3,106,3,2,0,1,-1,-235,0,-4,-3
"941","10",193,1,1,0,0,-239,-64,-4,-4,138,45,1,1,1,0,-377,-109,-5,-5
"942","10",196,2,3,1,0,176,-1,0,-3,139,218,2,2,1,-1,37,-219,-2,-5
"943","10",361,1,1,0,0,-249,7,-4,-4,-248,0,-3,-4,1,0,-1,7,-1,0
"944","10",53,7,4,1,3,174,-2,2,2,6,-33,1,1,1,-6,168,31,1,1
"945","10",194,8,1,1,0,-245,-88,-4,3,-233,-93,-4,4,1,-7,-12,5,0,-1
"946","10",197,5,4,1,3,98,-69,0,0,50,-145,3,2,1,-4,48,76,-3,-2
"947","10",192,6,4,0,1,79,-26,1,1,-2,92,1,0,1,-5,81,-118,0,1
"948","10",191,3,1,0,0,-190,-46,-2,-2,-170,-46,-2,-2,1,-2,-20,0,0,0
"949","10",36,8,3,1,3,-123,-77,3,3,-154,66,4,-3,1,-7,31,-143,-1,6
"950","10",198,4,1,0,1,-22,-148,-2,-1,44,-208,0,1,1,-3,-66,60,-2,-2
"951","10",360,1,3,1,0,-179,-143,-3,-4,91,103,1,-4,1,0,-270,-246,-4,0
"952","10",225,5,2,0,2,-6,87,0,0,-188,-69,0,0,1,-4,182,156,0,0
"953","11",344,6,4,1,3,203,-25,2,1,-105,-61,1,2,2,-4,308,36,1,-1
"954","11",308,1,4,1,0,-233,-227,-4,-4,68,45,0,2,2,1,-301,-272,-4,-6
"955","11",309,3,4,1,2,-99,14,-1,-2,166,93,2,-1,2,-1,-265,-79,-3,-1
"956","11",232,1,1,0,0,-239,-43,-4,-4,-158,-26,-1,-4,2,1,-81,-17,-3,0
"957","11",246,6,4,1,3,113,1,3,1,1,-42,2,3,2,-4,112,43,1,-2
"958","11",345,1,1,1,0,-52,52,-4,-4,33,-171,-3,-1,2,1,-85,223,-1,-3
"959","11",346,7,3,1,0,-241,-100,-4,2,224,1,2,3,2,-5,-465,-101,-6,-1
"960","11",241,1,4,1,2,-168,-24,-2,-4,174,172,2,0,2,1,-342,-196,-4,-4
"961","11",307,2,4,1,2,-138,-82,-3,-3,200,-69,1,1,2,0,-338,-13,-4,-4
"962","11",233,4,2,0,2,-153,15,-3,-1,112,34,1,1,2,-2,-265,-19,-4,-2
"963","11",234,4,3,0,3,99,52,-1,-1,163,58,1,0,2,-2,-64,-6,-2,-1
"964","11",351,1,1,0,0,-244,-244,-4,-4,132,119,-4,-4,2,1,-376,-363,0,0
"965","11",348,5,3,1,1,1,4,-4,0,84,99,0,-2,2,-3,-83,-95,-4,2
"966","11",310,3,4,1,2,31,0,-1,-2,131,69,3,2,2,-1,-100,-69,-4,-4
"967","11",297,3,3,1,2,149,99,2,-2,121,96,2,2,2,-1,28,3,0,-4
"968","11",349,5,4,1,1,54,-80,1,0,-186,-159,-2,-3,2,-3,240,79,3,3
"969","11",248,4,4,0,3,30,32,-1,-1,30,25,-1,-1,2,-2,0,7,0,0
"970","11",341,9,1,1,3,127,-12,4,4,233,-32,4,4,2,-7,-106,20,0,0
"971","11",245,1,1,0,0,-238,6,-3,-4,-54,-25,-2,-3,2,1,-184,31,-1,-1
"972","11",338,3,3,1,2,84,53,-2,-2,182,174,1,1,2,-1,-98,-121,-3,-3
"973","11",237,4,2,0,2,-250,50,-4,-1,85,0,0,1,2,-2,-335,50,-4,-2
"974","11",299,4,4,1,1,-208,22,0,-1,130,136,1,2,2,-2,-338,-114,-1,-3
"975","11",350,9,4,1,1,-246,-6,4,4,249,4,-1,-1,2,-7,-495,-10,5,5
"976","11",347,8,1,0,3,124,-134,2,3,144,-189,1,-1,2,-6,-20,55,1,4
"977","11",242,4,4,1,2,-27,0,1,-1,67,-4,1,-1,2,-2,-94,4,0,0
"978","11",384,3,1,0,0,-56,0,-2,-2,0,1,0,0,2,-1,-56,-1,-2,-2
"979","11",247,3,3,1,0,155,-1,-2,-2,132,-14,1,1,2,-1,23,13,-3,-3
"980","11",340,4,1,0,1,-57,-28,0,-1,85,16,0,0,2,-2,-142,-44,0,-1
"981","11",352,5,2,0,1,7,-9,0,0,10,-9,0,0,2,-3,-3,0,0,0
"982","11",337,9,2,0,3,7,-4,4,4,239,-20,4,4,2,-7,-232,16,0,0
"983","11",236,5,1,0,1,9,-9,0,0,19,-22,0,0,2,-3,-10,13,0,0
"984","11",31,6,1,1,0,78,-46,1,1,-95,-15,-2,-2,2,-4,173,-31,3,3
"985","11",35,3,1,0,3,110,195,4,-2,200,202,4,-2,2,-1,-90,-7,0,0
"986","11",249,1,3,1,0,-47,-40,-3,-4,73,-62,2,-3,2,1,-120,22,-5,-1
"987","11",342,4,3,1,1,34,-171,1,-1,27,-209,1,-1,2,-2,7,38,0,0
"988","11",387,4,3,1,1,-134,-135,-2,-1,161,146,3,2,2,-2,-295,-281,-5,-3
"989","11",339,5,3,1,1,-25,-10,0,0,14,16,1,1,2,-3,-39,-26,-1,-1
"990","11",238,4,3,1,1,92,-172,-2,-1,119,-107,-1,1,2,-2,-27,-65,-1,-2
"991","11",3,2,3,0,0,-190,182,-3,-3,245,-244,0,4,2,0,-435,426,-3,-7
"992","11",311,1,2,0,2,-189,8,-4,-4,180,23,4,-4,2,1,-369,-15,-8,0
"993","11",235,1,3,0,0,-239,0,-4,-4,242,7,4,4,2,1,-481,-7,-8,-8
"994","11",243,4,2,0,2,-249,-172,-3,-1,-248,-219,-3,-1,2,-2,-1,47,0,0
"995","11",377,4,1,0,0,246,7,4,-1,240,9,4,0,2,-2,6,-2,0,-1
"996","11",373,5,3,0,0,232,213,3,0,220,211,4,1,2,-3,12,2,-1,-1
"997","11",298,1,1,0,0,-245,14,-2,-4,225,25,1,2,2,1,-470,-11,-3,-6
"998","11",386,1,1,0,0,-245,-250,-4,-4,59,38,1,0,2,1,-304,-288,-5,-4
"999","11",313,3,3,1,0,-133,-133,-2,-2,165,195,2,2,2,-1,-298,-328,-4,-4
"1000","11",362,4,4,1,3,154,-126,2,-1,95,69,2,1,2,-2,59,-195,0,-2
"1001","11",354,4,1,0,0,-75,-35,0,-1,77,83,2,2,2,-2,-152,-118,-2,-3
"1002","11",253,7,3,1,3,173,225,2,2,229,235,2,2,2,-5,-56,-10,0,0
"1003","11",25,3,4,1,2,-94,-124,-2,-2,1,3,0,0,2,-1,-95,-127,-2,-2
"1004","11",343,4,2,0,2,-38,0,-1,-1,-34,6,-1,-1,2,-2,-4,-6,0,0
"1005","11",72,4,1,0,0,22,21,-2,-1,130,150,2,2,2,-2,-108,-129,-4,-3
"1006","11",69,3,4,0,1,134,19,-1,-2,23,-30,1,1,2,-1,111,49,-2,-3
"1007","11",239,1,1,0,1,-154,-128,-4,-4,213,214,-2,-1,2,1,-367,-342,-2,-3
"1008","11",385,5,4,0,1,-76,88,0,0,116,81,1,-2,2,-3,-192,7,-1,2
"1009","11",312,4,4,1,1,-54,83,0,-1,-65,101,0,0,2,-2,11,-18,0,-1
"1010","11",244,6,4,1,2,116,103,1,1,224,213,3,3,2,-4,-108,-110,-2,-2
"1011","11",353,9,2,0,2,-8,6,0,4,240,74,-4,3,2,-7,-248,-68,4,1
"1012","11",378,1,4,1,1,124,-2,-4,-4,131,17,2,2,2,1,-7,-19,-6,-6
"1013","11",374,5,4,1,2,-85,-11,0,0,-9,-7,0,0,2,-3,-76,-4,0,0
"1014","11",395,8,3,1,1,-229,27,3,3,194,20,-2,3,2,-6,-423,7,5,0
"1015","11",318,1,2,0,2,-198,107,-4,-4,186,176,-3,-4,2,1,-384,-69,-1,0
"1016","11",314,1,4,1,1,-244,10,4,-4,-239,7,4,-4,2,1,-5,3,0,0
"1017","11",363,2,3,1,3,-250,2,-3,-3,249,0,3,3,2,0,-499,2,-6,-6
"1018","11",388,4,4,1,0,63,249,-4,-1,242,-4,4,3,2,-2,-179,253,-8,-4
"1019","11",34,5,4,1,2,75,-77,1,0,58,-38,1,2,2,-3,17,-39,0,-2
"1020","11",303,2,3,0,2,-190,-40,-3,-3,-24,-39,-1,-1,2,0,-166,-1,-2,-2
"1021","11",30,6,2,1,2,136,-1,1,1,-65,17,-1,1,2,-4,201,-18,2,0
"1022","11",73,6,4,1,2,119,-123,-2,1,73,83,-3,1,2,-4,46,-206,1,0
"1023","11",264,4,4,1,2,-5,6,0,-1,-238,34,-4,1,2,-2,233,-28,4,-2
"1024","11",66,1,1,1,1,-71,2,-1,-4,83,2,1,0,2,1,-154,0,-2,-4
"1025","11",421,5,3,1,1,51,27,0,0,50,43,0,2,2,-3,1,-16,0,-2
"1026","11",418,3,2,0,2,-232,177,-4,-2,-234,182,-4,-2,2,-1,2,-5,0,0
"1027","11",265,4,1,1,3,-236,-29,-3,-1,3,2,0,0,2,-2,-239,-31,-3,-1
"1028","11",334,1,4,1,0,-237,118,-4,-4,-229,55,-4,-4,2,1,-8,63,0,0
"1029","11",306,5,3,0,3,116,109,1,0,69,51,1,0,2,-3,47,58,0,0
"1030","11",359,9,4,1,3,235,12,4,4,232,13,4,4,2,-7,3,-1,0,0
"1031","11",355,1,2,0,2,-197,140,-4,-4,116,118,1,0,2,1,-313,22,-5,-4
"1032","11",254,5,2,0,3,-26,-27,-1,0,194,-187,-3,1,2,-3,-220,160,2,-1
"1033","11",250,6,1,0,3,82,22,1,1,46,30,1,1,2,-4,36,-8,0,0
"1034","11",65,8,1,0,3,-48,82,-1,3,90,98,1,2,2,-6,-138,-16,-2,1
"1035","11",420,7,4,1,3,164,1,2,2,-90,3,0,-2,2,-5,254,-2,2,4
"1036","11",7,6,1,0,3,111,84,1,1,91,86,0,1,2,-4,20,-2,1,0
"1037","11",24,1,2,0,2,-244,0,-4,-4,247,1,0,4,2,1,-491,-1,-4,-8
"1038","11",333,6,4,1,1,95,-6,1,1,118,-112,1,1,2,-4,-23,106,0,0
"1039","11",305,7,4,1,3,4,135,2,2,11,100,1,2,2,-5,-7,35,1,0
"1040","11",462,9,3,1,3,238,43,4,4,221,136,4,4,2,-7,17,-93,0,0
"1041","11",301,6,4,1,1,73,1,1,1,181,2,3,3,2,-4,-108,-1,-2,-2
"1042","11",379,5,3,0,1,-82,-34,2,0,232,111,3,1,2,-3,-314,-145,-1,-1
"1043","11",375,4,3,0,1,-48,1,-1,-1,-1,2,0,0,2,-2,-47,-1,-1,-1
"1044","11",396,1,1,0,1,-158,20,4,-4,1,1,0,-4,2,1,-159,19,4,0
"1045","11",319,4,1,0,1,-108,24,2,-1,31,-51,1,1,2,-2,-139,75,1,-2
"1046","11",315,2,3,1,3,0,0,4,-3,231,13,4,4,2,0,-231,-13,0,-7
"1047","11",364,5,3,0,1,64,-2,0,0,-106,-4,-1,-1,2,-3,170,2,1,1
"1048","11",389,5,3,0,2,9,0,0,0,-1,5,0,0,2,-3,10,-5,0,0
"1049","11",417,4,2,0,2,-70,-75,-2,-1,-140,-141,-3,-3,2,-2,70,66,1,2
"1050","11",304,1,2,0,2,-224,-15,-4,-4,179,36,2,2,2,1,-403,-51,-6,-6
"1051","11",300,6,1,0,0,-130,26,0,1,30,83,1,1,2,-4,-160,-57,-1,0
"1052","11",74,1,3,1,0,-169,36,-3,-4,208,196,3,1,2,1,-377,-160,-6,-5
"1053","11",70,1,2,0,2,-141,-69,0,-4,211,211,3,-3,2,1,-352,-280,-3,-1
"1054","11",67,2,1,1,0,-22,8,-3,-3,161,-171,2,2,2,0,-183,179,-5,-5
"1055","11",422,6,3,0,1,-74,-246,4,1,-107,-234,4,-4,2,-4,33,-12,0,5
"1056","11",419,5,4,1,3,164,112,0,0,226,151,2,2,2,-3,-62,-39,-2,-2
"1057","11",266,4,1,0,1,-106,1,-1,-1,-66,-1,-1,-1,2,-2,-40,2,0,0
"1058","11",335,3,2,0,1,-114,31,-2,-2,-69,12,-1,-1,2,-1,-45,19,-1,-1
"1059","11",165,2,1,0,1,-161,-3,-3,-3,124,84,1,1,2,0,-285,-87,-4,-4
"1060","11",36,9,3,1,3,187,219,4,4,204,207,4,-4,2,-7,-17,12,0,8
"1061","11",356,4,4,1,1,-9,-2,0,-1,43,66,1,1,2,-2,-52,-68,-1,-2
"1062","11",255,3,3,0,1,-111,-141,-2,-2,179,99,2,2,2,-1,-290,-240,-4,-4
"1063","11",251,4,3,0,1,-35,-198,-1,-1,-4,-200,0,-1,2,-2,-31,2,-1,0
"1064","11",398,2,4,1,2,-235,46,-3,-3,156,137,2,2,2,0,-391,-91,-5,-5
"1065","11",320,4,2,0,2,-123,133,-2,-1,13,122,1,2,2,-2,-136,11,-3,-3
"1066","11",317,5,4,1,2,23,-20,0,0,108,-108,2,2,2,-3,-85,88,-2,-2
"1067","11",240,2,2,0,1,-236,7,-3,-3,221,-228,4,-4,2,0,-457,235,-7,1
"1068","11",390,5,2,1,2,9,-14,1,0,16,-12,1,3,2,-3,-7,-2,0,-3
"1069","11",168,4,1,1,3,211,-70,2,-1,133,-88,2,3,2,-2,78,18,0,-4
"1070","11",463,7,4,1,3,247,-78,-3,2,229,1,2,4,2,-5,18,-79,-5,-2
"1071","11",302,3,1,0,0,-156,-20,-3,-2,208,61,-2,-2,2,-1,-364,-81,-1,0
"1072","11",38,9,4,1,3,7,-3,4,4,9,-2,0,0,2,-7,-2,-1,4,4
"1073","11",376,4,4,1,1,94,-4,-1,-1,140,-52,-1,0,2,-2,-46,48,0,-1
"1074","11",397,6,4,1,3,115,-11,1,1,85,117,1,1,2,-4,30,-128,0,0
"1075","11",32,4,1,0,1,191,-137,2,-1,160,-176,2,-2,2,-2,31,39,0,1
"1076","11",316,5,3,0,0,-115,-106,0,0,-119,-129,0,0,2,-3,4,23,0,0
"1077","11",365,1,3,0,1,-244,1,0,-4,-225,2,0,0,2,1,-19,-1,0,-4
"1078","11",39,3,3,0,1,96,142,-1,-2,119,74,3,3,2,-1,-23,68,-4,-5
"1079","11",167,7,1,0,3,124,-129,2,2,147,-130,2,2,2,-5,-23,1,0,0
"1080","11",361,3,1,1,0,-68,-246,1,-2,-3,-243,3,-1,2,-1,-65,-3,-2,-1
"1081","11",358,1,4,1,2,-178,26,-4,-4,174,73,0,-4,2,1,-352,-47,-4,0
"1082","11",75,1,4,1,2,-175,33,0,-4,126,149,2,-3,2,1,-301,-116,-2,-1
"1083","11",71,4,3,1,1,-66,28,-1,-1,30,19,-1,0,2,-2,-96,9,0,-1
"1084","11",68,2,4,1,0,90,3,0,-3,231,1,3,0,2,0,-141,2,-3,-3
"1085","11",423,3,1,1,3,216,-61,1,-2,153,-31,-2,1,2,-1,63,-30,3,-3
"1086","11",42,2,3,0,1,-9,-37,2,-3,5,15,2,-2,2,0,-14,-52,0,-1
"1087","11",267,5,3,0,1,-49,-3,0,0,177,32,2,1,2,-3,-226,-35,-2,-1
"1088","11",336,3,4,0,3,150,151,2,-2,183,129,3,-2,2,-1,-33,22,-1,0
"1089","11",166,1,4,1,2,7,107,-2,-4,25,75,-2,0,2,1,-18,32,0,-4
"1090","11",360,1,3,0,0,-124,-80,0,-4,107,138,0,-3,2,1,-231,-218,0,-1
"1091","11",357,6,4,1,2,68,-12,1,1,213,208,2,4,2,-4,-145,-220,-1,-3
"1092","11",256,5,3,1,1,-1,0,0,0,-1,0,0,0,2,-3,0,0,0,0
"1093","11",252,4,4,0,1,-188,134,-1,-1,-110,101,-1,-2,2,-2,-78,33,0,1
"1094","11",399,5,4,1,3,115,9,0,0,53,5,0,0,2,-3,62,4,0,0
"1095","11",321,2,1,0,0,-215,-184,-2,-3,15,15,0,0,2,0,-230,-199,-2,-3
"1096","11",1,7,1,0,1,93,77,1,2,135,122,1,2,2,-5,-42,-45,0,0
"1097","11",471,6,3,0,2,-13,-35,0,1,-124,-162,1,1,2,-4,111,127,-1,0
"1098","11",391,4,2,1,3,-129,129,-2,-1,175,144,0,1,2,-2,-304,-15,-2,-2
"1099","11",169,1,3,0,0,-236,-217,-4,-4,128,-145,-4,-4,2,1,-364,-72,0,0
"1100","11",464,6,1,0,1,-26,24,1,1,37,29,1,1,2,-4,-63,-5,0,0
"1101","11",460,2,1,0,0,-208,41,-3,-3,188,19,-2,1,2,0,-396,22,-1,-4
"1102","11",380,1,4,1,1,-144,-26,3,-4,123,-37,3,-4,2,1,-267,11,0,0
"1103","11",457,2,3,1,1,-143,80,-3,-3,-28,228,1,2,2,0,-115,-148,-4,-5
"1104","11",453,3,4,0,2,197,2,-2,-2,192,8,2,-1,2,-1,5,-6,-4,-1
"1105","11",45,2,3,0,0,-196,-57,-4,-3,-37,-12,1,-3,2,0,-159,-45,-5,0
"1106","11",37,2,1,0,0,-132,-53,-2,-3,-1,-47,-2,-3,2,0,-131,-6,0,0
"1107","11",366,9,4,1,3,127,-98,3,4,179,-124,3,4,2,-7,-52,26,0,0
"1108","11",87,7,4,1,3,13,7,2,2,185,24,2,0,2,-5,-172,-17,0,2
"1109","11",143,6,1,0,3,210,18,1,1,185,0,3,3,2,-4,25,18,-2,-2
"1110","11",439,1,2,1,1,0,-245,-4,-4,40,-3,1,1,2,1,-40,-242,-5,-5
"1111","11",286,6,1,0,3,90,9,1,1,65,-2,1,1,2,-4,25,11,0,0
"1112","11",76,7,4,0,3,149,-3,2,2,151,0,2,2,2,-5,-2,-3,0,0
"1113","11",132,3,4,1,1,56,28,-1,-2,-2,149,1,2,2,-1,58,-121,-2,-4
"1114","11",428,4,1,0,0,-15,27,-1,-1,208,118,2,2,2,-2,-223,-91,-3,-3
"1115","11",424,2,2,0,2,1,4,0,-3,141,82,1,1,2,0,-140,-78,-1,-4
"1116","11",271,3,3,0,1,-230,-1,-2,-2,220,-1,4,4,2,-1,-450,0,-6,-6
"1117","11",268,7,4,1,3,111,-72,1,2,100,-71,3,3,2,-5,11,-1,-2,-1
"1118","11",121,2,1,0,0,-208,-1,-4,-3,245,-73,-1,-4,2,0,-453,72,-3,1
"1119","11",413,3,1,0,1,181,3,1,-2,161,-36,2,2,2,-1,20,39,-1,-4
"1120","11",33,5,3,0,1,58,73,0,0,164,-56,0,1,2,-3,-106,129,0,-1
"1121","11",406,2,2,0,2,-188,-94,-1,-3,76,22,2,1,2,0,-264,-116,-3,-4
"1122","11",257,1,1,0,0,-205,33,2,-4,109,106,1,-4,2,1,-314,-73,1,0
"1123","11",402,1,3,1,0,-245,2,-4,-4,118,1,0,1,2,1,-363,1,-4,-5
"1124","11",4,8,3,0,1,-244,5,0,3,42,133,0,2,2,-6,-286,-128,0,1
"1125","11",322,4,4,1,3,-25,31,-1,-1,237,-227,4,4,2,-2,-262,258,-5,-5
"1126","11",10,4,3,0,1,1,-17,-1,-1,-109,3,-1,-1,2,-2,110,-20,0,0
"1127","11",472,1,1,0,0,-171,99,-4,-4,6,9,-4,-4,2,1,-177,90,0,0
"1128","11",392,4,1,0,0,-101,-67,0,-1,112,39,1,1,2,-2,-213,-106,-1,-2
"1129","11",17,1,3,0,0,-203,2,-3,-4,111,79,-1,-4,2,1,-314,-77,-2,0
"1130","11",465,8,4,1,3,208,-22,3,3,23,-240,3,3,2,-6,185,218,0,0
"1131","11",461,3,4,1,2,87,37,-1,-2,90,30,1,1,2,-1,-3,7,-2,-3
"1132","11",381,4,2,0,2,227,234,-1,-1,244,229,4,4,2,-2,-17,5,-5,-5
"1133","11",458,2,1,0,1,-31,-25,-1,-3,88,88,-1,-2,2,0,-119,-113,0,-1
"1134","11",454,7,4,1,3,195,-1,2,2,220,2,2,2,2,-5,-25,-3,0,0
"1135","11",450,3,4,1,3,242,1,2,-2,0,234,3,-2,2,-1,242,-233,-1,0
"1136","11",370,9,1,0,3,-237,-10,-4,4,242,-9,-4,-4,2,-7,-479,-1,0,8
"1137","11",367,3,3,1,1,-17,-14,2,-2,8,8,2,-2,2,-1,-25,-22,0,0
"1138","11",88,1,4,1,2,-237,-20,-4,-4,208,-223,4,4,2,1,-445,203,-8,-8
"1139","11",144,1,3,1,0,-226,-2,-4,-4,91,1,1,-1,2,1,-317,-3,-5,-3
"1140","11",44,1,2,0,2,-199,187,-4,-4,128,1,-2,-4,2,1,-327,186,-2,0
"1141","11",287,8,4,0,3,139,-7,1,3,131,-11,2,2,2,-6,8,4,-1,1
"1142","11",77,5,3,1,1,-82,-1,-1,0,-1,-79,-1,-1,2,-3,-81,78,0,1
"1143","11",133,2,2,0,1,0,0,4,-3,164,-211,2,0,2,0,-164,211,2,-3
"1144","11",429,1,2,0,0,-232,-208,-4,-4,90,46,0,-4,2,1,-322,-254,-4,0
"1145","11",425,2,4,1,2,-151,-14,-2,-3,108,25,3,4,2,0,-259,-39,-5,-7
"1146","11",272,4,4,1,2,2,-1,-1,-1,10,2,-1,0,2,-2,-8,-3,0,-1
"1147","11",269,1,4,1,2,-250,132,0,-4,-250,123,0,-3,2,1,0,9,0,-1
"1148","11",122,1,1,0,0,-200,-221,-4,-4,-235,-241,-4,-4,2,1,35,20,0,0
"1149","11",414,6,1,0,0,-8,7,1,1,119,111,2,2,2,-4,-127,-104,-1,-1
"1150","11",330,4,2,0,2,-238,90,0,-1,215,203,2,1,2,-2,-453,-113,-2,-2
"1151","11",407,1,2,0,2,-190,-31,-4,-4,191,74,2,2,2,1,-381,-105,-6,-6
"1152","11",258,3,3,1,0,10,-1,-1,-2,21,-4,2,2,2,-1,-11,3,-3,-4
"1153","11",403,4,1,0,0,-113,-14,1,-1,62,-33,2,2,2,-2,-175,19,-1,-3
"1154","11",40,3,1,0,2,-140,56,-3,-2,202,100,4,1,2,-1,-342,-44,-7,-3
"1155","11",323,5,4,0,1,129,-4,0,0,35,-2,0,0,2,-3,94,-2,0,0
"1156","11",100,8,4,1,3,189,4,3,3,3,198,2,2,2,-6,186,-194,1,1
"1157","11",473,6,3,0,0,176,15,0,1,6,6,0,2,2,-4,170,9,0,-1
"1158","11",393,1,1,0,0,-236,-9,4,-4,0,2,-4,-4,2,1,-236,-11,8,0
"1159","11",170,1,2,0,0,-236,-231,-4,-4,22,27,0,0,2,1,-258,-258,-4,-4
"1160","11",466,3,3,1,0,-135,-86,-2,-2,127,-98,2,2,2,-1,-262,12,-4,-4
"1161","11",289,8,1,1,3,-237,-33,3,3,196,-232,3,3,2,-6,-433,199,0,0
"1162","11",382,5,4,1,2,110,-7,0,0,81,-10,1,1,2,-3,29,3,-1,-1
"1163","11",459,2,3,1,1,-172,49,2,-3,48,-44,2,-4,2,0,-220,93,0,1
"1164","11",455,8,2,0,2,133,4,3,3,181,-8,-2,2,2,-6,-48,12,5,1
"1165","11",451,1,1,0,0,-201,-215,-4,-4,-190,-212,-4,-4,2,1,-11,-3,0,0
"1166","11",371,2,3,1,0,-211,-121,-4,-3,169,167,-4,2,2,0,-380,-288,0,-5
"1167","11",368,9,3,1,3,-132,143,4,4,-158,122,4,4,2,-7,26,21,0,0
"1168","11",89,1,3,1,0,-143,4,-3,-4,-238,0,-4,-4,2,1,95,4,1,0
"1169","11",145,5,1,0,1,189,0,2,0,-45,-116,1,2,2,-3,234,116,1,-2
"1170","11",440,3,3,1,0,-84,-2,-2,-2,-182,-22,-3,-3,2,-1,98,20,1,1
"1171","11",288,3,2,0,2,-250,-4,-3,-2,-126,72,-1,-2,2,-1,-124,-76,-2,0
"1172","11",78,4,4,0,0,-190,-1,-2,-1,-156,-10,-3,-3,2,-2,-34,9,1,2
"1173","11",134,1,2,0,2,-227,-2,-1,-4,-137,-6,-1,-4,2,1,-90,4,0,0
"1174","11",43,2,3,0,0,-69,-2,-3,-3,121,3,-1,-3,2,0,-190,-5,-2,0
"1175","11",426,7,4,0,3,-224,3,4,2,176,-2,2,2,2,-5,-400,5,2,0
"1176","11",273,4,1,0,0,-166,4,-1,-1,215,227,4,3,2,-2,-381,-223,-5,-4
"1177","11",27,5,2,0,2,-34,-15,0,0,14,-24,0,0,2,-3,-48,9,0,0
"1178","11",123,2,4,1,2,-191,35,-3,-3,-189,41,-3,-3,2,0,-2,-6,0,0
"1179","11",415,4,2,0,2,5,3,0,-1,166,204,0,1,2,-2,-161,-201,0,-2
"1180","11",331,2,1,0,0,-42,64,-4,-3,44,57,-4,-3,2,0,-86,7,0,0
"1181","11",408,4,1,0,0,-84,-1,-1,-1,143,-3,1,2,2,-2,-227,2,-2,-3
"1182","11",259,1,3,0,1,-161,53,4,-4,143,46,3,-3,2,1,-304,7,1,-1
"1183","11",404,4,1,0,1,60,-66,-1,-1,45,-58,1,0,2,-2,15,-8,-2,-1
"1184","11",400,4,4,0,2,-68,60,-1,-1,160,32,3,3,2,-2,-228,28,-4,-4
"1185","11",324,1,2,0,0,-236,-2,-4,-4,1,5,0,0,2,1,-237,-7,-4,-4
"1186","11",101,1,3,0,0,-235,236,-4,-4,184,197,-3,-3,2,1,-419,39,-1,-1
"1187","11",474,1,1,0,0,13,-101,-4,-4,21,-125,-2,-4,2,1,-8,24,-2,0
"1188","11",394,1,3,1,0,-249,247,-4,-4,-246,247,-4,-4,2,1,-3,0,0,0
"1189","11",171,5,1,0,1,37,38,0,0,33,34,0,0,2,-3,4,4,0,0
"1190","11",467,5,1,0,3,163,132,3,0,144,191,4,0,2,-3,19,-59,-1,0
"1191","11",29,3,4,1,0,30,75,-2,-2,189,184,-1,0,2,-1,-159,-109,-1,-2
"1192","11",383,5,4,0,1,1,3,0,0,6,3,0,0,2,-3,-5,0,0,0
"1193","11",46,9,1,0,0,-104,-240,-4,4,225,232,0,-3,2,-7,-329,-472,-4,7
"1194","11",456,1,1,0,0,-148,106,-2,-4,-5,-128,0,-3,2,1,-143,234,-2,-1
"1195","11",452,4,3,1,1,-55,2,-1,-1,-41,11,-1,0,2,-2,-14,-9,0,-1
"1196","11",372,1,3,1,0,-218,-202,-3,-4,3,9,-4,-4,2,1,-221,-211,1,0
"1197","11",369,4,4,1,0,-177,1,-1,-1,76,-2,1,1,2,-2,-253,3,-2,-2
"1198","11",9,4,4,0,2,-43,15,0,-1,226,-39,2,1,2,-2,-269,54,-2,-2
"1199","11",146,2,2,0,0,-157,-193,-3,-3,-157,-175,-3,-3,2,0,0,-18,0,0
"1200","11",441,4,4,1,2,-27,-4,-1,-1,-65,-59,-1,-1,2,-2,38,55,0,0
"1201","11",41,6,2,0,3,79,51,2,1,73,27,2,1,2,-4,6,24,0,0
"1202","11",79,1,4,1,2,202,175,-4,-4,-218,-186,-2,-2,2,1,420,361,-2,-2
"1203","11",135,5,1,0,1,-181,70,-3,0,182,-96,2,2,2,-3,-363,166,-5,-2
"1204","11",430,5,2,1,1,24,-34,0,0,212,-124,0,0,2,-3,-188,90,0,0
"1205","11",427,1,4,1,1,-248,-38,4,-4,-241,-60,4,-4,2,1,-7,22,0,0
"1206","11",274,6,4,1,2,12,-25,-2,1,-132,-23,-1,1,2,-4,144,-2,-1,0
"1207","11",270,5,3,0,1,3,4,0,0,-8,98,2,1,2,-3,11,-94,-2,-1
"1208","11",124,9,1,0,3,250,1,3,4,247,4,3,2,2,-7,3,-3,0,2
"1209","11",416,1,4,1,0,-246,242,-4,-4,-152,-131,-4,-4,2,1,-94,373,0,0
"1210","11",332,5,1,0,0,-234,40,-2,0,40,12,1,3,2,-3,-274,28,-3,-3
"1211","11",409,4,4,1,2,-58,-54,-3,-1,136,111,2,2,2,-2,-194,-165,-5,-3
"1212","11",26,2,1,0,0,-123,82,-4,-3,35,35,-3,-2,2,0,-158,47,-1,-1
"1213","11",405,2,4,1,1,-147,99,-3,-3,105,-67,1,1,2,0,-252,166,-4,-4
"1214","11",401,4,2,0,1,-48,1,0,-1,98,53,1,0,2,-2,-146,-52,-1,-1
"1215","11",325,9,1,0,1,-120,-111,-2,4,-124,-127,-2,4,2,-7,4,16,0,0
"1216","11",102,9,4,1,3,-210,-163,-2,4,-96,161,3,4,2,-7,-114,-324,-5,0
"1217","11",475,2,3,0,3,163,-137,1,-3,88,-114,0,-1,2,0,75,-23,1,-2
"1218","11",176,1,1,0,1,-121,-1,-4,-4,159,69,-3,-4,2,1,-280,-70,-1,0
"1219","11",172,1,2,1,3,-220,216,-4,-4,197,183,4,4,2,1,-417,33,-8,-8
"1220","11",468,6,1,0,3,150,49,2,1,46,47,1,1,2,-4,104,2,1,0
"1221","11",290,2,1,0,1,-177,-116,-3,-3,114,-84,1,-3,2,0,-291,-32,-4,0
"1222","11",80,8,4,1,3,201,-7,3,3,241,0,3,1,2,-6,-40,-7,0,2
"1223","11",137,3,1,1,1,-32,17,-1,-2,-81,-132,-2,-1,2,-1,49,149,1,-1
"1224","11",230,6,1,0,0,-24,12,-3,1,211,23,-2,3,2,-4,-235,-11,-1,-2
"1225","11",158,2,3,0,0,-233,-13,-3,-3,238,-239,-2,1,2,0,-471,226,-1,-4
"1226","11",154,6,4,1,3,99,-6,1,1,99,-5,1,1,2,-4,0,-1,0,0
"1227","11",94,1,4,1,1,-141,-134,2,-4,220,-219,3,3,2,1,-361,85,-1,-7
"1228","11",90,2,4,1,0,-36,14,-3,-3,226,14,4,4,2,0,-262,0,-7,-7
"1229","11",147,7,2,0,3,123,200,1,2,61,-115,1,2,2,-5,62,315,0,0
"1230","11",442,6,4,1,1,24,29,0,1,25,26,1,1,2,-4,-1,3,-1,0
"1231","11",410,1,1,0,0,-218,-68,2,-4,219,60,-2,-1,2,1,-437,-128,4,-3
"1232","11",8,7,3,0,1,48,25,1,2,-80,76,1,1,2,-5,128,-51,0,1
"1233","11",136,1,1,0,0,-100,52,-4,-4,204,-234,-3,-3,2,1,-304,286,-1,-1
"1234","11",431,2,3,0,0,-207,95,-3,-3,179,158,-1,0,2,0,-386,-63,-2,-3
"1235","11",279,6,4,0,3,70,-56,3,1,-56,-45,3,1,2,-4,126,-11,0,0
"1236","11",275,4,4,1,2,-249,1,-1,-1,249,7,4,-1,2,-2,-498,-6,-5,0
"1237","11",199,1,4,0,2,-208,204,-4,-4,139,110,1,1,2,1,-347,94,-5,-5
"1238","11",125,2,4,1,0,-52,-40,-3,-3,243,-246,-2,-2,2,0,-295,206,-1,-1
"1239","11",174,6,4,1,3,121,52,0,1,66,17,1,1,2,-4,55,35,-1,0
"1240","11",47,7,4,1,3,121,-103,1,2,112,-1,1,2,2,-5,9,-102,0,0
"1241","11",292,9,3,1,1,4,93,4,4,-230,1,-2,-2,2,-7,234,92,6,6
"1242","11",260,3,3,1,0,-97,-109,-2,-2,157,165,1,2,2,-1,-254,-274,-3,-4
"1243","11",110,2,1,0,1,-96,91,-3,-3,167,138,3,3,2,0,-263,-47,-6,-6
"1244","11",54,5,4,1,1,-200,-8,0,0,140,72,0,0,2,-3,-340,-80,0,0
"1245","11",326,7,4,1,2,123,69,2,2,100,71,2,2,2,-5,23,-2,0,0
"1246","11",103,7,2,0,3,198,-16,2,2,63,8,2,2,2,-5,135,-24,0,0
"1247","11",476,5,3,1,0,-92,-145,0,0,-162,-178,-1,-1,2,-3,70,33,1,1
"1248","11",177,1,4,1,1,-95,-95,3,-4,40,197,4,3,2,1,-135,-292,-1,-7
"1249","11",173,6,4,0,3,-167,5,-1,1,225,14,0,0,2,-4,-392,-9,-1,1
"1250","11",469,1,4,1,0,-125,14,-3,-4,154,57,-4,-4,2,1,-279,-43,1,0
"1251","11",291,4,4,1,2,3,27,-2,-1,42,13,-2,-3,2,-2,-39,14,0,2
"1252","11",81,1,1,0,0,-246,86,-4,-4,38,63,1,-2,2,1,-284,23,-5,-2
"1253","11",138,4,3,1,1,96,-89,-1,-1,67,-15,1,1,2,-2,29,-74,-2,-2
"1254","11",231,8,4,0,0,-213,-5,-4,3,-97,-42,-4,1,2,-6,-116,37,0,2
"1255","11",159,1,3,0,2,-234,-3,-4,-4,241,1,4,4,2,1,-475,-4,-8,-8
"1256","11",155,5,2,0,1,3,0,0,0,-2,-15,0,0,2,-3,5,15,0,0
"1257","11",95,1,4,0,2,-248,-10,-4,-4,2,4,0,0,2,1,-250,-14,-4,-4
"1258","11",91,4,2,1,3,-19,1,-1,-1,7,-5,2,1,2,-2,-26,6,-3,-2
"1259","11",148,2,1,0,1,-214,-86,1,-3,-161,-92,2,-2,2,0,-53,6,-1,-1
"1260","11",443,1,1,0,0,-168,-151,-4,-4,96,96,1,1,2,1,-264,-247,-5,-5
"1261","11",411,2,2,1,2,241,242,-3,-3,239,239,4,4,2,0,2,3,-7,-7
"1262","11",262,6,4,1,3,79,94,1,1,57,61,1,1,2,-4,22,33,0,0
"1263","11",112,8,4,1,3,108,93,4,3,154,127,2,2,2,-6,-46,-34,2,1
"1264","11",432,5,2,0,1,22,-33,0,0,35,-32,0,0,2,-3,-13,-1,0,0
"1265","11",28,4,4,1,1,-36,-7,-1,-1,135,125,-2,-2,2,-2,-171,-132,1,1
"1266","11",276,8,4,1,3,202,-3,2,3,136,-2,2,2,2,-6,66,-1,0,1
"1267","11",2,7,4,1,1,97,30,1,2,66,73,-1,1,2,-5,31,-43,2,1
"1268","11",126,3,2,1,2,-3,-4,-2,-2,87,163,-1,-1,2,-1,-90,-167,-1,-1
"1269","11",175,7,4,0,1,-76,153,1,2,111,110,1,0,2,-5,-187,43,0,2
"1270","11",470,4,1,0,1,-93,32,-1,-1,34,58,1,1,2,-2,-127,-26,-2,-2
"1271","11",293,1,4,0,0,-140,32,-4,-4,-173,19,-4,-4,2,1,33,13,0,0
"1272","11",261,8,1,1,3,202,177,4,3,224,230,4,4,2,-6,-22,-53,0,-1
"1273","11",111,4,1,0,0,-217,27,-2,-1,-226,227,-4,-2,2,-2,9,-200,2,1
"1274","11",55,5,4,1,1,76,-5,1,0,38,-8,0,0,2,-3,38,3,1,0
"1275","11",327,5,4,1,3,141,0,1,0,134,3,1,-1,2,-3,7,-3,0,1
"1276","11",104,1,1,0,0,-239,1,-4,-4,236,1,1,-3,2,1,-475,0,-5,-1
"1277","11",48,1,3,0,0,0,0,-4,-4,95,-89,-4,-4,2,1,-95,89,0,0
"1278","11",178,5,1,1,1,-162,6,0,0,-3,1,0,0,2,-3,-159,5,0,0
"1279","11",15,7,4,0,3,90,-5,1,2,73,49,2,3,2,-5,17,-54,-1,-1
"1280","11",445,6,4,1,3,90,-78,1,1,84,-46,1,1,2,-4,6,-32,0,0
"1281","11",296,6,1,0,3,169,-17,2,1,193,21,2,2,2,-4,-24,-38,0,-1
"1282","11",82,2,4,1,2,-227,-16,-3,-3,224,-19,4,4,2,0,-451,3,-7,-7
"1283","11",139,1,4,1,2,-243,-6,-4,-4,-3,213,4,4,2,1,-240,-219,-8,-8
"1284","11",163,3,3,0,1,-135,4,-1,-2,76,60,1,2,2,-1,-211,-56,-2,-4
"1285","11",16,1,1,1,0,-230,16,-4,-4,108,21,1,-1,2,1,-338,-5,-5,-3
"1286","11",156,5,2,0,1,1,1,0,0,57,7,1,1,2,-3,-56,-6,-1,-1
"1287","11",96,3,1,0,0,-4,-5,-2,-2,5,-12,0,0,2,-1,-9,7,-2,-2
"1288","11",92,4,4,1,2,-158,-167,-1,-1,-192,-195,-1,-1,2,-2,34,28,0,0
"1289","11",149,5,3,0,1,-200,-16,-4,0,249,6,-3,1,2,-3,-449,-22,-1,-1
"1290","11",444,5,2,0,2,-2,-5,0,0,-2,4,0,0,2,-3,0,-9,0,0
"1291","11",412,9,1,1,0,-241,54,-4,4,217,134,4,4,2,-7,-458,-80,-8,0
"1292","11",263,2,4,1,0,-233,0,-3,-3,-242,2,-4,-4,2,0,9,-2,1,1
"1293","11",113,2,2,0,2,4,67,-2,-3,-226,204,-1,-4,2,0,230,-137,-1,1
"1294","11",433,1,1,0,0,-183,-211,-4,-4,171,171,3,-3,2,1,-354,-382,-7,-1
"1295","11",280,6,2,1,1,-99,54,-1,1,-71,-107,0,0,2,-4,-28,161,-1,1
"1296","11",277,1,4,0,1,-59,74,-4,-4,29,-95,0,0,2,1,-88,169,-4,-4
"1297","11",20,1,3,1,0,-115,-121,-2,-4,114,101,0,1,2,1,-229,-222,-2,-5
"1298","11",127,1,1,0,0,-235,-2,-4,-4,204,195,0,0,2,1,-439,-197,-4,-4
"1299","11",151,1,2,0,1,-247,9,4,-4,-152,3,4,-4,2,1,-95,6,0,0
"1300","11",447,6,4,0,2,117,7,2,1,67,6,2,2,2,-4,50,1,0,-1
"1301","11",294,9,1,0,3,-127,1,-1,4,163,5,2,2,2,-7,-290,-4,-3,2
"1302","11",84,7,4,1,3,232,3,2,2,73,3,2,2,2,-5,159,0,0,0
"1303","11",140,4,1,0,1,95,-40,1,-1,85,-51,2,2,2,-2,10,11,-1,-3
"1304","11",56,4,3,1,1,28,-115,-3,-1,110,-123,-2,0,2,-2,-82,8,-1,-1
"1305","11",328,2,3,1,1,-197,18,-3,-3,207,23,3,3,2,0,-404,-5,-6,-6
"1306","11",105,1,1,0,0,-221,86,-4,-4,193,67,-2,1,2,1,-414,19,-2,-5
"1307","11",49,5,4,1,1,156,124,0,0,141,49,2,2,2,-3,15,75,-2,-2
"1308","11",179,5,1,0,1,-4,-1,0,0,-4,-1,0,0,2,-3,0,0,0,0
"1309","11",150,5,3,0,1,1,-2,0,0,165,-1,1,1,2,-3,-164,-1,-1,-1
"1310","11",446,5,4,1,1,162,132,0,0,171,195,-2,0,2,-3,-9,-63,2,0
"1311","11",223,5,1,0,1,-157,-1,-1,0,165,0,-1,0,2,-3,-322,-1,0,0
"1312","11",83,6,1,0,3,153,-155,1,1,133,-128,2,1,2,-4,20,-27,-1,0
"1313","11",14,3,3,0,1,-49,-2,-1,-2,134,-31,0,0,2,-1,-183,29,-1,-2
"1314","11",164,4,2,0,2,-20,1,-1,-1,55,44,1,1,2,-2,-75,-43,-2,-2
"1315","11",160,6,2,0,0,-198,96,-4,1,-5,-1,-4,2,2,-4,-193,97,0,-1
"1316","11",157,1,3,1,2,-47,-20,-3,-4,153,123,-1,0,2,1,-200,-143,-2,-4
"1317","11",97,1,1,0,1,-243,-63,4,-4,203,222,0,2,2,1,-446,-285,4,-6
"1318","11",93,7,1,0,1,-133,-13,-2,2,60,-38,-1,-1,2,-5,-193,25,-1,3
"1319","11",153,7,1,0,3,-74,81,2,2,-72,-84,1,0,2,-5,-2,165,1,2
"1320","11",449,3,4,0,3,-163,28,1,-2,-78,75,2,0,2,-1,-85,-47,-1,-2
"1321","11",226,1,1,0,0,-135,-3,-2,-4,194,-2,3,-3,2,1,-329,-1,-5,-1
"1322","11",118,5,3,1,1,-21,14,-2,0,39,16,-1,2,2,-3,-60,-2,-1,-2
"1323","11",114,1,4,1,1,-48,-33,1,-4,165,164,1,-3,2,1,-213,-197,0,-1
"1324","11",434,6,4,1,3,73,-21,4,1,140,-10,2,1,2,-4,-67,-11,2,0
"1325","11",281,1,4,0,2,-232,4,4,-4,-8,235,4,-4,2,1,-224,-231,0,0
"1326","11",278,7,4,0,1,32,33,4,2,0,-1,4,-4,2,-5,32,34,0,6
"1327","11",200,1,3,0,0,-221,13,-4,-4,240,99,-3,-3,2,1,-461,-86,-1,-1
"1328","11",128,5,1,0,3,-32,8,0,0,169,-193,2,-1,2,-3,-201,201,-2,1
"1329","11",152,4,1,1,0,0,-1,0,-1,0,-1,0,0,2,-2,0,0,0,-1
"1330","11",448,1,2,0,2,-153,-3,-4,-4,230,0,0,0,2,1,-383,-3,-4,-4
"1331","11",295,5,1,0,1,1,-3,0,0,-1,-1,0,0,2,-3,2,-2,0,0
"1332","11",85,5,2,0,2,114,132,2,0,105,-91,2,1,2,-3,9,223,0,-1
"1333","11",141,2,1,1,0,-59,-66,-2,-3,236,227,-2,4,2,0,-295,-293,0,-7
"1334","11",57,1,4,1,1,-227,241,2,-4,134,-234,-2,0,2,1,-361,475,4,-4
"1335","11",329,9,4,1,3,-77,38,-4,4,129,68,2,3,2,-7,-206,-30,-6,1
"1336","11",106,6,2,0,1,-68,9,1,1,-69,29,1,1,2,-4,1,-20,0,0
"1337","11",5,1,2,0,2,-244,3,-3,-4,-189,11,-3,-4,2,1,-55,-8,0,0
"1338","11",18,2,3,0,1,-18,-66,1,-3,203,152,1,0,2,0,-221,-218,0,-3
"1339","11",119,3,3,1,3,-218,97,-2,-2,152,201,3,3,2,-1,-370,-104,-5,-5
"1340","11",228,5,4,1,2,-40,-6,0,0,-2,8,4,4,2,-3,-38,-14,-4,-4
"1341","11",224,3,2,0,2,-154,-73,-2,-2,140,90,2,1,2,-1,-294,-163,-4,-3
"1342","11",12,9,4,1,3,-2,-3,4,4,-1,-2,4,4,2,-7,-1,-1,0,0
"1343","11",116,9,2,0,3,76,-9,4,4,77,-21,1,2,2,-7,-1,12,3,2
"1344","11",436,7,4,1,3,88,12,4,2,40,16,4,-1,2,-5,48,-4,0,3
"1345","11",161,1,2,1,2,-245,244,-4,-4,127,101,1,-2,2,1,-372,143,-5,-2
"1346","11",206,2,4,1,0,-145,-76,-3,-3,222,226,2,4,2,0,-367,-302,-5,-7
"1347","11",98,1,3,0,0,-230,-44,-3,-4,171,-155,1,1,2,1,-401,111,-4,-5
"1348","11",13,3,4,1,1,5,-85,-2,-2,1,0,1,0,2,-1,4,-85,-3,-2
"1349","11",86,8,4,1,3,91,2,2,3,148,3,1,2,2,-6,-57,-1,1,1
"1350","11",227,4,3,1,3,58,52,1,-1,115,30,2,-1,2,-2,-57,22,-1,0
"1351","11",58,5,4,1,1,15,-249,0,0,3,242,4,4,2,-3,12,-491,-4,-4
"1352","11",188,8,2,0,3,193,0,3,3,176,-1,3,3,2,-6,17,1,0,0
"1353","11",115,5,3,0,3,4,-8,2,0,71,-6,0,1,2,-3,-67,-2,2,-1
"1354","11",435,2,4,1,1,-245,-10,-3,-3,142,-39,1,1,2,0,-387,29,-4,-4
"1355","11",282,9,3,0,3,180,-23,1,4,176,39,1,4,2,-7,4,-62,0,0
"1356","11",205,5,1,0,2,193,1,4,0,182,5,3,4,2,-3,11,-4,1,-4
"1357","11",201,2,3,1,1,-17,-2,-1,-3,117,0,1,-2,2,0,-134,-2,-2,-1
"1358","11",129,2,4,1,1,-227,0,-3,-3,-216,-1,-3,-3,2,0,-11,1,0,0
"1359","11",120,7,3,0,1,125,77,2,2,117,97,1,1,2,-5,8,-20,1,1
"1360","11",23,9,1,0,3,-203,-220,-4,4,207,210,4,4,2,-7,-410,-430,-8,0
"1361","11",437,3,1,1,0,178,-2,2,-2,137,2,2,2,2,-1,41,-4,0,-4
"1362","11",162,9,3,0,3,68,66,2,4,195,198,4,4,2,-7,-127,-132,-2,0
"1363","11",142,5,2,0,2,-122,22,-4,0,-143,13,-4,0,2,-3,21,9,0,0
"1364","11",99,5,4,1,3,0,8,0,0,225,-19,4,4,2,-3,-225,27,-4,-4
"1365","11",130,9,1,0,3,73,-60,4,4,62,-32,2,-3,2,-7,11,-28,2,7
"1366","11",107,7,2,1,3,71,150,-2,2,-204,73,-2,1,2,-5,275,77,0,1
"1367","11",50,3,2,0,1,2,-2,0,-2,-1,0,0,-2,2,-1,3,-2,0,0
"1368","11",180,5,2,0,2,-2,-1,0,0,18,8,0,-1,2,-3,-20,-9,0,1
"1369","11",220,1,4,0,2,-236,226,-4,-4,128,102,-4,-2,2,1,-364,124,0,-2
"1370","11",229,2,1,0,1,-240,242,-3,-3,-109,55,-1,-1,2,0,-131,187,-2,-2
"1371","11",225,1,2,0,2,-209,-5,-4,-4,35,-230,3,4,2,1,-244,225,-7,-8
"1372","11",283,7,1,0,1,-106,54,-2,2,205,93,-2,2,2,-5,-311,-39,0,0
"1373","11",117,1,4,1,2,-250,-4,-4,-4,-103,-1,-1,-1,2,1,-147,-3,-3,-3
"1374","11",202,4,1,0,1,58,110,2,-1,-11,125,-2,-1,2,-2,69,-15,4,0
"1375","11",182,6,4,1,3,4,-97,-1,1,-214,3,-4,-4,2,-4,218,-100,3,5
"1376","11",207,4,1,0,0,-249,-13,-2,-1,243,1,0,2,2,-2,-492,-14,-2,-3
"1377","11",11,7,4,1,1,190,220,0,2,208,209,4,4,2,-5,-18,11,-4,-2
"1378","11",438,8,4,1,3,2,2,0,3,99,-3,4,1,2,-6,-97,5,-4,2
"1379","11",22,3,3,1,1,-223,22,-2,-2,15,-238,2,3,2,-1,-238,260,-4,-5
"1380","11",208,1,4,1,2,-207,-191,-4,-4,185,129,2,2,2,1,-392,-320,-6,-6
"1381","11",59,2,1,0,0,-212,1,-3,-3,1,-111,3,3,2,0,-213,112,-6,-6
"1382","11",189,2,1,0,1,-220,18,3,-3,-178,16,3,-2,2,0,-42,2,0,-1
"1383","11",108,9,2,1,3,234,17,4,4,219,34,4,4,2,-7,15,-17,0,0
"1384","11",6,1,4,1,2,-134,0,-4,-4,24,-1,-1,-1,2,1,-158,1,-3,-3
"1385","11",181,5,4,0,3,-101,169,0,0,145,113,3,3,2,-3,-246,56,-3,-3
"1386","11",109,1,1,0,1,-38,1,4,-4,1,1,3,-4,2,1,-39,0,1,0
"1387","11",21,2,4,0,2,-69,-30,-2,-3,105,150,-1,-3,2,0,-174,-180,-1,0
"1388","11",60,5,1,0,3,7,-1,0,0,246,9,2,2,2,-3,-239,-10,-2,-2
"1389","11",222,2,1,0,0,-246,3,-4,-3,42,-4,0,0,2,0,-288,7,-4,-3
"1390","11",190,7,4,1,3,198,78,2,2,180,203,4,4,2,-5,18,-125,-2,-2
"1391","11",203,9,4,0,3,-14,-249,4,4,-16,-235,4,4,2,-7,2,-14,0,0
"1392","11",285,7,2,0,1,-151,32,-4,2,102,-37,-2,0,2,-5,-253,69,-2,2
"1393","11",191,3,1,0,0,-189,23,-2,-2,115,33,1,1,2,-1,-304,-10,-3,-3
"1394","11",204,6,3,0,1,2,-62,0,1,190,-123,0,0,2,-4,-188,61,0,1
"1395","11",131,8,4,1,3,39,1,0,3,-114,84,-3,3,2,-6,153,-83,3,0
"1396","11",212,4,1,1,1,101,44,0,-1,60,26,2,-1,2,-2,41,18,-2,0
"1397","11",51,1,4,0,1,-139,-75,-2,-4,138,108,0,-1,2,1,-277,-183,-2,-3
"1398","11",217,2,4,0,2,-69,30,-1,-3,-38,25,-1,-3,2,0,-31,5,0,0
"1399","11",221,3,4,1,1,4,4,-2,-2,69,-3,2,3,2,-1,-65,7,-4,-5
"1400","11",213,3,2,0,1,-115,0,-2,-2,-2,117,1,1,2,-1,-113,-117,-3,-3
"1401","11",52,1,3,1,0,-139,1,-2,-4,100,5,1,-2,2,1,-239,-4,-3,-2
"1402","11",284,1,3,1,1,-175,151,-4,-4,-198,-113,-3,-4,2,1,23,264,-1,0
"1403","11",64,1,1,0,1,-218,188,-3,-4,149,-43,-2,-2,2,1,-367,231,-1,-2
"1404","11",210,1,4,1,2,26,-20,1,-4,128,-107,3,-3,2,1,-102,87,-2,-1
"1405","11",183,5,4,1,1,27,21,0,0,78,139,0,-3,2,-3,-51,-118,0,3
"1406","11",187,2,4,0,2,94,113,-3,-3,34,67,1,1,2,0,60,46,-4,-4
"1407","11",211,4,3,0,1,-127,-104,-4,-1,80,93,2,4,2,-2,-207,-197,-6,-5
"1408","11",216,4,3,0,1,-116,-7,-1,-1,4,-4,-2,0,2,-2,-120,-3,1,-1
"1409","11",184,7,3,1,3,168,-1,2,2,168,-1,2,2,2,-5,0,0,0,0
"1410","11",209,6,4,1,3,-69,12,-1,1,-213,-4,-1,0,2,-4,144,16,0,1
"1411","11",196,2,3,1,0,-2,-242,-3,-3,246,248,4,4,2,0,-248,-490,-7,-7
"1412","11",19,2,2,0,2,-211,-163,1,-3,118,-75,1,-1,2,0,-329,-88,0,-2
"1413","11",214,9,1,0,3,84,-1,4,4,200,64,2,4,2,-7,-116,-65,2,0
"1414","11",193,2,1,0,0,-195,-203,-4,-3,114,51,3,1,2,0,-309,-254,-7,-4
"1415","11",186,3,2,1,2,-69,64,0,-2,7,10,0,0,2,-1,-76,54,0,-2
"1416","11",215,2,1,1,0,-191,17,-2,-3,151,31,-2,-3,2,0,-342,-14,0,0
"1417","11",195,1,1,0,1,-250,249,4,-4,15,-19,2,0,2,1,-265,268,2,-4
"1418","11",61,1,1,0,3,245,20,4,-4,233,-5,4,-4,2,1,12,25,0,0
"1419","11",219,3,4,1,3,249,1,4,-2,249,2,4,-2,2,-1,0,-1,0,0
"1420","11",218,8,4,1,3,-248,99,4,3,-216,90,4,3,2,-6,-32,9,0,0
"1421","11",185,4,4,1,2,25,-8,-3,-1,12,-13,-2,1,2,-2,13,5,-1,-2
"1422","11",62,4,2,1,3,-242,-218,4,-1,237,240,0,4,2,-2,-479,-458,4,-5
"1423","11",192,4,4,0,1,-1,86,1,-1,-4,-110,1,2,2,-2,3,196,0,-3
"1424","11",198,2,1,1,1,-214,126,-2,-3,128,-109,0,1,2,0,-342,235,-2,-4
"1425","11",197,4,4,1,3,-54,-14,4,-1,-177,-24,2,-2,2,-2,123,10,2,1
"1426","11",63,3,4,1,1,-1,0,0,-2,-1,0,0,0,2,-1,0,0,0,-2
"1427","11",53,7,4,1,3,188,5,2,2,208,0,3,2,2,-5,-20,5,-1,0
"1428","11",194,8,1,0,0,-166,36,-4,3,218,22,-3,3,2,-6,-384,14,-1,0
"1429","12",309,4,4,1,2,80,49,1,-1,96,53,-1,-1,3,-1,-16,-4,2,0
"1430","12",121,1,1,0,0,-63,12,-4,-4,242,-44,-1,-4,3,2,-305,56,-3,0
"1431","12",126,2,2,0,2,-88,-84,-3,-3,2,35,-2,-2,3,1,-90,-119,-1,-1
"1432","12",31,1,1,1,0,-118,73,-4,-4,-71,-105,-1,-1,3,2,-47,178,-3,-3
"1433","12",122,5,1,0,0,-204,-203,0,0,-14,-22,0,0,3,-2,-190,-181,0,0
"1434","12",127,1,1,0,0,-236,-2,-4,-4,-110,0,-4,-4,3,2,-126,-2,0,0
"1435","12",307,2,4,1,2,-163,-82,-3,-3,-186,-6,-3,-3,3,1,23,-76,0,0
"1436","12",125,3,4,1,0,-184,-16,-4,-2,240,-242,-3,-4,3,0,-424,226,-1,2
"1437","12",310,3,4,1,2,-54,-4,-1,-2,210,-1,2,2,3,0,-264,-3,-3,-4
"1438","12",128,6,1,0,3,154,-55,1,1,-34,-110,2,0,3,-3,188,55,-1,1
"1439","12",308,1,4,1,0,-249,-246,-4,-4,247,250,4,4,3,2,-496,-496,-8,-8
"1440","12",124,8,1,1,3,249,-1,3,3,250,0,3,2,3,-5,-1,-1,0,1
"1441","12",311,1,2,0,2,-218,8,-4,-4,185,9,4,-4,3,2,-403,-1,-8,0
"1442","12",462,9,3,1,3,236,78,4,4,235,148,4,4,3,-6,1,-70,0,0
"1443","12",313,7,3,1,0,50,55,2,2,107,114,1,1,3,-4,-57,-59,1,1
"1444","12",312,5,4,1,1,74,95,0,0,-60,133,1,0,3,-2,134,-38,-1,0
"1445","12",123,2,4,1,2,-191,39,-3,-3,-202,29,-3,-3,3,1,11,10,0,0
"1446","12",395,8,3,1,1,-163,33,-2,3,163,13,-1,3,3,-5,-326,20,-1,0
"1447","12",314,1,4,1,1,-242,10,4,-4,-241,21,4,-4,3,2,-1,-11,0,0
"1448","12",319,6,1,0,1,72,-80,1,1,48,50,1,2,3,-3,24,-130,0,-1
"1449","12",391,5,2,0,3,181,238,0,0,164,153,0,0,3,-2,17,85,0,0
"1450","12",302,3,1,1,0,-120,-27,-2,-2,210,72,-2,-2,3,0,-330,-99,0,0
"1451","12",129,3,4,1,1,-212,1,-2,-2,-216,5,-3,-3,3,0,4,-4,1,1
"1452","12",32,3,1,0,1,149,25,4,-2,181,-149,2,-2,3,0,-32,174,2,0
"1453","12",348,5,3,1,1,33,26,-3,0,55,60,0,-1,3,-2,-22,-34,-3,1
"1454","12",13,3,4,1,1,-32,-92,-2,-2,-1,-45,-1,-2,3,0,-31,-47,-1,0
"1455","12",320,4,2,0,2,-176,146,-2,-1,-130,123,-2,-1,3,-1,-46,23,0,0
"1456","12",349,4,4,1,1,-89,-70,0,-1,-126,104,1,3,3,-1,37,-174,-1,-4
"1457","12",318,1,2,0,2,-175,-156,-4,-4,179,184,-4,0,3,2,-354,-340,0,-4
"1458","12",463,9,4,1,3,79,-35,1,4,240,-2,0,4,3,-6,-161,-33,1,0
"1459","12",394,1,3,0,0,-250,248,-4,-4,-248,246,-4,-4,3,2,-2,2,0,0
"1460","12",301,4,4,1,1,-85,1,-1,-1,56,-1,3,2,3,-1,-141,2,-4,-3
"1461","12",464,5,1,0,1,-161,-7,1,0,-27,29,1,1,3,-2,-134,-36,0,-1
"1462","12",131,8,4,1,3,124,-43,2,3,30,17,0,3,3,-5,94,-60,2,0
"1463","12",396,1,1,0,1,-247,245,4,-4,-113,13,4,-4,3,2,-134,232,0,0
"1464","12",315,8,3,0,3,244,16,4,3,19,234,4,3,3,-5,225,-218,0,0
"1465","12",465,9,4,0,3,150,20,3,4,227,11,3,3,3,-6,-77,9,0,1
"1466","12",392,4,1,0,0,-98,-96,-1,-1,-78,-46,-1,-2,3,-1,-20,-50,0,1
"1467","12",344,7,4,1,3,226,-31,4,2,-170,-35,-1,-1,3,-4,396,4,5,3
"1468","12",466,3,3,1,0,-101,-70,-2,-2,-89,-64,-1,-1,3,0,-12,-6,-1,-1
"1469","12",393,1,1,0,0,-189,-32,-4,-4,2,-1,4,0,3,2,-191,-31,-8,-4
"1470","12",345,1,1,1,0,-80,59,-4,-4,49,-187,-4,-4,3,2,-129,246,0,0
"1471","12",130,9,1,0,3,196,26,4,4,79,-37,4,4,3,-6,117,63,0,0
"1472","12",321,1,1,0,0,-222,-137,-3,-4,-140,-145,-2,-3,3,2,-82,8,-1,-1
"1473","12",35,6,1,0,3,61,156,0,1,166,206,4,-1,3,-3,-105,-50,-4,2
"1474","12",346,7,3,1,0,-242,-121,-4,2,189,2,3,3,3,-4,-431,-123,-7,-1
"1475","12",468,7,1,0,3,77,-61,2,2,153,102,2,1,3,-4,-76,-163,0,1
"1476","12",245,2,1,0,0,-173,-4,-2,-3,-101,-3,-2,-3,3,1,-72,-1,0,0
"1477","12",209,5,4,1,3,-111,-10,-1,0,-210,2,1,-2,3,-2,99,-12,-2,2
"1478","12",3,3,3,0,0,-1,-3,2,-2,-178,184,-3,-3,3,0,177,-187,5,1
"1479","12",303,2,3,0,2,-223,-94,-3,-3,-185,-121,-2,-2,3,1,-38,27,-1,-1
"1480","12",384,3,1,1,0,-67,0,-2,-2,1,1,-2,-2,3,0,-68,-1,0,0
"1481","12",297,3,3,1,2,74,36,1,-2,23,24,1,-1,3,0,51,12,0,-1
"1482","12",98,1,3,1,0,-228,44,-3,-4,170,-141,1,1,3,2,-398,185,-4,-5
"1483","12",398,3,4,1,2,-56,30,-2,-2,-106,38,-2,-2,3,0,50,-8,0,0
"1484","12",467,3,1,0,3,179,190,3,-2,140,125,4,0,3,0,39,65,-1,-2
"1485","12",470,4,1,1,1,-89,34,-1,-1,-45,73,-1,-1,3,-1,-44,-39,0,0
"1486","12",22,5,3,1,1,36,-15,0,0,67,-11,1,1,3,-2,-31,-4,-1,-1
"1487","12",33,5,3,0,1,87,-30,-1,0,-208,56,-2,2,3,-2,295,-86,1,-2
"1488","12",299,7,4,1,1,185,48,2,2,120,142,1,1,3,-4,65,-94,1,1
"1489","12",306,5,3,0,3,145,91,1,0,100,86,1,0,3,-2,45,5,0,0
"1490","12",350,7,4,1,1,5,247,4,2,247,7,4,1,3,-4,-242,240,0,1
"1491","12",347,6,1,0,3,72,-87,-1,1,79,-175,1,3,3,-3,-7,88,-2,-2
"1492","12",132,6,4,1,1,11,100,1,1,6,103,1,1,3,-3,5,-3,0,0
"1493","12",397,7,4,1,3,91,-18,1,2,110,-87,2,4,3,-4,-19,69,-1,-2
"1494","12",316,4,3,0,0,-106,-7,-1,-1,-95,-36,-1,-1,3,-1,-11,29,0,0
"1495","12",47,7,4,0,3,94,-92,1,2,110,-2,3,1,3,-4,-16,-90,-2,1
"1496","12",340,4,1,0,1,-68,-20,0,-1,78,13,0,0,3,-1,-146,-33,0,-1
"1497","12",317,5,4,1,2,1,0,0,0,34,-40,1,1,3,-2,-33,40,-1,-1
"1498","12",298,1,1,0,0,-240,12,-2,-4,10,-174,1,1,3,2,-250,186,-3,-5
"1499","12",305,7,4,1,3,80,92,2,2,98,191,1,2,3,-4,-18,-99,1,0
"1500","12",399,6,4,1,3,121,9,1,1,123,19,1,1,3,-3,-2,-10,0,0
"1501","12",1,7,1,0,1,-45,20,1,2,148,129,1,2,3,-4,-193,-109,0,0
"1502","12",322,6,4,1,3,34,-36,1,1,234,-237,4,4,3,-3,-200,201,-3,-3
"1503","12",220,1,4,0,2,-237,198,-4,-4,137,109,-2,-2,3,2,-374,89,-2,-2
"1504","12",388,1,4,1,0,-241,10,-4,-4,-242,2,-1,1,3,2,1,8,-3,-5
"1505","12",469,1,4,1,0,78,16,-2,-4,135,21,-2,-4,3,2,-57,-5,0,0
"1506","12",246,8,4,1,3,120,-2,3,3,3,-42,2,1,3,-5,117,40,1,2
"1507","12",21,2,4,1,2,-121,-61,-2,-3,92,105,-2,-2,3,1,-213,-166,0,-1
"1508","12",30,4,2,0,2,-161,-2,-2,-1,172,5,3,3,3,-1,-333,-7,-5,-4
"1509","12",304,2,2,0,2,-229,-23,-3,-3,107,-13,2,2,3,1,-336,-10,-5,-5
"1510","12",385,6,4,1,1,-33,-184,-1,1,85,38,2,1,3,-3,-118,-222,-3,0
"1511","12",2,5,4,1,1,-83,41,1,0,63,-82,-2,2,3,-2,-146,123,3,-2
"1512","12",99,5,4,1,3,4,9,0,0,-3,3,0,0,3,-2,7,6,0,0
"1513","12",341,9,1,0,3,246,-27,3,4,236,-30,4,4,3,-6,10,3,-1,0
"1514","12",390,1,2,0,2,61,-2,-4,-4,110,-42,0,0,3,2,-49,40,-4,-4
"1515","12",471,6,3,0,2,3,19,-1,1,34,-190,-2,-2,3,-3,-31,209,1,3
"1516","12",334,1,4,1,0,-236,129,-4,-4,-231,38,-4,-4,3,2,-5,91,0,0
"1517","12",330,2,2,1,2,-248,1,0,-3,201,146,1,1,3,1,-449,-145,-1,-4
"1518","12",76,7,4,1,3,138,4,-1,2,146,4,2,2,3,-4,-8,0,-3,0
"1519","12",165,3,1,0,1,63,64,-2,-2,47,36,0,0,3,0,16,28,-2,-2
"1520","12",351,1,1,0,0,-245,-244,-4,-4,119,123,-4,-4,3,2,-364,-367,0,0
"1521","12",199,2,4,0,2,-197,181,-3,-3,161,72,1,1,3,1,-358,109,-4,-4
"1522","12",133,2,2,0,1,-74,-93,1,-3,-103,-179,1,-1,3,1,29,86,0,-2
"1523","12",352,5,2,1,1,7,-7,0,0,14,-8,0,0,3,-2,-7,1,0,0
"1524","12",39,3,3,1,1,-71,34,-1,-2,140,-169,3,2,3,0,-211,203,-4,-4
"1525","12",66,4,1,0,1,-52,0,1,-1,99,-2,4,1,3,-1,-151,2,-3,-2
"1526","12",333,6,4,1,1,62,-9,1,1,-115,117,0,1,3,-3,177,-126,1,0
"1527","12",236,5,1,1,1,24,-32,0,0,22,-38,0,0,3,-2,2,6,0,0
"1528","12",232,1,1,0,0,-237,-59,-2,-4,-182,-30,-2,-4,3,2,-55,-29,0,0
"1529","12",382,6,4,1,2,76,-7,-2,1,51,0,1,1,3,-3,25,-7,-3,0
"1530","12",4,6,3,1,1,177,-1,1,1,238,230,3,3,3,-3,-61,-231,-2,-2
"1531","12",10,4,3,0,1,-25,-1,-1,-1,203,0,2,2,3,-1,-228,-1,-3,-3
"1532","12",323,5,4,0,1,-2,-126,0,0,175,-3,0,0,3,-2,-177,-123,0,0
"1533","12",221,5,4,0,1,-2,4,0,0,-2,0,1,1,3,-2,0,4,-1,-1
"1534","12",389,5,3,0,2,11,-2,0,0,1,8,-1,0,3,-2,10,-10,1,0
"1535","12",65,7,1,0,3,-132,-20,0,2,21,-18,1,1,3,-4,-153,-2,-1,1
"1536","12",247,4,3,1,0,152,-12,-1,-1,212,-15,1,1,3,-1,-60,3,-2,-2
"1537","12",210,2,4,1,2,26,-31,2,-3,121,-61,1,-4,3,1,-95,30,1,1
"1538","12",300,4,1,0,0,-67,85,0,-1,-71,93,0,0,3,-1,4,-8,0,-1
"1539","12",134,1,2,0,2,-225,-2,-2,-4,-131,-9,-1,-4,3,2,-94,7,-1,0
"1540","12",353,8,2,1,2,0,0,1,3,244,81,-4,3,3,-5,-244,-81,5,0
"1541","12",20,5,3,1,0,35,23,-2,0,-155,-139,-2,0,3,-2,190,162,0,0
"1542","12",67,2,1,0,0,-28,30,-3,-3,141,-145,1,1,3,1,-169,175,-4,-4
"1543","12",342,4,3,1,1,6,-165,3,-1,25,-187,1,-2,3,-1,-19,22,2,1
"1544","12",241,1,4,0,2,-242,-57,-4,-4,169,126,2,0,3,2,-411,-183,-6,-4
"1545","12",472,1,1,1,0,-68,11,-4,-4,10,10,-3,-4,3,2,-78,1,-1,0
"1546","12",335,3,2,0,1,-119,28,-2,-2,-100,27,-1,-1,3,0,-19,1,-1,-1
"1547","12",331,2,1,1,0,-33,-20,-4,-3,-27,30,-4,-3,3,1,-6,-50,0,0
"1548","12",77,6,3,1,1,94,-1,1,1,106,-4,1,1,3,-3,-12,3,0,0
"1549","12",166,1,4,1,2,162,179,-2,-4,202,173,-2,1,3,2,-40,6,0,-5
"1550","12",400,2,4,0,2,-72,70,-3,-3,13,-16,3,2,3,1,-85,86,-6,-5
"1551","12",101,1,3,0,0,-236,239,-4,-4,206,202,-3,-3,3,2,-442,37,-1,-1
"1552","12",474,1,1,0,0,2,-108,-4,-4,1,-113,-4,-4,3,2,1,5,0,0
"1553","12",248,5,4,1,3,232,12,0,0,12,233,-1,2,3,-2,220,-221,1,-2
"1554","12",244,8,4,1,2,211,226,3,3,200,208,2,2,3,-5,11,18,1,1
"1555","12",387,2,3,0,1,-147,-151,-2,-3,151,141,2,3,3,1,-298,-292,-4,-6
"1556","12",168,7,1,1,3,150,-93,3,2,79,68,1,1,3,-4,71,-161,2,1
"1557","12",237,2,2,0,2,-250,110,-2,-3,88,2,1,0,3,1,-338,108,-3,-3
"1558","12",233,5,2,0,2,-239,-20,0,0,-53,22,0,0,3,-2,-186,-42,0,0
"1559","12",383,5,4,1,1,1,-4,0,0,1,-4,0,0,3,-2,0,0,0,0
"1560","12",40,6,1,0,2,-177,58,2,1,162,93,-3,-2,3,-3,-339,-35,5,3
"1561","12",100,8,4,0,3,195,-7,3,3,-175,6,-2,-2,3,-5,370,-13,5,5
"1562","12",324,1,2,0,0,-232,5,-4,-4,3,1,-1,-1,3,2,-235,4,-3,-3
"1563","12",222,2,1,0,0,-249,-4,-3,-3,-238,-2,-3,-3,3,1,-11,-2,0,0
"1564","12",243,2,2,1,2,-249,109,-4,-3,-215,-249,-3,-1,3,1,-34,358,-1,-2
"1565","12",386,1,1,0,0,-242,-247,-4,-4,-7,7,-1,-2,3,2,-235,-254,-3,-2
"1566","12",167,7,1,0,3,-124,-160,2,2,178,-166,3,3,3,-4,-302,6,-1,-1
"1567","12",211,9,3,1,1,25,29,3,4,-12,-14,1,3,3,-6,37,43,2,1
"1568","12",79,3,4,1,2,-204,185,-2,-2,-202,202,-3,-3,3,0,-2,-17,1,1
"1569","12",135,2,1,0,1,-179,101,-3,-3,-27,6,-1,-1,3,1,-152,95,-2,-2
"1570","12",354,6,1,0,0,-59,-90,1,1,166,161,2,3,3,-3,-225,-251,-1,-2
"1571","12",200,1,3,0,0,-230,-170,-4,-4,-167,-14,-4,-3,3,2,-63,-156,0,-1
"1572","12",68,2,4,1,0,72,0,-2,-3,201,1,1,-2,3,1,-129,-1,-3,-1
"1573","12",343,5,2,1,2,-55,1,0,0,-40,0,-1,-1,3,-2,-15,1,1,1
"1574","12",242,4,4,1,2,13,-1,1,-1,14,1,1,-2,3,-1,-1,-2,0,1
"1575","12",473,6,3,1,0,22,-34,1,1,4,9,0,0,3,-3,18,-43,1,1
"1576","12",336,2,4,0,3,178,148,2,-3,207,109,3,-3,3,1,-29,39,-1,0
"1577","12",332,4,1,0,0,-234,80,-3,-1,-221,55,-1,0,3,-1,-13,25,-2,-1
"1578","12",78,3,4,1,0,41,-1,-2,-2,-229,12,-2,-3,3,0,270,-13,0,1
"1579","12",325,9,1,1,1,-34,-23,-3,4,-84,-80,-3,4,3,-6,50,57,0,0
"1580","12",401,2,2,0,1,-119,-106,-1,-3,119,15,0,0,3,1,-238,-121,-1,-3
"1581","12",102,4,4,1,3,-41,68,2,-1,-67,-166,3,4,3,-1,26,234,-1,-5
"1582","12",475,5,3,1,3,42,-98,1,0,-70,10,-3,-2,3,-2,112,-108,4,2
"1583","12",249,1,3,1,0,-10,-94,-3,-4,-55,-47,-3,-4,3,2,45,-47,0,0
"1584","12",176,6,1,0,1,-67,0,-4,1,132,46,-3,-4,3,-3,-199,-46,-1,5
"1585","12",169,1,3,0,0,-199,-84,-4,-4,-158,-104,-4,-4,3,2,-41,20,0,0
"1586","12",363,2,3,0,3,-249,-1,-3,-3,-244,1,-3,-3,3,1,-5,-2,0,0
"1587","12",238,3,3,1,1,-1,-27,1,-2,140,-107,1,1,3,0,-141,80,0,-3
"1588","12",234,7,3,0,3,162,48,1,2,142,34,1,2,3,-4,20,14,0,0
"1589","12",460,3,1,0,0,-192,9,-3,-2,129,18,-3,1,3,0,-321,-9,0,-3
"1590","12",380,3,4,1,1,-83,-39,3,-2,-132,-34,3,-3,3,0,49,-5,0,1
"1591","12",377,3,1,0,0,243,8,-4,-2,243,10,4,0,3,0,0,-2,-8,-2
"1592","12",373,1,3,0,0,-246,-28,0,-4,-225,-34,0,-4,3,2,-21,6,0,0
"1593","12",223,5,1,0,1,-136,1,-1,0,77,-1,-1,0,3,-2,-213,2,0,0
"1594","12",90,3,4,1,0,-122,8,4,-2,96,17,1,1,3,0,-218,-9,3,-3
"1595","12",171,5,1,0,1,27,15,0,0,21,31,0,0,3,-2,6,-16,0,0
"1596","12",362,6,4,1,3,154,-109,3,1,106,133,4,1,3,-3,48,-242,-1,0
"1597","12",212,5,1,0,1,-64,17,0,0,-101,-48,2,-3,3,-2,37,65,-2,3
"1598","12",8,5,3,1,1,-173,173,-1,0,81,206,1,2,3,-2,-254,-33,-2,-2
"1599","12",136,3,1,0,0,0,0,-3,-2,195,-148,-4,-4,3,0,-195,148,1,2
"1600","12",355,3,2,1,2,-90,19,-4,-2,-179,129,-4,-4,3,0,89,-110,0,2
"1601","12",201,1,3,1,1,-74,-1,-3,-4,31,-1,1,-3,3,2,-105,0,-4,-1
"1602","12",69,5,4,0,1,18,88,1,0,-52,29,-1,-1,3,-2,70,59,2,1
"1603","12",424,3,2,0,2,-31,-8,-3,-2,140,94,1,-1,3,0,-171,-102,-4,-1
"1604","12",420,6,4,1,3,-1,109,2,1,0,-1,1,2,3,-3,-1,110,1,-1
"1605","12",170,1,2,0,0,-232,-234,-4,-4,14,20,0,0,3,2,-246,-254,-4,-4
"1606","12",337,9,2,0,3,12,-9,4,4,246,-10,4,4,3,-6,-234,1,0,0
"1607","12",114,2,4,1,1,-20,-38,1,-3,213,209,1,-3,3,1,-233,-247,0,0
"1608","12",110,6,1,0,1,-106,150,-4,1,146,93,3,1,3,-3,-252,57,-7,0
"1609","12",326,7,4,1,2,151,80,2,2,102,61,2,2,3,-4,49,19,0,0
"1610","12",402,1,3,1,0,-247,4,-4,-4,196,-1,4,-1,3,2,-443,5,-8,-3
"1611","12",103,7,2,0,3,161,1,-1,2,56,-126,1,2,3,-4,105,127,-2,0
"1612","12",476,6,3,1,0,96,-131,1,1,-85,-84,-1,1,3,-3,181,-47,2,0
"1613","12",25,3,4,1,2,-119,-132,-1,-2,-106,-121,0,-2,3,0,-13,-11,-1,0
"1614","12",177,6,4,1,1,-62,-62,4,1,-63,72,3,0,3,-3,1,-134,1,1
"1615","12",17,1,3,0,0,-137,43,-3,-4,138,86,-2,-4,3,2,-275,-43,-1,0
"1616","12",364,6,3,0,1,91,7,1,1,-36,1,0,0,3,-3,127,6,1,1
"1617","12",239,3,1,0,1,128,186,2,-2,162,-75,2,2,3,0,-34,261,0,-4
"1618","12",235,6,3,1,0,93,4,1,1,61,-2,1,1,3,-3,32,6,0,0
"1619","12",461,5,4,1,2,115,26,2,0,54,46,1,-1,3,-2,61,-20,1,1
"1620","12",381,6,2,0,2,66,96,2,1,242,236,4,4,3,-3,-176,-140,-2,-3
"1621","12",378,3,4,1,1,-199,1,1,-2,97,2,1,1,3,0,-296,-1,0,-3
"1622","12",374,5,4,1,2,-55,-10,0,0,-8,-12,0,0,3,-2,-47,2,0,0
"1623","12",224,2,2,1,2,-188,-27,-3,-3,169,97,2,1,3,1,-357,-124,-5,-4
"1624","12",91,6,2,0,3,65,-1,2,1,44,5,2,1,3,-3,21,-6,0,0
"1625","12",172,9,2,0,3,-100,158,4,4,141,137,0,0,3,-6,-241,21,4,4
"1626","12",339,4,3,1,1,-25,-38,-2,-1,-40,-14,-1,-1,3,-1,15,-24,-1,0
"1627","12",213,4,2,0,1,-1,108,1,-1,-40,4,1,-1,3,-1,39,104,0,0
"1628","12",80,7,4,1,3,192,-9,2,2,211,1,2,-2,3,-4,-19,-10,0,4
"1629","12",137,5,1,0,1,-122,-17,-3,0,61,78,-3,0,3,-2,-183,-95,0,0
"1630","12",356,6,4,1,1,129,0,1,1,104,72,1,2,3,-3,25,-72,0,-1
"1631","12",202,6,1,0,1,50,38,2,1,36,61,-2,-1,3,-3,14,-23,4,2
"1632","12",7,7,1,1,3,10,-7,1,2,110,48,2,1,3,-4,-100,-55,-1,1
"1633","12",425,6,4,1,2,71,89,0,1,79,26,1,1,3,-3,-8,63,-1,0
"1634","12",421,5,3,1,1,24,25,0,0,51,53,0,3,3,-2,-27,-28,0,-3
"1635","12",87,7,4,1,3,94,16,2,2,7,-5,0,1,3,-4,87,21,2,1
"1636","12",338,4,3,1,2,100,88,-1,-1,101,103,-2,-2,3,-1,-1,-15,1,1
"1637","12",115,5,3,1,3,49,-3,0,0,91,1,0,1,3,-2,-42,-4,0,-1
"1638","12",111,2,1,1,0,-222,233,-4,-3,31,-34,1,-1,3,1,-253,267,-5,-2
"1639","12",327,6,4,1,3,165,0,2,1,101,-33,1,0,3,-3,64,33,1,1
"1640","12",403,3,1,0,0,-149,-17,1,-2,19,-74,2,1,3,0,-168,57,-1,-3
"1641","12",104,2,1,1,0,-243,0,-4,-3,-231,1,1,-4,3,1,-12,-1,-5,1
"1642","12",48,1,3,0,0,-3,-4,-4,-4,81,-78,-4,-4,3,2,-84,74,0,0
"1643","12",250,6,1,1,3,97,38,1,1,80,21,1,1,3,-3,17,17,0,0
"1644","12",178,5,1,0,1,-3,1,0,0,-3,0,0,0,3,-2,0,1,0,0
"1645","12",174,5,4,1,3,151,144,1,0,182,197,1,0,3,-2,-31,-53,0,0
"1646","12",365,1,3,1,1,-208,3,0,-4,-248,-1,0,-4,3,2,40,4,0,0
"1647","12",24,1,2,0,2,-249,246,-4,-4,250,1,4,4,3,2,-499,245,-8,-8
"1648","12",82,1,4,1,2,-238,-12,-4,-4,-225,-18,4,0,3,2,-13,6,-8,-4
"1649","12",139,1,4,1,2,-190,2,-4,-4,0,236,4,4,3,2,-190,-234,-8,-8
"1650","12",358,1,4,1,2,-28,93,-3,-4,-213,200,-4,-4,3,2,185,-107,1,0
"1651","12",379,1,3,0,1,6,15,1,-4,-15,-39,1,0,3,2,21,54,0,-4
"1652","12",375,4,3,1,1,-103,25,-1,-1,0,1,0,0,3,-1,-103,24,-1,-1
"1653","12",225,3,2,1,2,-205,-96,-2,-2,119,-152,2,2,3,0,-324,56,-4,-4
"1654","12",92,4,4,1,2,-38,-60,-1,-1,-174,-168,-1,-1,3,-1,136,108,0,0
"1655","12",173,5,4,1,3,73,20,0,0,175,11,0,0,3,-2,-102,9,0,0
"1656","12",34,6,4,1,2,106,-95,1,1,68,-52,1,1,3,-3,38,-43,0,0
"1657","12",214,9,1,0,3,137,-1,4,4,222,-1,4,4,3,-6,-85,0,0,0
"1658","12",81,1,1,0,0,-239,93,-4,-4,-213,132,4,1,3,2,-26,-39,-8,-5
"1659","12",138,4,3,1,1,-43,-44,-1,-1,-22,-22,0,0,3,-1,-21,-22,-1,-1
"1660","12",357,6,4,1,2,87,-20,1,1,60,-78,1,1,3,-3,27,58,0,0
"1661","12",203,9,4,1,3,-14,-55,4,4,-15,-236,4,4,3,-6,1,181,0,0
"1662","12",70,1,2,0,2,-236,-229,4,-4,115,64,1,-4,3,2,-351,-293,3,0
"1663","12",426,9,4,1,3,239,-1,4,4,186,-6,-2,-2,3,-6,53,5,6,6
"1664","12",422,5,3,0,1,-109,-241,3,0,-54,-235,4,-2,3,-2,-55,-6,-1,2
"1665","12",88,2,4,1,2,-231,-11,-3,-3,191,-212,4,4,3,1,-422,201,-7,-7
"1666","12",367,4,3,1,1,-85,-80,2,-1,-80,-73,2,0,3,-1,-5,-7,0,-1
"1667","12",116,1,2,1,3,-193,-19,4,-4,85,-16,1,1,3,2,-278,-3,3,-5
"1668","12",112,8,4,1,3,24,245,4,3,81,161,3,3,3,-5,-57,84,1,0
"1669","12",328,3,3,1,1,-117,18,-2,-2,217,23,3,3,3,0,-334,-5,-5,-5
"1670","12",404,5,1,1,1,80,-99,1,0,42,-51,1,0,3,-2,38,-48,0,0
"1671","12",105,5,1,1,0,-47,-13,-2,0,137,32,2,0,3,-2,-184,-45,-4,0
"1672","12",49,4,4,1,1,8,11,-1,-1,-4,0,-1,-1,3,-1,12,11,0,0
"1673","12",251,6,3,0,1,-1,-220,1,1,1,-236,0,-2,3,-3,-2,16,1,3
"1674","12",179,5,1,0,1,1,4,0,0,-12,3,0,4,3,-2,13,1,0,-4
"1675","12",175,6,4,0,1,175,-18,2,1,0,-51,1,2,3,-3,175,33,1,-1
"1676","12",366,8,4,1,3,128,54,2,3,145,-127,4,2,3,-5,-17,181,-2,1
"1677","12",240,1,2,0,1,-160,8,-2,-4,50,-117,2,-2,3,2,-210,125,-4,-2
"1678","12",83,7,1,1,3,120,-135,1,2,131,-126,4,1,3,-4,-11,-9,-3,1
"1679","12",14,2,3,1,1,-31,-1,-3,-3,150,-26,0,0,3,1,-181,25,-3,-3
"1680","12",359,9,4,1,3,237,11,4,4,229,12,4,4,3,-6,8,-1,0,0
"1681","12",38,5,4,0,3,0,-3,0,0,38,-109,0,0,3,-2,-38,106,0,0
"1682","12",376,3,4,1,1,78,-14,-1,-2,119,-41,-1,0,3,0,-41,27,0,-2
"1683","12",226,1,1,0,0,43,-3,-2,-4,159,1,3,-3,3,2,-116,-4,-5,-1
"1684","12",93,6,1,0,1,-61,9,-1,1,42,-41,-1,0,3,-3,-103,50,0,1
"1685","12",9,4,4,1,2,33,21,1,-1,78,19,1,-1,3,-1,-45,2,0,0
"1686","12",417,3,2,0,2,-109,-76,-2,-2,-11,-17,-3,-2,3,0,-98,-59,1,0
"1687","12",215,2,1,1,0,-64,21,-2,-3,119,34,-2,-3,3,1,-183,-13,0,0
"1688","12",413,3,1,0,1,-40,-11,-2,-2,112,-180,2,2,3,0,-152,169,-4,-4
"1689","12",41,6,2,0,3,33,68,2,1,96,41,2,1,3,-3,-63,27,0,0
"1690","12",406,2,2,0,2,-172,-150,-2,-3,4,-6,2,1,3,1,-176,-144,-4,-4
"1691","12",204,5,3,1,1,28,-14,0,0,-152,-168,0,0,3,-2,180,154,0,0
"1692","12",71,4,3,1,1,-43,11,-1,-1,28,23,-1,0,3,-1,-71,-12,0,-1
"1693","12",427,2,4,0,1,-245,-25,2,-3,236,-54,3,-3,3,1,-481,29,-1,0
"1694","12",423,5,1,0,3,-109,-29,1,0,7,-222,-1,1,3,-2,-116,193,2,-1
"1695","12",89,3,3,1,0,-237,1,-2,-2,-239,3,-4,-4,3,0,2,-2,2,2
"1696","12",368,9,3,1,3,-173,143,4,4,-106,122,4,4,3,-6,-67,21,0,0
"1697","12",117,1,4,0,2,-208,-3,-4,-4,-162,1,-3,-3,3,2,-46,-4,-1,-1
"1698","12",113,2,2,0,2,-209,247,-2,-3,-203,242,-3,-3,3,1,-6,5,1,0
"1699","12",329,8,4,1,3,-207,-15,-3,3,-113,52,-4,3,3,-5,-94,-67,1,0
"1700","12",405,4,4,1,1,-28,27,1,-1,108,-84,1,-1,3,-1,-136,111,0,0
"1701","12",106,7,2,0,1,90,21,3,2,-43,40,2,2,3,-4,133,-19,1,0
"1702","12",5,1,2,0,2,-243,120,-3,-4,-234,8,-2,-4,3,2,-9,112,-1,0
"1703","12",252,5,4,1,1,-127,-79,0,0,-157,82,-1,-1,3,-2,30,-161,1,1
"1704","12",18,4,3,1,1,-1,17,1,-1,103,33,1,-3,3,-1,-104,-16,0,2
"1705","12",370,9,1,0,3,-235,-15,-4,4,237,-14,-4,-4,3,-6,-472,-1,0,8
"1706","12",419,6,4,1,3,201,132,1,1,168,120,1,0,3,-3,33,12,0,1
"1707","12",217,2,4,1,2,-85,27,-1,-3,-36,22,-1,-3,3,1,-49,5,0,0
"1708","12",84,7,4,1,3,217,2,3,2,188,1,2,2,3,-4,29,1,1,0
"1709","12",140,5,1,1,1,53,-57,2,0,54,-45,0,-1,3,-2,-1,-12,2,1
"1710","12",36,8,3,1,3,168,-77,3,3,-167,95,3,-3,3,-5,335,-172,0,6
"1711","12",206,4,4,1,0,-34,24,-2,-1,-47,33,-2,1,3,-1,13,-9,0,-2
"1712","12",230,7,1,0,0,-79,14,-3,2,-60,13,-3,2,3,-4,-19,1,0,0
"1713","12",227,4,3,1,3,143,67,1,-1,54,18,-2,-1,3,-1,89,49,3,0
"1714","12",94,3,4,1,1,-32,-33,-1,-2,189,-173,1,3,3,0,-221,140,-2,-5
"1715","12",37,1,1,0,0,-171,-12,-3,-4,-159,-17,-3,-4,3,2,-12,5,0,0
"1716","12",418,4,2,1,2,-116,-37,1,-1,-208,185,-4,-2,3,-1,92,-222,5,1
"1717","12",216,4,3,1,1,-69,-13,-1,-1,59,15,-1,0,3,-1,-128,-28,0,-1
"1718","12",414,7,1,0,0,4,7,2,2,115,111,2,2,3,-4,-111,-104,0,0
"1719","12",410,2,1,0,0,-98,-27,1,-3,-54,64,1,-2,3,1,-44,-91,0,-1
"1720","12",407,1,2,1,2,212,70,-4,-4,156,52,2,2,3,2,56,18,-6,-6
"1721","12",205,9,1,0,2,225,6,4,4,-1,-221,3,3,3,-6,226,227,1,1
"1722","12",72,5,1,0,0,-63,147,-1,0,159,162,2,2,3,-2,-222,-15,-3,-2
"1723","12",428,1,1,0,0,-182,-1,-4,-4,211,106,2,2,3,2,-393,-107,-6,-6
"1724","12",275,4,4,1,2,-4,-236,1,-1,-1,-245,3,2,3,-1,-3,9,-2,-3
"1725","12",372,3,3,1,0,-96,-81,-1,-2,-62,-173,-4,-4,3,0,-34,92,3,2
"1726","12",369,2,4,1,0,-170,1,-3,-3,42,4,1,1,3,1,-212,-3,-4,-4
"1727","12",118,6,3,1,1,-12,30,-1,1,44,41,1,1,3,-3,-56,-11,-2,0
"1728","12",86,6,4,1,3,176,-5,-1,1,147,-4,2,3,3,-3,29,-1,-3,-2
"1729","12",142,5,2,0,2,-205,22,-4,0,-150,23,-3,0,3,-2,-55,-1,-1,0
"1730","12",361,4,1,1,0,-53,-227,3,-1,-249,-10,1,-4,3,-1,196,-217,2,3
"1731","12",107,6,2,0,3,147,-25,2,1,-42,-104,0,-1,3,-3,189,79,2,2
"1732","12",50,2,2,1,1,21,-52,0,-3,136,2,1,-2,3,1,-115,-54,-1,-1
"1733","12",253,7,3,0,3,72,76,2,2,112,137,4,4,3,-4,-40,-61,-2,-2
"1734","12",180,4,2,0,2,-1,7,0,-1,0,1,0,1,3,-1,-1,6,0,-2
"1735","12",371,4,3,1,0,34,-146,-1,-1,172,-52,-2,-2,3,-1,-138,-94,1,1
"1736","12",42,2,3,1,1,0,-14,2,-3,2,11,2,-2,3,1,-2,-25,0,-1
"1737","12",218,8,4,1,3,-216,26,4,3,-246,85,4,3,3,-5,30,-59,0,0
"1738","12",85,1,2,0,2,-110,-111,-4,-4,124,139,2,1,3,2,-234,-250,-6,-5
"1739","12",141,1,1,0,0,-40,-47,-2,-4,40,8,1,4,3,2,-80,-55,-3,-8
"1740","12",360,2,3,1,0,-65,20,-1,-3,108,169,1,-3,3,1,-173,-149,-2,0
"1741","12",207,5,1,0,0,0,-1,0,0,0,246,2,3,3,-2,0,-247,-2,-3
"1742","12",231,7,4,1,0,-113,-119,-4,2,-2,85,-4,3,3,-4,-111,-204,0,-1
"1743","12",228,6,4,1,2,47,73,1,1,-114,85,1,1,3,-3,161,-12,0,0
"1744","12",95,1,4,1,2,-226,3,-4,-4,-59,2,0,0,3,2,-167,1,-4,-4
"1745","12",155,5,2,0,1,-16,-46,0,0,9,-4,0,0,3,-2,-25,-42,0,0
"1746","12",450,4,4,1,3,238,0,1,-1,227,1,2,-2,3,-1,11,-1,-1,1
"1747","12",12,9,4,1,3,-1,-1,4,4,-2,-1,4,4,3,-6,1,0,0,0
"1748","12",415,3,2,0,2,-25,0,0,-2,101,140,0,1,3,0,-126,-140,0,-3
"1749","12",411,9,2,0,2,233,238,4,4,241,243,4,4,3,-6,-8,-5,0,0
"1750","12",408,4,1,0,0,-135,-1,-2,-1,-85,12,-1,-2,3,-1,-50,-13,-1,1
"1751","12",109,1,1,0,1,-17,-1,3,-4,-25,-1,3,-4,3,2,8,0,0,0
"1752","12",73,7,4,1,2,121,-76,1,2,100,-110,-1,-1,3,-4,21,34,2,3
"1753","12",429,1,2,0,0,-16,-3,-4,-4,0,2,0,-4,3,2,-16,-5,-4,0
"1754","12",276,8,4,1,3,234,-3,3,3,161,-4,2,2,3,-5,73,1,1,1
"1755","12",154,5,4,0,3,4,-10,0,0,36,149,0,0,3,-2,-32,-159,0,0
"1756","12",45,4,3,1,0,-17,-59,1,-1,-43,33,-1,-1,3,-1,26,-92,2,0
"1757","12",119,7,3,0,3,150,-67,2,2,118,-55,1,1,3,-4,32,-12,1,1
"1758","12",147,7,2,0,3,129,170,2,2,61,135,1,2,3,-4,68,35,1,0
"1759","12",143,7,1,1,3,237,-23,3,2,26,-73,2,2,3,-4,211,50,1,0
"1760","12",439,5,2,0,1,-2,4,0,0,0,1,0,0,3,-2,-2,3,0,0
"1761","12",108,9,2,0,3,243,12,4,4,204,33,4,4,3,-6,39,-21,0,0
"1762","12",51,3,4,1,1,-209,-94,0,-2,99,94,1,-3,3,0,-308,-188,-1,1
"1763","12",254,5,2,0,3,-10,-9,-1,0,157,-133,-3,-1,3,-2,-167,124,2,1
"1764","12",181,3,4,1,3,135,-113,-2,-2,-44,67,0,0,3,0,179,-180,-2,-2
"1765","12",157,2,3,1,2,-23,0,-2,-3,125,128,-1,0,3,1,-148,-128,-1,-3
"1766","12",452,4,3,1,1,-41,4,-1,-1,-169,2,-2,-1,3,-1,128,2,1,0
"1767","12",219,3,4,1,3,-1,249,4,-2,248,4,4,-2,3,0,-249,245,0,0
"1768","12",268,6,4,1,3,149,-53,1,1,133,-135,3,1,3,-3,16,82,-2,0
"1769","12",264,2,4,1,2,-13,1,-1,-3,4,3,0,-2,3,1,-17,-2,-1,-1
"1770","12",61,1,1,0,3,248,-25,4,-4,-27,3,4,-4,3,2,275,-28,0,0
"1771","12",208,1,4,0,2,-221,171,-4,-4,195,201,2,2,3,2,-416,-30,-6,-6
"1772","12",163,6,3,0,1,-47,8,-1,1,104,2,1,1,3,-3,-151,6,-2,0
"1773","12",229,2,1,0,1,-240,161,-3,-3,-191,42,-2,-2,3,1,-49,119,-1,-1
"1774","12",96,4,1,0,0,-243,0,-3,-1,-21,4,-1,-1,3,-1,-222,-4,-2,0
"1775","12",156,5,2,1,1,1,2,0,0,67,32,1,1,3,-2,-66,-30,-1,-1
"1776","12",451,1,1,0,0,-220,-188,-4,-4,-83,-201,-4,-4,3,2,-137,13,0,0
"1777","12",120,7,3,1,1,152,-72,2,2,154,-108,2,2,3,-4,-2,36,0,0
"1778","12",416,1,4,0,0,-229,245,-4,-4,-234,225,-4,-4,3,2,5,20,0,0
"1779","12",412,8,1,0,0,-240,6,-4,3,-151,1,4,4,3,-5,-89,5,-8,-1
"1780","12",409,3,4,1,2,-46,-43,-2,-2,114,116,2,2,3,0,-160,-159,-4,-4
"1781","12",11,6,4,1,1,46,79,2,1,107,151,3,2,3,-3,-61,-72,-1,-1
"1782","12",74,4,3,1,0,-72,-47,-2,-1,5,22,0,0,3,-1,-77,-69,-2,-1
"1783","12",43,1,3,0,0,-211,7,-3,-4,82,6,1,-4,3,2,-293,1,-4,0
"1784","12",277,1,4,0,1,-95,64,4,-4,55,-87,2,-1,3,2,-150,151,2,-3
"1785","12",458,2,1,0,1,-59,-52,0,-3,66,66,-1,-2,3,1,-125,-118,1,-1
"1786","12",454,5,4,1,3,-1,2,0,0,247,-1,3,3,3,-2,-248,3,-3,-3
"1787","12",151,1,2,0,1,-244,13,4,-4,-240,3,4,-4,3,2,-4,10,0,0
"1788","12",148,1,1,0,1,-244,94,2,-4,-156,-98,2,-4,3,2,-88,192,0,0
"1789","12",144,1,3,1,0,-242,-233,-4,-4,-1,2,0,0,3,2,-241,-235,-4,-4
"1790","12",44,1,2,1,2,-149,1,-2,-4,119,-58,-4,-4,3,2,-268,59,2,0
"1791","12",287,8,4,1,3,115,8,3,3,21,11,1,1,3,-5,94,-3,2,2
"1792","12",52,2,3,1,0,-210,6,-3,-3,131,4,2,-2,3,1,-341,2,-5,-1
"1793","12",255,1,3,0,1,118,-117,-4,-4,117,-138,1,1,3,2,1,21,-5,-5
"1794","12",182,6,4,1,3,-1,-83,3,1,1,-161,2,1,3,-3,-2,78,1,0
"1795","12",457,3,3,1,1,-194,54,-2,-2,180,122,2,2,3,0,-374,-68,-4,-4
"1796","12",453,3,4,0,2,171,5,0,-2,-141,5,0,1,3,0,312,0,0,-3
"1797","12",150,5,3,0,1,3,1,0,0,21,5,0,0,3,-2,-18,-4,0,0
"1798","12",269,1,4,1,2,-249,106,0,-4,-249,123,0,-4,3,2,0,-17,0,0
"1799","12",265,8,1,0,3,22,1,0,3,-2,4,0,0,3,-5,24,-3,0,3
"1800","12",62,9,2,0,3,171,3,0,4,217,239,2,4,3,-6,-46,-236,-2,0
"1801","12",286,6,1,0,3,88,-9,1,1,63,-2,1,1,3,-3,25,-7,0,0
"1802","12",164,2,2,0,2,-229,-1,-2,-3,-38,-1,0,-1,3,1,-191,0,-2,-2
"1803","12",23,9,1,0,3,-229,-208,-4,4,205,216,4,4,3,-6,-434,-424,-8,0
"1804","12",97,2,1,0,1,-239,75,2,-3,177,124,3,-2,3,1,-416,-49,-1,-1
"1805","12",46,5,1,0,0,-27,-234,-4,0,-1,-239,-4,4,3,-2,-26,5,0,-4
"1806","12",456,2,1,0,0,0,-98,-1,-3,-2,-70,0,-3,3,1,2,-28,-1,0
"1807","12",271,2,3,0,1,-226,0,-3,-3,240,3,3,4,3,1,-466,-3,-6,-7
"1808","12",15,7,4,1,3,140,20,2,2,29,54,2,1,3,-4,111,-34,0,1
"1809","12",146,2,2,0,0,-159,-169,-3,-3,-207,-200,-3,-3,3,1,48,31,0,0
"1810","12",441,4,4,0,2,-28,12,1,-1,-53,-109,0,1,3,-1,25,121,1,-2
"1811","12",58,1,4,1,1,-229,-2,-4,-4,-3,245,4,4,3,2,-226,-247,-8,-8
"1812","12",75,1,4,1,2,-240,17,-4,-4,223,221,3,-2,3,2,-463,-204,-7,-2
"1813","12",430,5,2,0,1,41,-41,0,0,185,-63,0,0,3,-2,-144,22,0,0
"1814","12",278,9,4,0,1,110,111,4,4,1,1,4,-4,3,-6,109,110,0,8
"1815","12",459,1,3,1,1,-137,122,2,-4,52,-47,1,2,3,2,-189,169,1,-6
"1816","12",455,2,2,0,2,-229,-4,-3,-3,-249,-1,-3,-3,3,1,20,-3,0,0
"1817","12",152,4,1,0,0,0,-3,0,-1,0,-3,0,0,3,-1,0,0,0,-1
"1818","12",149,5,3,1,1,-1,-3,-1,0,247,2,-3,1,3,-2,-248,-5,2,-1
"1819","12",145,6,1,0,1,93,-2,1,1,95,43,1,0,3,-3,-2,-45,0,1
"1820","12",440,5,3,1,0,0,-2,0,0,-103,2,-2,-2,3,-2,103,-4,2,2
"1821","12",288,3,2,1,2,-108,1,-4,-2,-112,76,-2,-3,3,0,4,-75,-2,1
"1822","12",53,7,4,1,3,205,2,2,2,219,1,2,2,3,-4,-14,1,0,0
"1823","12",256,5,3,0,1,-3,4,0,0,-3,-1,0,0,3,-2,0,5,0,0
"1824","12",183,2,4,1,1,17,15,1,-3,46,77,1,-3,3,1,-29,-62,0,0
"1825","12",289,8,1,1,3,-199,-20,3,3,-235,-25,-3,-3,3,-5,36,5,6,6
"1826","12",446,5,4,1,1,9,27,-1,0,50,22,0,0,3,-2,-41,5,-1,0
"1827","12",273,2,1,0,0,-224,-178,-4,-3,-29,10,4,4,3,1,-195,-188,-8,-7
"1828","12",27,5,2,0,2,-99,-136,0,0,-50,-9,0,0,3,-2,-49,-127,0,0
"1829","12",266,4,1,0,1,-122,-7,-1,-1,-108,-1,-1,-1,3,-1,-14,-6,0,0
"1830","12",63,2,4,0,1,-4,-1,-2,-3,-1,-3,0,-3,3,1,-3,2,-2,0
"1831","12",6,1,4,1,2,-208,0,-2,-4,-1,1,0,0,3,2,-207,-1,-2,-4
"1832","12",436,6,4,1,3,10,44,2,1,-9,66,2,2,3,-3,19,-22,0,-1
"1833","12",161,1,2,0,2,-242,43,-4,-4,105,84,1,-3,3,2,-347,-41,-5,-1
"1834","12",158,4,3,1,0,46,-30,-1,-1,36,-33,-2,0,3,-1,10,3,1,-1
"1835","12",60,6,1,0,3,-4,-4,0,1,-4,4,3,0,3,-3,0,-8,-3,1
"1836","12",449,3,4,1,3,-151,37,-2,-2,-116,60,2,0,3,0,-35,-23,-4,-2
"1837","12",272,4,4,1,2,40,27,-1,-1,47,14,-1,-1,3,-1,-7,13,0,0
"1838","12",159,3,3,1,2,-31,4,-3,-2,232,1,3,3,3,0,-263,3,-6,-5
"1839","12",54,1,4,1,1,49,7,-2,-4,41,40,0,0,3,2,8,-33,-2,-4
"1840","12",442,6,4,1,1,-26,28,-1,1,27,27,1,1,3,-3,-53,1,-2,0
"1841","12",59,3,1,0,0,0,148,-2,-2,1,-192,4,4,3,0,-1,340,-6,-6
"1842","12",435,5,4,1,1,-1,-5,0,0,66,12,0,0,3,-2,-67,-17,0,0
"1843","12",431,4,3,0,0,-218,53,-1,-1,1,4,0,0,3,-1,-219,49,-1,-1
"1844","12",279,7,4,1,3,137,18,3,2,38,-81,3,1,3,-4,99,99,0,1
"1845","12",270,4,3,0,1,138,3,1,-1,41,4,1,0,3,-1,97,-1,0,-1
"1846","12",267,5,3,1,1,55,-12,0,0,52,-11,1,1,3,-2,3,-1,-1,-1
"1847","12",153,5,1,1,3,-83,90,1,0,-60,-97,-1,1,3,-2,-23,187,2,-1
"1848","12",28,3,4,1,1,-48,-25,-2,-2,66,40,-1,-1,3,0,-114,-65,-1,-1
"1849","12",437,5,1,0,0,108,0,0,0,152,-2,0,0,3,-2,-44,2,0,0
"1850","12",445,6,4,1,3,93,-10,1,1,114,-105,1,1,3,-3,-21,95,0,0
"1851","12",433,1,1,0,0,-223,-151,-3,-4,180,162,3,-3,3,2,-403,-313,-6,-1
"1852","12",292,5,3,1,1,-174,0,0,0,-6,26,0,0,3,-2,-168,-26,0,0
"1853","12",257,1,1,0,0,-167,54,2,-4,193,93,4,-4,3,2,-360,-39,-2,0
"1854","12",184,6,3,1,3,127,-2,1,1,127,-2,3,1,3,-3,0,0,-2,0
"1855","12",29,1,4,1,0,-109,75,-4,-4,153,126,-2,-2,3,2,-262,-51,-2,-2
"1856","12",447,4,4,0,2,-105,5,1,-1,80,66,2,2,3,-1,-185,-61,-1,-3
"1857","12",274,6,4,1,2,23,-41,1,1,16,-80,-1,1,3,-3,7,39,2,0
"1858","12",290,1,1,0,1,-209,163,-4,-4,-212,67,-2,-4,3,2,3,96,-2,0
"1859","12",56,6,3,0,1,113,-115,-3,1,70,-111,-2,-1,3,-3,43,-4,-1,2
"1860","12",64,3,1,0,1,-168,-40,-2,-2,146,-46,-2,-1,3,0,-314,6,0,-1
"1861","12",444,3,2,0,2,-56,1,-1,-2,0,-2,0,0,3,0,-56,3,-1,-2
"1862","12",291,3,4,1,2,68,-4,-2,-2,2,-56,-2,-2,3,0,66,52,0,0
"1863","12",162,7,3,1,3,46,106,-2,2,215,168,3,3,3,-4,-169,-62,-5,-1
"1864","12",198,3,1,1,1,-147,135,-1,-2,-54,-75,-1,-1,3,0,-93,210,0,-1
"1865","12",280,6,2,0,1,14,-238,-1,1,232,-21,0,-1,3,-3,-218,-217,-1,2
"1866","12",438,7,4,0,3,6,3,4,2,72,0,4,4,3,-4,-66,3,0,-2
"1867","12",434,5,4,1,3,207,-24,2,0,177,-29,2,2,3,-2,30,5,0,-2
"1868","12",16,2,1,1,0,-226,21,-3,-3,58,23,-2,-4,3,1,-284,-2,-1,1
"1869","12",55,5,4,1,1,3,-38,0,0,-21,6,0,0,3,-2,24,-44,0,0
"1870","12",443,3,1,0,0,116,46,-2,-2,67,52,1,1,3,0,49,-6,-3,-3
"1871","12",185,5,4,1,2,43,-13,-2,0,49,-10,-3,1,3,-2,-6,-3,1,-1
"1872","12",294,8,1,0,3,0,0,3,3,246,0,3,3,3,-5,-246,0,0,0
"1873","12",432,4,2,0,1,19,-30,-1,-1,25,-32,0,0,3,-1,-6,2,-1,-1
"1874","12",259,1,3,0,1,-134,48,4,-4,-3,2,4,-4,3,2,-131,46,0,0
"1875","12",186,5,2,1,2,12,24,0,0,14,17,0,0,3,-2,-2,7,0,0
"1876","12",57,1,4,0,1,4,-156,0,-4,116,-226,-2,0,3,2,-112,70,2,-4
"1877","12",19,2,2,0,2,-164,-170,-3,-3,121,41,1,-1,3,1,-285,-211,-4,-2
"1878","12",26,1,1,0,0,-195,97,-4,-4,125,-51,-2,-2,3,2,-320,148,-2,-2
"1879","12",296,6,1,0,3,160,9,4,1,193,14,2,2,3,-3,-33,-5,2,-1
"1880","12",195,1,1,0,1,-246,245,4,-4,19,-17,2,0,3,2,-265,262,2,-4
"1881","12",260,4,3,1,0,-65,-41,-1,-1,-98,-75,-2,-2,3,-1,33,34,1,1
"1882","12",293,1,4,0,0,-188,9,-4,-4,-100,-31,-4,-4,3,2,-88,40,0,0
"1883","12",258,4,3,0,0,12,2,-1,-1,11,1,-2,-2,3,-1,1,1,1,1
"1884","12",261,9,1,0,3,202,169,4,4,206,194,4,4,3,-6,-4,-25,0,0
"1885","12",160,7,2,1,0,-217,54,-4,2,-78,29,-4,2,3,-4,-139,25,0,0
"1886","12",448,1,2,0,2,-181,2,-4,-4,-1,111,-2,-4,3,2,-180,-109,-2,0
"1887","12",189,3,1,1,1,-172,23,3,-2,-201,38,3,-3,3,0,29,-15,0,1
"1888","12",262,6,4,1,3,122,81,1,1,72,49,1,1,3,-3,50,32,0,0
"1889","12",295,5,1,0,1,0,-1,0,0,-2,-2,0,0,3,-2,2,1,0,0
"1890","12",190,7,4,1,3,40,-117,4,2,172,239,4,4,3,-4,-132,-356,0,-2
"1891","12",193,2,1,0,0,-148,-163,-4,-3,205,119,1,-1,3,1,-353,-282,-5,-2
"1892","12",187,2,4,1,2,-184,2,-3,-3,-72,-30,-2,-1,3,1,-112,32,-1,-2
"1893","12",284,2,3,1,1,-120,32,-3,-3,-199,-112,-3,-4,3,1,79,144,0,1
"1894","12",191,2,1,0,0,-214,-48,-2,-3,-202,20,-2,-2,3,1,-12,-68,0,-1
"1895","12",281,1,4,0,2,-235,11,-4,-4,5,-241,0,-4,3,2,-240,252,-4,0
"1896","12",196,3,3,1,0,13,-174,-2,-2,241,247,4,4,3,0,-228,-421,-6,-6
"1897","12",285,7,2,1,1,-76,-15,1,2,33,41,-2,1,3,-4,-109,-56,3,1
"1898","12",283,7,1,0,1,-108,-74,-1,2,128,-140,-1,2,3,-4,-236,66,0,0
"1899","12",197,3,4,1,3,-129,11,3,-2,-234,8,3,0,3,0,105,3,0,-2
"1900","12",194,8,1,0,0,-135,17,-4,3,-211,16,-4,3,3,-5,76,1,0,0
"1901","12",192,4,4,1,1,-105,-2,1,-1,-63,1,1,2,3,-1,-42,-3,0,-3
"1902","12",282,9,3,1,3,72,-103,1,4,174,37,1,4,3,-6,-102,-140,0,0
"1903","12",263,2,4,1,0,-238,-3,-3,-3,-217,6,-4,-4,3,1,-21,-9,1,1
"1904","12",188,8,2,0,3,204,-4,3,3,216,3,3,3,3,-5,-12,-7,0,0
"1905","13",471,4,3,1,2,59,-165,-1,-1,-168,-111,3,4,3,-1,227,-54,-4,-5
"1906","13",463,8,4,1,3,190,-25,3,3,235,4,2,2,3,-5,-45,-29,1,1
"1907","13",468,6,1,0,3,112,-6,1,1,199,52,1,1,3,-3,-87,-58,0,0
"1908","13",472,1,1,0,0,-67,10,-4,-4,53,9,-3,-4,3,2,-120,1,-1,0
"1909","13",66,3,1,0,1,-162,2,1,-2,139,-2,2,1,3,0,-301,4,-1,-3
"1910","13",65,7,1,0,3,-45,22,1,2,-80,25,2,2,3,-4,35,-3,-1,0
"1911","13",243,2,2,1,2,-249,89,-4,-3,-248,52,-4,-3,3,1,-1,37,0,0
"1912","13",241,3,4,1,2,27,14,1,-2,187,175,2,0,3,0,-160,-161,-1,-2
"1913","13",462,9,3,1,3,224,78,4,4,219,123,4,4,3,-6,5,-45,0,0
"1914","13",244,8,4,1,2,142,205,2,3,207,211,2,2,3,-5,-65,-6,0,1
"1915","13",248,5,4,1,3,42,82,0,0,85,203,1,0,3,-2,-43,-121,-1,0
"1916","13",470,4,1,0,1,-66,13,-1,-1,85,14,1,-1,3,-1,-151,-1,-2,0
"1917","13",67,3,1,0,0,-27,20,-2,-2,134,-125,3,3,3,0,-161,145,-5,-5
"1918","13",245,2,1,1,0,-119,-8,-2,-3,-103,-13,-2,-3,3,1,-16,5,0,0
"1919","13",233,5,2,0,2,-52,17,0,0,-35,14,-1,0,3,-2,-17,3,1,0
"1920","13",464,4,1,0,1,-144,-11,1,-1,-72,24,1,0,3,-1,-72,-35,0,-1
"1921","13",242,3,4,1,2,20,1,1,-2,28,22,-1,-3,3,0,-8,-21,2,1
"1922","13",246,7,4,1,3,186,-4,3,2,183,2,3,1,3,-4,3,-6,0,1
"1923","13",469,1,4,1,0,31,7,-4,-4,12,-60,-2,-4,3,2,19,67,-2,0
"1924","13",473,4,3,0,0,-14,8,0,-1,28,-62,0,0,3,-1,-42,70,0,-1
"1925","13",247,4,3,1,0,107,0,-1,-1,109,-13,1,1,3,-1,-2,13,-2,-2
"1926","13",47,7,4,1,3,66,0,1,2,191,1,2,3,3,-4,-125,-1,-1,-1
"1927","13",474,1,1,1,0,-2,-93,-4,-4,0,-85,-4,-4,3,2,-2,-8,0,0
"1928","13",236,5,1,0,1,30,-28,0,0,17,-22,0,0,3,-2,13,-6,0,0
"1929","13",232,2,1,0,0,-7,-52,-2,-3,-176,-32,0,-4,3,1,169,-20,-2,1
"1930","13",467,5,1,1,3,-34,28,4,0,57,-34,4,-3,3,-2,-91,62,0,3
"1931","13",237,4,2,0,2,-250,0,0,-1,86,3,1,0,3,-1,-336,-3,-1,-1
"1932","13",249,1,3,1,0,-152,-50,-4,-4,-133,-48,-4,-4,3,2,-19,-2,0,0
"1933","13",1,5,1,0,1,-61,-16,-1,0,22,25,-1,-1,3,-2,-83,-41,0,1
"1934","13",68,2,4,1,0,33,2,0,-3,162,-1,0,-2,3,1,-129,3,0,-1
"1935","13",238,3,3,1,1,-49,1,0,-2,81,-57,0,2,3,0,-130,58,0,-4
"1936","13",234,7,3,1,3,104,72,1,2,121,38,1,0,3,-4,-17,34,0,2
"1937","13",465,9,4,1,3,-218,14,4,4,22,-223,4,4,3,-6,-240,237,0,0
"1938","13",69,1,4,0,1,81,50,-4,-4,-24,75,-2,-4,3,2,105,-25,-2,0
"1939","13",275,4,4,1,2,-1,-240,1,-1,-8,246,3,-3,3,-1,7,-486,-2,2
"1940","13",466,3,3,1,0,-116,-62,-2,-2,-89,-81,-2,-2,3,0,-27,19,0,0
"1941","13",7,6,1,1,3,85,9,1,1,93,94,1,0,3,-3,-8,-85,0,1
"1942","13",276,7,4,1,3,241,-1,2,2,189,3,2,2,3,-4,52,-4,0,0
"1943","13",101,2,3,1,0,-214,217,-3,-3,233,237,-3,-3,3,1,-447,-20,0,0
"1944","13",475,3,3,1,3,106,-63,0,-2,-157,-80,-3,-3,3,0,263,17,3,1
"1945","13",240,4,2,1,1,129,48,1,-1,189,10,2,-4,3,-1,-60,38,-1,3
"1946","13",168,7,1,1,3,141,-119,2,2,91,-33,2,1,3,-4,50,-86,0,1
"1947","13",318,1,2,0,2,-202,-164,-4,-4,172,179,-4,0,3,2,-374,-343,0,-4
"1948","13",476,5,3,1,0,103,-130,0,0,144,-92,0,0,3,-2,-41,-38,0,0
"1949","13",25,3,4,1,2,-61,-82,-2,-2,-84,-82,0,-1,3,0,23,0,-2,-1
"1950","13",10,3,3,1,1,-96,1,-2,-2,46,7,0,0,3,0,-142,-6,-2,-2
"1951","13",319,4,1,0,1,71,-75,-2,-1,51,61,2,1,3,-1,20,-136,-4,-2
"1952","13",239,3,1,0,1,116,-138,1,-2,108,160,2,2,3,0,8,-298,-1,-4
"1953","13",100,8,4,1,3,221,0,3,3,2,2,2,3,3,-5,219,-2,1,0
"1954","13",32,1,1,0,1,-176,-44,2,-4,150,-166,2,-2,3,2,-326,122,0,-2
"1955","13",24,1,2,0,2,-245,247,-3,-4,248,3,4,4,3,2,-493,244,-7,-8
"1956","13",167,7,1,0,3,-92,145,2,2,-141,75,2,2,3,-4,49,70,0,0
"1957","13",320,3,2,0,2,-221,163,-3,-2,-188,154,-2,-2,3,0,-33,9,-1,0
"1958","13",70,1,2,1,2,-68,-26,4,-4,-67,59,-2,-4,3,2,-1,-85,6,0
"1959","13",277,1,4,1,1,-31,-16,3,-4,-68,40,3,-4,3,2,37,-56,0,0
"1960","13",102,8,4,0,3,-108,83,2,3,69,103,4,4,3,-5,-177,-20,-2,-1
"1961","13",321,1,1,0,0,-211,-210,-4,-4,18,20,0,0,3,2,-229,-230,-4,-4
"1962","13",172,5,2,1,3,-148,-44,0,0,170,157,3,3,3,-2,-318,-201,-3,-3
"1963","13",169,1,3,1,0,-233,-45,-4,-4,-189,-56,-4,-4,3,2,-44,11,0,0
"1964","13",307,5,4,1,2,-17,-3,0,0,-134,-70,-4,-1,3,-2,117,67,4,1
"1965","13",388,1,4,0,0,-228,-1,-4,-4,-233,-2,-1,-1,3,2,5,1,-3,-3
"1966","13",235,6,3,1,0,62,0,1,1,-4,3,1,1,3,-3,66,-3,0,0
"1967","13",201,1,3,1,1,-17,-2,1,-4,42,2,0,-3,3,2,-59,-4,1,-1
"1968","13",49,3,4,1,1,-67,-28,-1,-2,2,23,-1,-1,3,0,-69,-51,0,-1
"1969","13",251,2,3,1,1,-75,-79,2,-3,-3,-171,0,-2,3,1,-72,92,2,-1
"1970","13",377,5,1,0,0,243,10,4,0,244,9,4,0,3,-2,-1,1,0,0
"1971","13",373,1,3,1,0,-208,-22,0,-4,-239,-39,1,-3,3,2,31,17,-1,-1
"1972","13",175,6,4,1,1,13,-9,0,1,-5,64,1,-1,3,-3,18,-73,-1,2
"1973","13",171,5,1,1,1,-19,5,0,0,33,46,-2,0,3,-2,-52,-41,2,0
"1974","13",31,9,1,0,0,68,84,4,4,-141,113,-4,-4,3,-6,209,-29,8,8
"1975","13",390,7,2,1,2,69,-116,2,2,46,-40,0,2,3,-4,23,-76,2,0
"1976","13",387,3,3,1,1,-87,-78,-1,-2,162,109,2,3,3,0,-249,-187,-3,-5
"1977","13",103,5,2,0,3,-1,-158,1,0,176,2,2,2,3,-2,-177,-160,-1,-2
"1978","13",48,1,3,1,0,35,-34,-4,-4,75,-78,-4,-4,3,2,-40,44,0,0
"1979","13",250,6,1,0,3,57,27,1,1,85,26,1,1,3,-3,-28,1,0,0
"1980","13",17,1,3,1,0,26,0,-1,-4,163,138,-1,-4,3,2,-137,-138,0,0
"1981","13",199,3,4,1,2,-95,34,-2,-2,109,-35,0,0,3,0,-204,69,-2,-2
"1982","13",174,5,4,1,3,138,121,1,0,114,110,1,0,3,-2,24,11,0,0
"1983","13",170,1,2,0,0,-241,-240,-4,-4,11,16,0,0,3,2,-252,-256,-4,-4
"1984","13",309,4,4,1,2,73,59,-2,-1,114,92,1,0,3,-1,-41,-33,-3,-1
"1985","13",39,3,3,0,1,-152,3,-1,-2,163,-191,3,0,3,0,-315,194,-4,-2
"1986","13",386,2,1,0,0,-171,-41,-1,-3,218,218,4,3,3,1,-389,-259,-5,-6
"1987","13",378,3,4,1,1,-90,-8,-2,-2,-163,-6,-3,-3,3,0,73,-2,1,1
"1988","13",71,4,3,1,1,-51,24,-1,-1,28,17,-1,0,3,-1,-79,7,0,-1
"1989","13",278,1,4,1,1,-227,-233,4,-4,58,1,4,0,3,2,-285,-234,0,-4
"1990","13",395,5,3,1,1,-218,36,-3,0,213,27,-2,3,3,-2,-431,9,-1,-3
"1991","13",322,6,4,1,3,32,-31,1,1,240,-235,3,3,3,-3,-208,204,-2,-2
"1992","13",173,5,4,0,3,-150,4,0,0,175,3,0,0,3,-2,-325,1,0,0
"1993","13",287,3,4,1,3,165,-13,1,-2,-95,0,1,-2,3,0,260,-13,0,0
"1994","13",308,1,4,1,0,-247,-247,-4,-4,246,247,4,4,3,2,-493,-494,-8,-8
"1995","13",389,5,3,1,2,10,7,0,0,26,-6,0,0,3,-2,-16,13,0,0
"1996","13",28,4,4,1,1,-26,-20,-1,-1,7,7,-1,-1,3,-1,-33,-27,0,0
"1997","13",202,6,1,0,1,54,143,2,1,86,123,3,2,3,-3,-32,20,-1,-1
"1998","13",5,2,2,0,2,-237,8,-2,-3,-245,132,-3,-4,3,1,8,-124,1,1
"1999","13",252,4,4,1,1,-123,-119,-1,-1,97,76,1,0,3,-1,-220,-195,-2,-1
"2000","13",269,1,4,1,2,-250,124,-4,-4,-250,119,-3,-4,3,2,0,5,-1,0
"2001","13",374,5,4,1,2,8,-12,0,0,37,11,1,1,3,-2,-29,-23,-1,-1
"2002","13",176,4,1,0,1,-156,1,-4,-1,147,57,-3,-3,3,-1,-303,-56,-1,2
"2003","13",286,6,1,0,3,81,5,1,1,44,0,1,1,3,-3,37,5,0,0
"2004","13",310,4,4,1,2,-32,0,-1,-1,-198,-1,1,1,3,-1,166,1,-2,-2
"2005","13",391,5,2,1,3,74,-55,0,0,177,111,0,0,3,-2,-103,-166,0,0
"2006","13",279,7,4,1,3,124,-45,3,2,149,100,2,2,3,-4,-25,-145,1,0
"2007","13",104,1,1,1,0,2,-226,-2,-4,234,-2,0,-4,3,2,-232,-224,-2,0
"2008","13",73,6,4,1,2,108,-123,-1,1,133,-92,-1,1,3,-3,-25,-31,0,0
"2009","13",271,6,3,1,1,29,5,1,1,210,0,4,4,3,-3,-181,5,-3,-3
"2010","13",268,7,4,1,3,142,-62,2,2,147,-98,3,3,3,-4,-5,36,-1,-1
"2011","13",2,4,4,1,1,-142,89,0,-1,128,-64,3,2,3,-1,-270,153,-3,-3
"2012","13",272,6,4,1,2,48,28,1,1,48,42,0,-1,3,-3,0,-14,1,2
"2013","13",289,8,1,0,3,191,-19,3,3,223,215,-4,-4,3,-5,-32,-234,7,7
"2014","13",313,7,3,1,0,126,129,2,2,123,143,1,1,3,-4,3,-14,1,1
"2015","13",29,1,4,1,0,-210,212,-4,-4,245,240,-1,-1,3,2,-455,-28,-3,-3
"2016","13",253,7,3,1,3,137,111,1,2,111,137,2,2,3,-4,26,-26,-1,0
"2017","13",379,2,3,1,1,-66,37,1,-3,177,124,2,1,3,1,-243,-87,-1,-4
"2018","13",72,4,1,0,0,-94,79,-2,-1,143,148,2,2,3,-1,-237,-69,-4,-3
"2019","13",177,6,4,1,1,46,155,2,1,48,134,4,0,3,-3,-2,21,-2,1
"2020","13",396,1,1,1,1,-231,226,4,-4,-217,149,4,-4,3,2,-14,77,0,0
"2021","13",323,1,4,1,1,6,-66,0,-4,135,-3,-1,-1,3,2,-129,-63,1,-3
"2022","13",392,2,1,1,0,-222,193,-3,-3,-129,-105,-1,-1,3,1,-93,298,-2,-2
"2023","13",288,4,2,1,2,-172,-1,-2,-1,-110,61,-2,-2,3,-1,-62,-62,0,1
"2024","13",312,5,4,1,1,86,-45,0,0,-45,-112,2,0,3,-2,131,67,-2,0
"2025","13",393,1,1,0,0,-241,-1,-4,-4,-176,-85,-4,-4,3,2,-65,84,0,0
"2026","13",280,4,2,0,1,62,-57,-1,-1,-44,38,-1,1,3,-1,106,-95,0,-2
"2027","13",203,9,4,1,3,238,15,4,4,231,10,4,4,3,-6,7,5,0,0
"2028","13",50,3,2,1,1,7,-22,0,-2,41,-96,0,-2,3,0,-34,74,0,0
"2029","13",273,5,1,1,0,-53,-1,0,0,113,8,2,1,3,-2,-166,-9,-2,-1
"2030","13",27,5,2,1,2,31,-28,0,0,-72,-90,0,0,3,-2,103,62,0,0
"2031","13",375,5,3,1,1,-2,0,0,0,-2,0,0,0,3,-2,0,0,0,0
"2032","13",290,1,1,0,1,-106,22,-4,-4,90,137,-4,-4,3,2,-196,-115,0,0
"2033","13",84,8,4,1,3,205,1,3,3,191,1,3,3,3,-5,14,0,0,0
"2034","13",311,1,2,0,2,-231,8,-4,-4,200,47,4,-4,3,2,-431,-39,-8,0
"2035","13",52,1,3,1,0,-190,5,-3,-4,-3,237,2,0,3,2,-187,-232,-5,-4
"2036","13",255,6,3,1,1,119,81,1,1,63,-111,0,0,3,-3,56,192,1,1
"2037","13",105,5,1,1,0,-126,13,-1,0,75,13,1,0,3,-2,-201,0,-2,0
"2038","13",74,4,3,1,0,110,-42,-2,-1,150,-47,2,1,3,-1,-40,5,-4,-2
"2039","13",179,5,1,1,1,-1,-3,0,0,-1,1,2,1,3,-2,0,-4,-2,-1
"2040","13",398,2,4,1,2,-77,35,-3,-3,-31,28,-2,-2,3,1,-46,7,-1,-1
"2041","13",20,4,3,1,0,-185,-178,-2,-1,74,48,2,1,3,-1,-259,-226,-4,-2
"2042","13",394,1,3,0,0,-100,-85,-4,-4,-248,249,-4,-4,3,2,148,-334,0,0
"2043","13",83,6,1,1,3,127,-136,1,1,122,-123,2,1,3,-3,5,-13,-1,0
"2044","13",314,1,4,1,1,-244,10,4,-4,-245,5,4,-4,3,2,1,5,0,0
"2045","13",51,8,4,1,1,-101,-124,2,3,-121,-74,1,1,3,-5,20,-50,1,2
"2046","13",254,5,2,0,3,-3,-6,0,0,184,-210,-3,-1,3,-2,-187,204,3,1
"2047","13",38,9,4,1,3,0,0,4,4,68,235,4,4,3,-6,-68,-235,0,0
"2048","13",376,3,4,1,1,97,-20,-2,-2,121,-68,-2,-2,3,0,-24,48,0,0
"2049","13",178,5,1,0,1,0,0,0,0,5,-3,0,0,3,-2,-5,3,0,0
"2050","13",397,8,4,1,3,190,-1,2,3,135,73,0,2,3,-5,55,-74,2,1
"2051","13",324,4,2,1,0,-129,-3,-1,-1,-210,0,-3,-3,3,-1,81,-3,2,2
"2052","13",292,5,3,1,1,-191,5,0,0,43,-3,3,0,3,-2,-234,8,-3,0
"2053","13",61,2,1,0,3,215,11,4,-3,-221,211,4,-4,3,1,436,-200,0,1
"2054","13",265,6,1,0,3,95,0,0,1,-1,1,0,0,3,-3,96,-1,0,1
"2055","13",75,3,4,0,2,210,30,2,-2,238,237,3,-4,3,0,-28,-207,-1,2
"2056","13",281,1,4,1,2,-246,4,-4,-4,-235,-2,4,-4,3,2,-11,6,-8,0
"2057","13",204,4,3,1,1,-106,-123,-1,-1,166,-223,0,0,3,-1,-272,100,-1,-1
"2058","13",200,2,3,1,0,-53,12,-3,-3,-226,-36,-4,-4,3,1,173,48,1,1
"2059","13",274,6,4,1,2,40,-87,1,1,48,-133,1,1,3,-3,-8,46,0,0
"2060","13",270,5,3,0,1,0,5,0,0,95,3,2,1,3,-2,-95,2,-2,-1
"2061","13",315,9,3,1,3,240,13,4,4,-247,18,-1,-1,3,-6,487,-5,5,5
"2062","13",291,3,4,1,2,94,4,-1,-2,75,5,-1,-1,3,0,19,-1,0,-1
"2063","13",85,1,2,0,2,-106,-116,-4,-4,-86,-93,-4,-4,3,2,-20,-23,0,0
"2064","13",264,3,4,1,2,2,4,0,-2,-11,42,-2,-4,3,0,13,-38,2,2
"2065","13",53,7,4,1,3,-4,65,2,2,223,0,2,2,3,-4,-227,65,0,0
"2066","13",256,6,3,1,1,161,0,1,1,1,0,0,0,3,-3,160,0,1,1
"2067","13",106,5,2,1,1,33,30,1,0,-56,28,2,2,3,-2,89,2,-1,-2
"2068","13",325,9,1,0,1,-105,-88,-4,4,-56,-46,-3,3,3,-6,-49,-42,-1,1
"2069","13",18,2,3,1,1,64,19,-1,-3,60,27,0,-1,3,1,4,-8,-1,-2
"2070","13",399,7,4,1,3,110,-6,2,2,-42,16,1,1,3,-4,152,-22,1,1
"2071","13",266,4,1,1,1,-105,-1,-1,-1,-121,-3,-2,-2,3,-1,16,2,1,1
"2072","13",294,7,1,0,3,191,0,2,2,157,0,2,2,3,-4,34,0,0,0
"2073","13",63,4,4,1,1,-96,1,-1,-1,2,-3,0,-1,3,-1,-98,4,-1,0
"2074","13",98,1,3,1,0,-238,-55,-2,-4,234,233,4,4,3,2,-472,-288,-6,-8
"2075","13",460,2,1,0,0,-190,9,-3,-3,225,76,-3,2,3,1,-415,-67,0,-5
"2076","13",230,7,1,0,0,-182,68,-3,2,-112,51,-3,2,3,-4,-70,17,0,0
"2077","13",380,1,4,1,1,54,-38,3,-4,-211,-50,3,-2,3,2,265,12,0,-2
"2078","13",30,6,2,0,2,150,-19,2,1,128,10,1,2,3,-3,22,-29,1,-1
"2079","13",297,4,3,0,2,53,42,-1,-1,-21,17,4,1,3,-1,74,25,-5,-2
"2080","13",45,2,3,1,0,-82,-61,2,-3,11,-28,1,-1,3,1,-93,-33,1,-2
"2081","13",317,5,4,1,2,29,-27,0,0,2,-3,0,0,3,-2,27,-24,0,0
"2082","13",293,1,4,1,0,-205,19,-4,-4,-215,28,-4,-4,3,2,10,-9,0,0
"2083","13",62,9,2,0,3,-234,-6,-4,4,232,224,4,4,3,-6,-466,-230,-8,0
"2084","13",8,7,3,1,1,-95,-80,2,2,-39,211,-2,-3,3,-4,-56,-291,4,5
"2085","13",76,6,4,0,3,39,0,1,1,134,-4,1,2,3,-3,-95,4,0,-1
"2086","13",282,9,3,1,3,105,-117,2,4,103,59,1,4,3,-6,2,-176,1,0
"2087","13",205,5,1,0,2,151,1,0,0,196,-4,4,4,3,-2,-45,5,-4,-4
"2088","13",428,1,1,0,0,-245,0,-3,-4,88,9,0,0,3,2,-333,-9,-3,-4
"2089","13",351,1,1,0,0,-218,-224,-4,-4,126,132,-4,-4,3,2,-344,-356,0,0
"2090","13",129,3,4,1,1,-116,-3,-2,-2,-229,0,-2,-2,3,0,113,-3,0,0
"2091","13",316,3,3,1,0,-165,-92,-2,-2,-212,-126,-2,-2,3,0,47,34,0,0
"2092","13",121,1,1,0,0,-176,3,-4,-4,243,-49,-1,-4,3,2,-419,52,-3,0
"2093","13",86,7,4,1,3,164,3,0,2,165,-4,2,3,3,-4,-1,7,-2,-1
"2094","13",82,8,4,1,2,-130,-118,4,3,54,-33,4,4,3,-5,-184,-85,0,-1
"2095","13",54,1,4,1,1,-35,-1,-1,-4,113,38,-2,0,3,2,-148,-39,1,-4
"2096","13",257,1,1,0,0,130,-67,2,-4,116,93,2,-4,3,2,14,-160,0,0
"2097","13",107,3,2,0,3,65,116,1,-2,86,100,2,4,3,0,-21,16,-1,-6
"2098","13",326,7,4,1,2,135,79,2,2,154,77,2,2,3,-4,-19,2,0,0
"2099","13",180,5,2,0,2,17,5,-1,0,1,1,-2,0,3,-2,16,4,1,0
"2100","13",4,7,3,1,1,152,0,2,2,241,241,-1,2,3,-4,-89,-241,3,0
"2101","13",267,5,3,1,1,-31,-4,-1,0,82,-12,1,1,3,-2,-113,8,-2,-1
"2102","13",295,5,1,0,1,2,0,0,0,-1,0,0,0,3,-2,3,0,0,0
"2103","13",64,2,1,1,1,-224,138,-2,-3,127,-41,-2,-1,3,1,-351,179,0,-2
"2104","13",99,9,4,1,3,226,-32,4,4,222,31,4,4,3,-6,4,-63,0,0
"2105","13",461,4,4,0,2,146,32,1,-1,-33,26,-1,-1,3,-1,179,6,2,0
"2106","13",231,6,4,1,0,-2,0,-4,1,-97,-101,-4,2,3,-3,95,101,0,-1
"2107","13",381,2,2,0,2,-236,31,-3,-3,229,237,4,4,3,1,-465,-206,-7,-7
"2108","13",300,4,1,0,0,-106,49,0,-1,142,111,1,2,3,-1,-248,-62,-1,-3
"2109","13",298,1,1,0,0,-132,11,-1,-4,-35,12,-1,-2,3,2,-97,-1,0,-2
"2110","13",450,6,4,0,3,149,3,1,1,-1,2,0,1,3,-3,150,1,1,0
"2111","13",127,3,1,1,0,-106,-1,-1,-2,-51,1,-2,-2,3,0,-55,-2,1,0
"2112","13",123,2,4,1,2,-191,31,-3,-3,-204,39,-3,-3,3,1,13,-8,0,0
"2113","13",88,1,4,1,2,-235,-15,-4,-4,212,-195,4,4,3,2,-447,180,-8,-8
"2114","13",80,5,4,1,3,205,2,3,0,217,-1,2,2,3,-2,-12,3,1,-2
"2115","13",77,6,3,0,1,83,6,1,1,1,92,-1,-1,3,-3,82,-86,2,2
"2116","13",283,6,1,0,1,-57,-116,-2,1,162,-95,-2,2,3,-3,-219,-21,0,-1
"2117","13",206,2,4,1,0,-78,31,-2,-3,170,135,1,1,3,1,-248,-104,-3,-4
"2118","13",429,1,2,0,0,-235,-232,-4,-4,-2,-200,0,-4,3,2,-233,-32,-4,0
"2119","13",352,5,2,0,1,2,-12,0,0,3,-12,0,0,3,-2,-1,0,0,0
"2120","13",13,2,4,1,1,45,-84,-1,-3,-43,-90,-1,-3,3,1,88,6,0,0
"2121","13",126,3,2,1,2,14,30,-2,-2,-83,-93,-2,-2,3,0,97,123,0,0
"2122","13",122,9,1,0,0,180,201,4,4,-77,-42,0,0,3,-6,257,243,4,4
"2123","13",87,7,4,1,3,-2,186,1,2,6,-194,1,1,3,-4,-8,380,0,1
"2124","13",366,7,4,1,3,159,-69,4,2,145,54,2,3,3,-4,14,-123,2,-1
"2125","13",55,5,4,1,1,-18,-124,0,0,17,0,0,0,3,-2,-35,-124,0,0
"2126","13",258,3,3,1,0,15,3,-2,-2,13,-1,-1,-2,3,0,2,4,-1,0
"2127","13",108,9,2,0,3,223,36,4,4,228,23,-4,4,3,-6,-5,13,8,0
"2128","13",327,6,4,1,3,108,7,1,1,42,-119,1,-1,3,-3,66,126,0,2
"2129","13",181,6,4,1,3,156,-142,1,1,95,-71,1,-2,3,-3,61,-71,0,3
"2130","13",40,6,1,0,2,110,-56,2,1,171,-69,3,-1,3,-3,-61,13,-1,2
"2131","13",125,5,4,1,0,-50,-27,-2,0,247,-244,-4,-3,3,-2,-297,217,2,3
"2132","13",296,5,1,0,3,52,3,0,0,216,-16,1,2,3,-2,-164,19,-1,-2
"2133","13",344,7,4,1,3,224,11,2,2,226,-27,-2,2,3,-4,-2,38,4,0
"2134","13",340,4,1,0,1,-80,-21,0,-1,83,15,0,0,3,-1,-163,-36,0,-1
"2135","13",79,1,4,0,2,-201,-205,-4,-4,-180,166,-2,-2,3,2,-21,-371,-2,-2
"2136","13",285,6,2,1,1,-81,33,-2,1,72,30,1,1,3,-3,-153,3,-3,0
"2137","13",382,5,4,1,2,94,-14,0,0,94,-7,1,1,3,-2,0,-7,-1,-1
"2138","13",301,4,4,1,1,-41,1,-1,-1,-68,-1,-1,-2,3,-1,27,2,0,1
"2139","13",299,7,4,1,1,153,-143,2,2,110,140,2,3,3,-4,43,-283,0,-1
"2140","13",451,1,1,0,0,-226,-217,-4,-4,-199,-176,-4,-4,3,2,-27,-41,0,0
"2141","13",128,6,1,0,3,99,34,1,1,134,-115,1,1,3,-3,-35,149,0,0
"2142","13",124,6,1,0,3,216,-1,0,1,248,2,3,2,3,-3,-32,-3,-3,-1
"2143","13",89,1,3,1,0,-244,2,-1,-4,-246,-1,-4,-3,3,2,2,3,3,-1
"2144","13",81,1,1,0,0,-130,46,-4,-4,-80,51,-3,-3,3,2,-50,-5,-1,-1
"2145","13",78,2,4,1,0,-179,3,-2,-3,-170,-1,-2,-2,3,1,-9,4,0,-1
"2146","13",284,1,3,1,1,-234,-169,-3,-4,-130,117,-3,-3,3,2,-104,-286,0,-1
"2147","13",207,5,1,0,0,121,-114,4,0,141,-3,0,1,3,-2,-20,-111,4,-1
"2148","13",43,1,3,1,0,-250,11,-3,-4,44,-1,-1,-4,3,2,-294,12,-2,0
"2149","13",353,8,2,1,2,235,2,3,3,217,58,2,2,3,-5,18,-56,1,1
"2150","13",130,9,1,0,3,166,32,4,4,120,61,4,4,3,-6,46,-29,0,0
"2151","13",95,3,4,1,2,-188,6,-2,-2,-232,2,-3,-3,3,0,44,4,1,1
"2152","13",91,7,2,1,3,104,-14,2,2,69,3,1,1,3,-4,35,-17,1,1
"2153","13",346,7,3,1,0,-250,-137,-4,2,197,-1,3,3,3,-4,-447,-136,-7,-1
"2154","13",367,4,3,1,1,44,33,2,-1,-54,-56,2,0,3,-1,98,89,0,-1
"2155","13",56,3,3,1,1,42,-126,-2,-2,51,-122,-2,-1,3,0,-9,-4,0,-1
"2156","13",259,1,3,1,1,-169,55,4,-4,1,3,4,-4,3,2,-170,52,0,0
"2157","13",109,2,1,0,1,-28,5,3,-3,-17,1,3,-4,3,1,-11,4,0,1
"2158","13",328,3,3,0,1,-152,27,-2,-2,166,33,2,2,3,0,-318,-6,-4,-4
"2159","13",182,8,4,1,3,120,-31,2,3,1,-164,2,1,3,-5,119,133,0,2
"2160","13",400,7,4,1,2,20,-23,2,2,161,27,2,2,3,-4,-141,-50,0,0
"2161","13",94,3,4,1,1,51,-91,-1,-2,139,139,-1,3,3,0,-88,-230,0,-5
"2162","13",90,3,4,1,0,-72,16,-2,-2,170,14,2,2,3,0,-242,2,-4,-4
"2163","13",345,1,1,1,0,-27,12,-3,-4,44,-188,-3,-2,3,2,-71,200,0,-2
"2164","13",341,9,1,1,3,244,-10,4,4,246,-23,4,4,3,-6,-2,13,0,0
"2165","13",362,3,4,1,3,-71,-89,4,-2,151,133,2,-1,3,0,-222,-222,2,-1
"2166","13",212,1,1,1,1,-221,30,0,-4,-98,48,0,0,3,2,-123,-18,0,-4
"2167","13",383,5,4,1,1,0,-4,0,0,0,-4,0,0,3,-2,0,0,0,0
"2168","13",302,3,1,0,0,-59,-17,-2,-2,227,234,-4,-2,3,0,-286,-251,2,0
"2169","13",3,2,3,1,0,1,-5,-2,-3,0,0,-2,-2,3,1,1,-5,0,-1
"2170","13",452,3,3,1,1,-193,4,-2,-2,-3,-99,0,0,3,0,-190,103,-2,-2
"2171","13",97,2,1,1,1,-77,49,1,-3,208,182,3,1,3,1,-285,-133,-2,-4
"2172","13",348,5,3,1,1,63,34,-1,0,77,52,-1,0,3,-2,-14,-18,0,0
"2173","13",9,4,4,1,2,19,14,1,-1,40,14,1,-1,3,-1,-21,0,0,0
"2174","13",369,3,4,1,0,-135,1,-2,-2,23,-1,0,0,3,0,-158,2,-2,-2
"2175","13",58,3,4,1,1,-246,-3,1,-2,247,0,4,4,3,0,-493,-3,-3,-6
"2176","13",260,5,3,1,0,1,-1,0,0,18,22,-1,-1,3,-2,-17,-23,1,1
"2177","13",208,4,4,1,2,143,-7,-1,-1,216,18,2,2,3,-1,-73,-25,-3,-3
"2178","13",430,5,2,0,1,30,-41,0,0,104,-102,1,1,3,-2,-74,61,-1,-1
"2179","13",354,6,1,1,0,49,46,2,1,205,220,3,4,3,-3,-156,-174,-1,-3
"2180","13",131,8,4,1,3,38,17,0,3,39,-1,0,3,3,-5,-1,18,0,0
"2181","13",96,4,1,0,0,-217,4,-3,-1,-17,-4,-1,-1,3,-1,-200,8,-2,0
"2182","13",92,4,4,1,2,-148,-124,-2,-1,-73,-127,-1,-1,3,-1,-75,3,-1,0
"2183","13",347,5,1,0,3,236,-174,1,0,-165,108,2,4,3,-2,401,-282,-1,-4
"2184","13",368,9,3,1,3,-98,144,4,4,-134,137,4,4,3,-6,36,7,0,0
"2185","13",57,1,4,1,1,47,-243,1,-4,-1,-238,0,-4,3,2,48,-5,1,0
"2186","13",26,2,1,0,0,-220,-75,-4,-3,73,69,-1,-3,3,1,-293,-144,-3,0
"2187","13",11,7,4,1,1,-41,57,0,2,54,159,2,1,3,-4,-95,-102,-2,1
"2188","13",329,7,4,1,3,48,-56,1,2,-193,15,2,2,3,-4,241,-71,-1,0
"2189","13",183,4,4,1,1,38,59,1,-1,63,151,1,-2,3,-1,-25,-92,0,1
"2190","13",401,2,2,0,1,-119,26,1,-3,159,10,0,-2,3,1,-278,16,1,-1
"2191","13",162,8,3,1,3,49,53,0,3,54,-56,2,4,3,-5,-5,109,-2,-1
"2192","13",35,4,1,1,3,20,188,3,-1,144,183,3,-1,3,-1,-124,5,0,0
"2193","13",155,3,2,1,1,-152,-81,0,-2,7,3,0,0,3,0,-159,-84,0,-2
"2194","13",342,3,3,1,1,53,-163,1,-2,16,-175,2,-1,3,0,37,12,-1,-1
"2195","13",363,8,3,1,3,249,1,3,3,-229,2,-3,-3,3,-5,478,-1,6,6
"2196","13",213,6,2,1,1,-1,-2,0,1,40,3,-1,-1,3,-3,-41,-5,1,2
"2197","13",384,3,1,0,0,-50,0,-2,-2,1,66,-3,-3,3,0,-51,-66,1,1
"2198","13",303,2,3,1,2,-133,-108,-3,-3,-140,-25,-2,-3,3,1,7,-83,-1,0
"2199","13",457,2,3,1,1,-240,32,-2,-3,151,-130,2,2,3,1,-391,162,-4,-5
"2200","13",453,4,4,1,2,-1,0,1,-1,-172,9,0,-2,3,-1,171,-9,1,1
"2201","13",161,1,2,0,2,-236,76,-3,-4,79,75,1,-3,3,2,-315,1,-4,-1
"2202","13",349,4,4,1,1,-63,-31,0,-1,71,-68,1,2,3,-1,-134,37,-1,-3
"2203","13",154,5,4,1,3,-2,0,0,0,-1,64,0,0,3,-2,-1,-64,0,0
"2204","13",37,1,1,1,0,-212,24,-3,-4,-186,13,-3,-4,3,2,-26,11,0,0
"2205","13",59,3,1,0,0,-144,1,-2,-2,159,2,2,2,3,0,-303,-1,-4,-4
"2206","13",261,7,1,1,3,-55,-42,2,2,162,189,4,4,3,-4,-217,-231,-2,-2
"2207","13",209,4,4,1,3,177,7,2,-1,-181,4,-1,-1,3,-1,358,3,3,0
"2208","13",431,5,3,1,0,17,20,0,0,-2,2,0,0,3,-2,19,18,0,0
"2209","13",355,3,2,1,2,-62,-13,-3,-2,-199,98,-4,-3,3,0,137,-111,1,1
"2210","13",132,5,4,1,1,9,-219,-1,0,2,-36,2,1,3,-2,7,-183,-3,-1
"2211","13",164,6,2,1,2,31,-1,1,1,-220,-46,-3,-3,3,-3,251,45,4,4
"2212","13",93,6,1,0,1,-22,-14,-1,1,-51,19,-1,1,3,-3,29,-33,0,0
"2213","13",157,1,3,1,2,-29,15,-3,-4,138,113,-1,0,3,2,-167,-98,-2,-4
"2214","13",424,4,2,0,2,129,79,0,-1,138,87,1,0,3,-1,-9,-8,-1,-1
"2215","13",365,1,3,1,1,-226,-3,0,-4,-189,-3,2,0,3,2,-37,0,-2,-4
"2216","13",215,2,1,0,0,-172,21,-2,-3,114,21,-2,-3,3,1,-286,0,0,0
"2217","13",110,7,1,0,1,-85,53,-4,2,91,47,3,0,3,-4,-176,6,-7,2
"2218","13",33,5,3,1,1,-76,36,0,0,33,-52,0,2,3,-2,-109,88,0,-2
"2219","13",184,7,3,1,3,119,2,1,2,43,-99,1,1,3,-4,76,101,0,1
"2220","13",402,1,3,0,0,-243,0,-2,-4,132,1,2,-2,3,2,-375,-1,-4,-2
"2221","13",163,3,3,0,1,-82,48,-1,-2,92,-5,1,1,3,0,-174,53,-2,-3
"2222","13",350,4,4,0,1,-7,-240,-1,-1,8,-244,4,0,3,-1,-15,4,-5,-1
"2223","13",156,5,2,1,1,41,2,0,0,65,12,1,1,3,-2,-24,-10,-1,-1
"2224","13",343,4,2,0,2,-54,2,-1,-1,-25,2,-1,-1,3,-1,-29,0,0,0
"2225","13",364,5,3,1,1,-4,-78,0,0,-56,4,1,-1,3,-2,52,-82,-1,1
"2226","13",214,9,1,0,3,166,1,4,4,243,4,4,4,3,-6,-77,-3,0,0
"2227","13",385,4,4,0,1,-82,-65,0,-1,-85,-100,-1,-1,3,-1,3,35,1,0
"2228","13",304,6,2,1,2,60,-37,1,1,-57,-30,2,2,3,-3,117,-7,-1,-1
"2229","13",458,2,1,0,1,-53,-42,-1,-3,77,74,-3,-2,3,1,-130,-116,2,-1
"2230","13",454,5,4,1,3,-1,2,0,0,-1,2,0,0,3,-2,0,0,0,0
"2231","13",425,5,4,1,2,-17,-22,0,0,60,-3,0,0,3,-2,-77,-19,0,0
"2232","13",159,3,3,1,2,238,1,1,-2,237,4,3,3,3,0,1,-3,-2,-5
"2233","13",216,5,3,0,1,27,5,-1,0,59,4,1,-1,3,-2,-32,1,-2,1
"2234","13",370,9,1,0,3,237,-10,4,4,-234,-12,-4,-4,3,-6,471,2,8,8
"2235","13",6,2,4,0,2,-238,1,-3,-3,-60,-1,-4,-4,3,1,-178,2,1,1
"2236","13",262,7,4,1,3,32,41,1,2,71,49,1,1,3,-4,-39,-8,0,1
"2237","13",21,2,4,1,2,-47,-39,-2,-3,60,64,-1,-2,3,1,-107,-103,-1,-1
"2238","13",432,5,2,1,1,36,-38,0,0,58,-69,0,0,3,-2,-22,31,0,0
"2239","13",356,5,4,1,1,41,1,1,0,63,1,1,1,3,-2,-22,0,0,-1
"2240","13",133,2,2,1,1,-140,-217,1,-3,1,26,2,-1,3,1,-141,-243,-1,-2
"2241","13",372,1,3,1,0,-212,-227,-4,-4,-51,-72,-4,-4,3,2,-161,-155,0,0
"2242","13",158,4,3,1,0,-42,-19,-1,-1,-34,-22,-2,0,3,-1,-8,3,1,-1
"2243","13",118,6,3,1,1,-84,-35,-2,1,22,-17,-1,1,3,-3,-106,-18,-1,0
"2244","13",211,9,3,1,1,51,52,3,4,82,85,-1,2,3,-6,-31,-33,4,2
"2245","13",22,3,3,1,1,-222,30,-2,-2,115,-18,1,2,3,0,-337,48,-3,-4
"2246","13",459,1,3,1,1,-127,43,3,-4,42,-34,3,-3,3,2,-169,77,0,-1
"2247","13",111,1,1,1,0,40,-37,-4,-4,9,180,3,1,3,2,31,-217,-7,-5
"2248","13",330,5,2,0,2,54,1,1,0,213,134,1,1,3,-2,-159,-133,0,-1
"2249","13",185,5,4,1,2,39,-17,-2,0,225,-12,3,-1,3,-2,-186,-5,-5,1
"2250","13",403,3,1,1,0,-92,-17,0,-2,96,-74,2,2,3,0,-188,57,-2,-4
"2251","13",371,3,3,1,0,212,-120,-1,-2,221,-37,-2,-2,3,0,-9,-83,1,0
"2252","13",160,6,2,0,0,-217,0,-4,1,-191,3,2,2,3,-3,-26,-3,-6,-1
"2253","13",263,1,4,1,0,-240,-3,-4,-4,-246,2,-4,-4,3,2,6,-5,0,0
"2254","13",210,4,4,1,2,171,34,3,-1,136,-45,2,-3,3,-1,35,79,1,2
"2255","13",420,6,4,1,3,207,-3,3,1,-1,-83,2,3,3,-3,208,80,1,-2
"2256","13",357,6,4,1,2,132,43,1,1,132,112,1,1,3,-3,0,-69,0,0
"2257","13",134,1,2,1,2,-143,-4,-2,-4,-130,-7,0,-3,3,2,-13,3,-2,-1
"2258","13",305,6,4,1,3,163,11,2,1,116,122,2,2,3,-3,47,-111,0,-1
"2259","13",421,7,3,1,1,80,61,0,2,147,162,-1,-2,3,-4,-67,-101,1,4
"2260","13",455,2,2,1,2,-244,2,-3,-3,2,244,4,3,3,1,-246,-242,-7,-6
"2261","13",426,4,4,1,3,0,0,-1,-1,240,3,4,2,3,-1,-240,-3,-5,-3
"2262","13",16,1,1,0,0,-223,10,-3,-4,79,17,-2,-4,3,2,-302,-7,-1,0
"2263","13",217,2,4,0,2,-69,21,-1,-3,23,16,1,-1,3,1,-92,5,-2,-2
"2264","13",112,9,4,1,3,80,231,4,4,217,220,4,2,3,-6,-137,11,0,2
"2265","13",60,7,1,0,3,202,4,2,2,142,-1,2,2,3,-4,60,5,0,0
"2266","13",186,5,2,1,2,6,4,0,0,18,21,0,0,3,-2,-12,-17,0,0
"2267","13",404,5,1,0,1,71,-61,1,0,40,-59,1,0,3,-2,31,-2,0,0
"2268","13",433,2,1,0,0,-149,-149,2,-3,189,172,3,-3,3,1,-338,-321,-1,0
"2269","13",222,2,1,0,0,-124,1,-2,-3,-239,1,-3,-3,3,1,115,0,1,0
"2270","13",219,3,4,1,3,249,1,4,-2,249,1,4,-1,3,0,0,0,0,-1
"2271","13",227,4,3,1,3,52,38,1,-1,53,22,-1,-2,3,-1,-1,16,2,1
"2272","13",434,7,4,1,3,78,-39,2,2,80,-102,2,2,3,-4,-2,63,0,0
"2273","13",119,6,3,1,3,159,70,2,1,-106,136,0,0,3,-3,265,-66,2,1
"2274","13",439,6,2,1,1,1,0,1,1,-4,2,0,0,3,-3,5,-2,1,1
"2275","13",220,1,4,1,2,-200,71,-4,-4,72,86,-2,-2,3,2,-272,-15,-2,-2
"2276","13",46,3,1,0,0,-39,-243,-3,-2,-99,-240,-4,-3,3,0,60,-3,1,1
"2277","13",456,2,1,0,0,-5,-161,-2,-3,-10,100,2,-3,3,1,5,-261,-4,0
"2278","13",331,1,1,1,0,10,-69,-4,-4,21,-31,-4,-3,3,2,-11,-38,0,-1
"2279","13",221,5,4,0,1,-4,3,0,0,12,-10,0,0,3,-2,-16,13,0,0
"2280","13",218,8,4,1,3,-197,-1,4,3,-227,56,4,3,3,-5,30,-57,0,0
"2281","13",23,9,1,0,3,-175,-182,-4,4,223,216,4,4,3,-6,-398,-398,-8,0
"2282","13",332,2,1,0,0,-242,98,-3,-3,-242,74,-3,-2,3,1,0,24,0,-1
"2283","13",187,3,4,0,2,-172,-1,-2,-2,-69,-64,-2,-4,3,0,-103,63,0,2
"2284","13",114,1,4,1,1,-59,-90,-4,-4,141,107,1,-3,3,2,-200,-197,-5,-1
"2285","13",441,5,4,1,2,1,-8,0,0,-6,1,0,0,3,-2,7,-9,0,0
"2286","13",358,1,4,1,2,-126,91,-4,-4,-124,103,-4,-4,3,2,-2,-12,0,0
"2287","13",135,1,1,1,1,-229,206,-4,-4,-230,122,-3,-3,3,2,1,84,-1,-1
"2288","13",306,4,3,1,3,94,91,1,-1,126,177,1,0,3,-1,-32,-86,0,-1
"2289","13",422,3,3,1,1,-96,-239,4,-2,-96,-241,3,-1,3,0,0,2,1,-1
"2290","13",12,9,4,1,3,0,2,4,4,-1,1,4,4,3,-6,1,1,0,0
"2291","13",427,1,4,1,1,-240,-37,4,-4,-212,-48,4,-4,3,2,-28,11,0,0
"2292","13",165,4,1,0,1,84,13,0,-1,73,50,1,1,3,-1,11,-37,-1,-2
"2293","13",36,9,3,1,3,-161,-143,4,4,145,118,3,3,3,-6,-306,-261,1,1
"2294","13",113,4,2,0,2,92,80,-1,-1,-190,235,-3,-3,3,-1,282,-155,2,2
"2295","13",440,3,3,1,0,-174,1,-2,-2,119,0,3,3,3,0,-293,1,-5,-5
"2296","13",226,1,1,0,0,-62,1,-2,-4,98,1,2,-3,3,2,-160,0,-4,-1
"2297","13",405,4,4,1,1,-64,-42,1,-1,44,-44,-1,0,3,-1,-108,2,2,-1
"2298","13",138,4,3,1,1,-56,-41,-1,-1,-68,-27,-1,-1,3,-1,12,-14,0,0
"2299","13",223,5,1,0,1,-2,-1,0,0,173,-1,-1,0,3,-2,-175,0,1,0
"2300","13",446,5,4,1,1,90,30,0,0,20,31,0,0,3,-2,70,-1,0,0
"2301","13",228,5,4,1,2,-49,-239,0,0,3,8,4,4,3,-2,-52,-247,-4,-4
"2302","13",435,5,4,1,1,67,-84,0,0,69,-90,0,0,3,-2,-2,6,0,0
"2303","13",359,9,4,1,3,237,12,4,4,234,12,4,4,3,-6,3,0,0,0
"2304","13",44,1,2,1,2,-169,3,-2,-4,125,-46,-1,-4,3,2,-294,49,-1,0
"2305","13",229,2,1,1,1,-234,-64,-3,-3,-237,231,0,-4,3,1,3,-295,-3,1
"2306","13",423,5,1,0,3,208,-13,0,0,-25,-144,2,-1,3,-2,233,131,-2,1
"2307","13",137,4,1,0,1,-217,-138,-3,-1,-60,-62,-3,0,3,-1,-157,-76,0,-1
"2308","13",408,3,1,0,0,-180,-1,-2,-2,-140,-92,1,-1,3,0,-40,91,-3,-1
"2309","13",166,2,4,1,2,184,168,-1,-3,221,222,-3,-4,3,1,-37,-54,2,1
"2310","13",449,6,4,1,3,-37,54,1,1,-161,65,2,-1,3,-3,124,-11,-1,2
"2311","13",190,9,4,1,3,233,184,4,4,210,195,4,4,3,-6,23,-11,0,0
"2312","13",333,4,4,1,1,39,-1,-1,-1,66,-48,1,1,3,-1,-27,47,-2,-2
"2313","13",188,8,2,1,3,205,7,3,3,203,-1,3,3,3,-5,2,8,0,0
"2314","13",115,5,3,1,3,229,4,3,0,-2,109,0,0,3,-2,231,-105,3,0
"2315","13",442,6,4,1,1,-28,26,-1,1,23,24,1,1,3,-3,-51,2,-2,0
"2316","13",224,3,2,0,2,-121,-22,-2,-2,171,68,2,1,3,0,-292,-90,-4,-3
"2317","13",136,4,1,0,0,-184,-15,-3,-1,126,-169,-3,-1,3,-1,-310,154,0,0
"2318","13",116,3,2,1,3,-74,-11,0,-2,10,-7,2,-2,3,0,-84,-4,-2,0
"2319","13",436,7,4,1,3,234,-163,2,2,-12,1,3,3,3,-4,246,-164,-1,-1
"2320","13",120,6,3,1,1,141,114,1,1,159,-113,2,2,3,-3,-18,227,-1,-1
"2321","13",448,1,2,1,2,-42,-2,-2,-4,1,101,-1,-4,3,2,-43,-103,-1,0
"2322","13",117,3,4,1,2,-173,2,-2,-2,-226,1,-4,-4,3,0,53,1,2,2
"2323","13",360,1,3,1,0,-208,-35,-2,-4,154,211,0,-4,3,2,-362,-246,-2,0
"2324","13",336,3,4,1,3,201,139,2,-2,183,159,3,-3,3,0,18,-20,-1,1
"2325","13",417,1,2,0,2,-171,-167,-3,-4,-141,-146,-4,-4,3,2,-30,-21,1,0
"2326","13",438,5,4,1,3,141,1,4,0,110,1,4,1,3,-2,31,0,0,-1
"2327","13",406,7,2,1,2,-31,-32,1,2,193,46,-2,1,3,-4,-224,-78,3,1
"2328","13",139,2,4,0,2,-249,-2,4,-3,-168,1,-4,-4,3,1,-81,-3,8,1
"2329","13",334,1,4,1,0,-237,139,-4,-4,-242,61,-4,-4,3,2,5,78,0,0
"2330","13",447,3,4,1,2,41,3,0,-2,92,44,2,2,3,0,-51,-41,-2,-4
"2331","13",407,7,2,0,2,124,97,1,2,21,46,1,3,3,-4,103,51,0,-1
"2332","13",443,3,1,0,0,-84,-30,-2,-2,54,50,0,0,3,0,-138,-80,-2,-2
"2333","13",19,3,2,0,2,-75,-47,1,-2,-107,-52,0,1,3,0,32,5,1,-3
"2334","13",144,1,3,1,0,-19,-2,-4,-4,-25,-238,-4,0,3,2,6,236,0,-4
"2335","13",140,6,1,0,1,45,-47,1,1,13,-13,1,0,3,-3,32,-34,0,1
"2336","13",437,3,1,0,0,-124,-1,-2,-2,64,4,0,0,3,0,-188,-5,-2,-2
"2337","13",42,3,3,1,1,2,-19,2,-2,-2,19,2,-2,3,0,4,-38,0,0
"2338","13",409,2,4,1,2,-45,-63,-3,-3,115,118,2,2,3,1,-160,-181,-5,-5
"2339","13",445,7,4,1,3,93,-26,2,2,112,-75,1,2,3,-4,-19,49,1,0
"2340","13",361,3,1,1,0,-1,-242,2,-2,-1,-227,3,-1,3,0,0,-15,-1,-1
"2341","13",191,3,1,0,0,-209,-35,-2,-2,-207,-29,-3,-3,3,0,-2,-6,1,1
"2342","13",418,4,2,0,2,-181,16,1,-1,-166,27,-1,-1,3,-1,-15,-11,2,0
"2343","13",189,3,1,1,1,-180,20,3,-2,-153,24,2,2,3,0,-27,-4,1,-4
"2344","13",143,7,1,1,3,176,37,2,2,213,6,2,2,3,-4,-37,31,0,0
"2345","13",14,4,3,1,1,-82,-5,-1,-1,70,-21,0,0,3,-1,-152,16,-1,-1
"2346","13",225,6,2,0,2,118,-56,1,1,81,-124,1,1,3,-3,37,68,0,0
"2347","13",148,1,1,1,1,-248,140,1,-4,-205,-148,2,-2,3,2,-43,288,-1,-2
"2348","13",193,1,1,0,0,-203,-44,-4,-4,-223,-35,-4,-4,3,2,20,-9,0,0
"2349","13",444,2,2,0,2,-135,0,-2,-3,-127,1,-2,-3,3,1,-8,-1,0,0
"2350","13",415,4,2,1,2,6,-7,0,-1,124,135,0,1,3,-1,-118,-142,0,-2
"2351","13",145,6,1,0,1,43,57,1,1,95,131,0,-2,3,-3,-52,-74,1,3
"2352","13",141,1,1,0,0,-135,9,-3,-4,-80,33,-2,-3,3,2,-55,-24,-1,-1
"2353","13",337,8,2,0,3,-129,13,3,3,240,-14,4,4,3,-5,-369,27,-1,-1
"2354","13",15,8,4,1,3,64,36,2,3,103,66,3,2,3,-5,-39,-30,-1,1
"2355","13",41,6,2,0,3,40,69,2,1,51,68,2,1,3,-3,-11,1,0,0
"2356","13",147,6,2,0,3,98,172,2,1,46,95,1,-1,3,-3,52,77,1,2
"2357","13",338,3,3,1,2,111,123,1,-2,83,106,-2,1,3,0,28,17,3,-3
"2358","13",192,7,4,1,1,-98,2,1,2,-1,80,1,2,3,-4,-97,-78,0,0
"2359","13",335,4,2,1,1,-103,24,-1,-1,-92,29,-1,-1,3,-1,-11,-5,0,0
"2360","13",414,6,1,0,0,105,77,1,1,106,93,2,2,3,-3,-1,-16,-1,-1
"2361","13",339,4,3,1,1,-59,-19,-1,-1,-47,-49,-2,-1,3,-1,-12,30,1,0
"2362","13",411,9,2,1,2,242,234,4,4,219,221,4,4,3,-6,23,13,0,0
"2363","13",416,1,4,1,0,-81,36,-4,-4,-231,218,-4,-4,3,2,150,-182,0,0
"2364","13",149,6,3,1,1,-1,-1,-3,1,245,2,-3,1,3,-3,-246,-3,0,0
"2365","13",194,8,1,0,0,-182,9,-4,3,-191,11,-4,3,3,-5,9,-2,0,0
"2366","13",412,9,1,1,0,-238,8,-4,4,-144,1,-4,4,3,-6,-94,7,0,0
"2367","13",150,5,3,1,1,164,5,-1,0,-3,-34,0,0,3,-2,167,39,-1,0
"2368","13",146,2,2,0,0,-190,-183,-3,-3,-195,-192,-4,-3,3,1,5,9,1,0
"2369","13",142,5,2,1,2,-17,-14,-3,0,13,20,-3,0,3,-2,-30,-34,0,0
"2370","13",413,5,1,0,1,-61,205,1,0,118,-105,3,3,3,-2,-179,310,-2,-3
"2371","13",197,3,4,1,3,-239,82,4,-2,-239,-30,2,0,3,0,0,112,2,-2
"2372","13",419,6,4,1,3,195,108,1,1,174,132,2,1,3,-3,21,-24,-1,0
"2373","13",153,6,1,0,3,15,11,2,1,-49,20,-1,1,3,-3,64,-9,3,0
"2374","13",34,6,4,1,2,132,-101,1,1,116,-64,1,1,3,-3,16,-37,0,0
"2375","13",198,2,1,1,1,-88,127,-1,-3,94,-76,0,2,3,1,-182,203,-1,-5
"2376","13",151,1,2,1,1,-207,19,4,-4,-246,9,4,-4,3,2,39,10,0,0
"2377","13",410,1,1,0,0,-201,-21,1,-4,49,24,1,-3,3,2,-250,-45,0,-1
"2378","13",195,2,1,0,1,-174,163,3,-3,25,-21,2,0,3,1,-199,184,1,-3
"2379","13",152,5,1,0,0,8,1,0,0,141,1,0,1,3,-2,-133,0,0,-1
"2380","13",196,2,3,1,0,6,-38,-3,-3,-2,0,0,0,3,1,8,-38,-3,-3
"2381","14",234,5,3,1,3,120,28,1,0,84,83,0,1,4,-1,36,-55,1,-1
"2382","14",237,5,2,0,2,-248,0,-2,0,-1,0,0,0,4,-1,-247,0,-2,0
"2383","14",236,5,1,0,1,-25,-16,0,0,20,-21,0,0,4,-1,-45,5,0,0
"2384","14",241,1,4,0,2,-198,-175,-2,-4,191,183,2,-1,4,3,-389,-358,-4,-3
"2385","14",238,3,3,1,1,-29,56,2,-2,174,-66,3,2,4,1,-203,122,-1,-4
"2386","14",318,4,2,1,2,-42,-193,-4,-1,178,192,-4,0,4,0,-220,-385,0,-1
"2387","14",240,2,2,1,1,-3,-7,-1,-3,-3,-7,0,0,4,2,0,0,-1,-3
"2388","14",235,9,3,1,0,248,1,4,4,43,3,3,1,4,-5,205,-2,1,3
"2389","14",67,1,1,0,0,-21,26,-4,-4,123,-150,1,1,4,3,-144,176,-5,-5
"2390","14",244,8,4,1,2,212,203,3,3,236,233,3,3,4,-4,-24,-30,0,0
"2391","14",319,3,1,0,1,-100,64,-2,-2,41,78,1,1,4,1,-141,-14,-3,-3
"2392","14",320,2,2,0,2,-246,138,-3,-3,-210,134,-3,-2,4,2,-36,4,0,-1
"2393","14",242,3,4,1,2,41,3,1,-2,-22,0,-1,-2,4,1,63,3,2,0
"2394","14",245,3,1,1,0,-208,-6,-2,-2,-120,-7,-2,-3,4,1,-88,1,0,1
"2395","14",65,7,1,0,3,-73,86,1,2,-117,26,1,2,4,-3,44,60,0,0
"2396","14",243,2,2,1,2,-244,87,-3,-3,-247,-171,-3,2,4,2,3,258,0,-5
"2397","14",24,1,2,0,2,247,0,4,-4,244,1,4,4,4,3,3,-1,0,-8
"2398","14",32,5,1,0,1,2,6,0,0,185,-159,2,-4,4,-1,-183,165,-2,4
"2399","14",324,5,2,0,0,-11,5,0,0,-158,-23,-2,-2,4,-1,147,28,2,2
"2400","14",248,5,4,1,3,20,92,0,0,14,86,1,1,4,-1,6,6,-1,-1
"2401","14",321,4,1,1,0,-54,-45,-1,-1,-186,-165,-1,-1,4,0,132,120,0,0
"2402","14",233,3,2,0,2,-216,43,-3,-2,-33,14,0,0,4,1,-183,29,-3,-2
"2403","14",325,9,1,0,1,-143,-135,-3,4,-84,-102,-3,4,4,-5,-59,-33,0,0
"2404","14",395,4,3,1,1,-67,12,3,-1,225,13,-2,2,4,0,-292,-1,5,-3
"2405","14",322,6,4,1,3,109,-104,1,1,236,-229,3,3,4,-2,-127,125,-2,-2
"2406","14",68,2,4,1,0,132,5,0,-3,191,4,-2,-3,4,2,-59,1,2,0
"2407","14",239,3,1,1,1,-80,-31,-2,-2,92,163,1,1,4,1,-172,-194,-3,-3
"2408","14",396,1,1,1,1,-128,76,4,-4,-166,156,4,-4,4,3,38,-80,0,0
"2409","14",323,1,4,1,1,0,-43,-4,-4,191,2,0,-4,4,3,-191,-45,-4,0
"2410","14",247,5,3,1,0,95,-8,0,0,198,-18,2,2,4,-1,-103,10,-2,-2
"2411","14",66,4,1,0,1,-77,0,1,-1,169,0,1,2,4,0,-246,0,0,-3
"2412","14",232,1,1,0,0,-133,-19,-2,-4,-229,-4,-2,-4,4,3,96,-15,0,0
"2413","14",7,4,1,0,3,84,42,1,-1,81,23,1,-1,4,0,3,19,0,0
"2414","14",398,7,4,1,2,184,90,2,2,-33,30,-3,-3,4,-3,217,60,5,5
"2415","14",272,6,4,1,2,58,43,0,1,35,39,0,1,4,-2,23,4,0,0
"2416","14",394,1,3,0,0,-246,245,-4,-4,-248,246,-4,-4,4,3,2,-1,0,0
"2417","14",249,1,3,1,0,-108,-144,-3,-4,-210,-80,-3,-4,4,3,102,-64,0,0
"2418","14",399,6,4,1,3,92,17,1,1,184,-8,2,2,4,-2,-92,25,-1,-1
"2419","14",391,5,2,0,3,205,205,0,0,132,134,0,0,4,-1,73,71,0,0
"2420","14",246,6,4,1,3,225,1,4,1,138,-2,3,2,4,-2,87,3,1,-1
"2421","14",25,4,4,1,2,0,6,0,-1,39,30,0,0,4,0,-39,-24,0,-1
"2422","14",4,5,3,1,1,2,0,0,0,227,221,2,2,4,-1,-225,-221,-2,-2
"2423","14",69,2,4,1,1,73,52,2,-3,-109,-79,1,-1,4,2,182,131,1,-2
"2424","14",397,6,4,1,3,-171,-84,0,1,-106,131,1,1,4,-2,-65,-215,-1,0
"2425","14",271,6,3,1,1,9,0,1,1,243,-2,4,4,4,-2,-234,2,-3,-3
"2426","14",393,1,1,0,0,-226,-24,-4,-4,-2,1,0,-2,4,3,-224,-25,-4,-2
"2427","14",276,8,4,1,3,217,3,3,3,182,-1,3,3,4,-4,35,4,0,0
"2428","14",386,1,1,0,0,-248,125,-2,-4,11,8,0,-1,4,3,-259,117,-2,-3
"2429","14",400,5,4,1,2,19,23,-2,0,34,28,2,2,4,-1,-15,-5,-4,-2
"2430","14",390,8,2,1,2,230,43,3,3,136,-30,1,1,4,-4,94,73,2,2
"2431","14",387,3,3,1,1,-77,-76,-1,-2,174,182,3,4,4,1,-251,-258,-4,-6
"2432","14",273,1,1,0,0,-228,5,-3,-4,215,152,3,2,4,3,-443,-147,-6,-6
"2433","14",326,7,4,1,2,144,86,2,2,164,97,2,2,4,-3,-20,-11,0,0
"2434","14",169,5,3,1,0,-54,145,-2,0,-172,-43,-3,-3,4,-1,118,188,1,3
"2435","14",388,2,4,1,0,-157,10,-4,-3,-229,8,-1,-1,4,2,72,2,-3,-2
"2436","14",392,3,1,0,0,-59,91,-2,-2,-125,107,-2,-2,4,1,66,-16,0,0
"2437","14",275,4,4,1,2,1,242,4,-1,0,-239,3,-1,4,0,1,481,1,0
"2438","14",250,6,1,0,3,77,20,1,1,86,25,1,1,4,-2,-9,-5,0,0
"2439","14",40,4,1,0,2,144,82,2,-1,-63,58,2,2,4,0,207,24,0,-3
"2440","14",39,5,3,1,1,48,72,0,0,178,205,3,4,4,-1,-130,-133,-3,-4
"2441","14",251,2,3,1,1,200,27,2,-3,9,10,2,-2,4,2,191,17,0,-1
"2442","14",167,4,1,0,3,-101,51,3,-1,-116,-126,3,3,4,0,15,177,0,-4
"2443","14",70,1,2,0,2,-235,-170,1,-4,238,235,4,2,4,3,-473,-405,-3,-6
"2444","14",277,1,4,1,1,-71,69,4,-4,-26,19,3,-4,4,3,-45,50,1,0
"2445","14",168,4,1,0,3,93,-116,-2,-1,183,-107,2,1,4,0,-90,-9,-4,-2
"2446","14",172,9,2,0,3,137,122,4,4,108,142,-2,-2,4,-5,29,-20,6,6
"2447","14",71,4,3,1,1,-26,14,-1,-1,37,31,-1,0,4,0,-63,-17,0,-1
"2448","14",278,1,4,1,1,-231,-233,4,-4,-184,-177,4,-4,4,3,-47,-56,0,0
"2449","14",274,7,4,1,2,105,-49,2,2,54,-124,1,2,4,-3,51,75,1,0
"2450","14",327,4,4,1,3,24,-166,1,-1,97,118,1,-1,4,0,-73,-284,0,0
"2451","14",17,1,3,1,0,13,0,-1,-4,134,79,0,-4,4,3,-121,-79,-1,0
"2452","14",389,5,3,1,2,-3,0,0,0,-14,-12,0,0,4,-1,11,12,0,0
"2453","14",328,6,3,1,1,12,10,1,1,176,21,2,2,4,-2,-164,-11,-1,-1
"2454","14",170,1,2,0,0,-239,-239,-4,-4,18,15,0,0,4,3,-257,-254,-4,-4
"2455","14",377,4,1,0,0,212,25,4,-1,231,3,4,1,4,0,-19,22,0,-2
"2456","14",175,5,4,1,1,-182,-33,-2,0,6,10,-1,-2,4,-1,-188,-43,-1,2
"2457","14",171,6,1,1,1,60,20,1,1,45,31,0,0,4,-2,15,-11,1,1
"2458","14",252,5,4,1,1,-72,-127,0,0,-94,73,0,-1,4,-1,22,-200,0,1
"2459","14",401,3,2,0,1,-106,39,0,-2,95,-3,0,-2,4,1,-201,42,0,0
"2460","14",176,3,1,1,1,114,25,-3,-2,132,61,-3,-4,4,1,-18,-36,0,2
"2461","14",471,8,3,1,2,-20,43,1,3,-100,71,1,-1,4,-4,80,-28,0,4
"2462","14",314,1,4,1,1,-242,10,4,-4,-241,4,4,-4,4,3,-1,6,0,0
"2463","14",173,7,4,1,3,151,-1,2,2,192,6,0,1,4,-3,-41,-7,2,1
"2464","14",72,5,1,1,0,50,48,0,0,126,134,2,2,4,-1,-76,-86,-2,-2
"2465","14",279,7,4,1,3,128,74,2,2,75,-63,2,1,4,-3,53,137,0,1
"2466","14",174,5,4,1,3,139,83,1,0,43,109,0,1,4,-1,96,-26,1,-1
"2467","14",98,2,3,1,0,-238,31,-2,-3,188,-170,2,3,4,2,-426,201,-4,-6
"2468","14",473,6,3,1,0,14,11,1,1,-25,14,0,0,4,-2,39,-3,1,1
"2469","14",373,1,3,1,0,-236,-36,0,-4,-224,-22,0,-4,4,3,-12,-14,0,0
"2470","14",329,7,4,1,3,16,25,-2,2,233,214,-2,2,4,-3,-217,-189,0,0
"2471","14",474,1,1,0,0,2,-85,-4,-4,3,-90,-1,-4,4,3,-1,5,-3,0
"2472","14",317,5,4,0,2,5,-3,0,0,-20,29,-1,-1,4,-1,25,-32,1,1
"2473","14",31,4,1,0,0,-182,-190,-1,-1,-216,104,-4,-4,4,0,34,-294,3,3
"2474","14",33,5,3,1,1,-93,48,0,0,58,-114,0,0,4,-1,-151,162,0,0
"2475","14",253,7,3,1,3,42,69,2,2,63,115,0,0,4,-3,-21,-46,2,2
"2476","14",402,2,3,1,0,-57,-3,-3,-3,217,-4,4,-2,4,2,-274,1,-7,-1
"2477","14",177,3,4,1,1,29,179,4,-2,46,111,2,-2,4,1,-17,68,2,0
"2478","14",472,1,1,1,0,-17,10,-4,-4,54,9,-4,-4,4,3,-71,1,0,0
"2479","14",201,4,3,1,1,62,-2,-2,-1,5,0,-1,-4,4,0,57,-2,-1,3
"2480","14",178,5,1,0,1,0,0,0,0,0,0,0,0,4,-1,0,0,0,0
"2481","14",73,4,4,1,2,-154,-130,-1,-1,160,-169,1,-1,4,0,-314,39,-2,0
"2482","14",316,2,3,1,0,-164,-77,-3,-3,-133,-103,-3,-3,4,2,-31,26,0,0
"2483","14",179,5,1,0,1,-1,-1,2,0,2,-1,0,1,4,-1,-3,0,2,-1
"2484","14",99,7,4,1,3,32,41,4,2,245,8,3,3,4,-3,-213,33,1,-1
"2485","14",378,3,4,1,1,-159,-2,-2,-2,-174,-4,1,-2,4,1,15,2,-3,0
"2486","14",374,6,4,1,2,89,15,1,1,18,12,1,1,4,-2,71,3,0,0
"2487","14",18,2,3,1,1,-1,-35,-1,-3,29,19,-1,-3,4,2,-30,-54,0,0
"2488","14",475,6,3,1,3,143,-128,2,1,-106,-76,0,0,4,-2,249,-52,2,1
"2489","14",102,9,4,1,3,-55,-77,2,4,-114,-91,0,1,4,-5,59,14,2,3
"2490","14",310,7,4,1,2,112,1,2,2,-17,-1,-1,-1,4,-3,129,2,3,3
"2491","14",330,2,2,1,2,-234,1,0,-3,190,164,2,2,4,2,-424,-163,-2,-5
"2492","14",315,8,3,1,3,242,13,4,3,244,9,3,3,4,-4,-2,4,1,0
"2493","14",403,4,1,1,0,-5,-26,2,-1,-23,-8,2,-1,4,0,18,-18,0,0
"2494","14",199,3,4,1,2,-222,56,-3,-2,19,33,0,0,4,1,-241,23,-3,-2
"2495","14",28,4,4,1,1,-46,-41,-1,-1,7,4,-1,-1,4,0,-53,-45,0,0
"2496","14",309,3,4,1,2,200,129,-2,-2,140,116,-1,-1,4,1,60,13,-1,-1
"2497","14",2,4,4,1,1,-126,45,-1,-1,101,-113,0,1,4,0,-227,158,-1,-2
"2498","14",269,1,4,1,2,-250,134,-3,-4,-245,107,-4,-4,4,3,-5,27,1,0
"2499","14",265,8,1,0,3,112,1,2,3,1,-3,0,0,4,-4,111,4,2,3
"2500","14",313,6,3,1,0,117,103,1,1,120,63,2,2,4,-2,-3,40,-1,-1
"2501","14",75,4,4,0,2,231,27,0,-1,245,239,4,-2,4,0,-14,-212,-4,1
"2502","14",379,3,3,0,1,-44,-39,1,-2,-4,-8,1,0,4,1,-40,-31,0,-2
"2503","14",375,5,3,1,1,1,-1,0,0,0,1,0,0,4,-1,1,-2,0,0
"2504","14",180,1,2,0,2,-60,-33,-2,-4,-111,2,-2,-2,4,3,51,-35,0,-2
"2505","14",254,8,2,0,3,80,-25,3,3,157,-124,-2,0,4,-4,-77,99,5,3
"2506","14",103,7,2,1,3,47,-46,2,2,-17,126,1,1,4,-3,64,-172,1,1
"2507","14",311,1,2,1,2,-17,4,-1,-4,183,32,4,-4,4,3,-200,-28,-5,0
"2508","14",268,7,4,1,3,151,-86,2,2,124,-110,2,2,4,-3,27,24,0,0
"2509","14",202,4,1,0,1,8,47,3,-1,24,57,-2,-1,4,0,-16,-10,5,0
"2510","14",312,5,4,1,1,3,-10,0,0,-49,-112,1,0,4,-1,52,102,-1,0
"2511","14",74,2,3,1,0,-55,-1,-1,-3,57,-1,1,0,4,2,-112,0,-2,-3
"2512","14",280,4,2,0,1,229,-133,2,-1,54,74,1,0,4,0,175,-207,1,-1
"2513","14",203,9,4,1,3,244,6,4,4,235,20,4,4,4,-5,9,-14,0,0
"2514","14",20,6,3,1,0,67,61,-1,1,215,216,4,4,4,-2,-148,-155,-5,-3
"2515","14",27,5,2,1,2,-21,-34,0,0,24,12,0,0,4,-1,-45,-46,0,0
"2516","14",266,4,1,1,1,-43,0,-1,-1,-113,0,-1,-1,4,0,70,0,0,0
"2517","14",1,7,1,1,1,17,14,1,2,19,15,1,2,4,-3,-2,-1,0,0
"2518","14",476,6,3,1,0,155,83,1,1,59,-96,0,0,4,-2,96,179,1,1
"2519","14",384,3,1,1,0,11,63,-2,-2,0,109,-2,-2,4,1,11,-46,0,0
"2520","14",380,1,4,1,1,224,-57,3,-4,-141,-41,3,-4,4,3,365,-16,0,0
"2521","14",331,2,1,1,0,67,67,-4,-3,17,-106,-4,-3,4,2,50,173,0,0
"2522","14",264,4,4,1,2,245,54,1,-1,-219,6,-1,-2,4,0,464,48,2,1
"2523","14",404,4,1,1,1,41,-42,1,-1,66,-51,1,0,4,0,-25,9,0,-1
"2524","14",182,9,4,1,3,60,-28,4,4,-4,-215,4,2,4,-5,64,187,0,2
"2525","14",49,3,4,1,1,-86,-105,-2,-2,-51,23,-2,-2,4,1,-35,-128,0,0
"2526","14",105,6,1,1,0,56,4,1,1,134,20,2,1,4,-2,-78,-16,-1,0
"2527","14",101,1,3,1,0,-242,242,-4,-4,227,229,-3,-3,4,3,-469,13,-1,-1
"2528","14",467,9,1,0,3,-39,-36,4,4,126,161,4,0,4,-5,-165,-197,0,4
"2529","14",463,8,4,1,3,234,-5,1,3,249,-2,3,1,4,-4,-15,-3,-2,2
"2530","14",383,5,4,1,1,0,1,0,0,0,1,0,0,4,-1,0,0,0,0
"2531","14",76,6,4,1,3,128,6,1,1,54,-1,1,1,4,-2,74,7,0,0
"2532","14",38,9,4,0,3,236,-1,4,4,224,22,2,4,4,-5,12,-23,2,0
"2533","14",376,3,4,1,1,122,-33,-2,-2,75,-63,-2,-2,4,1,47,30,0,0
"2534","14",181,7,4,1,3,208,-72,2,2,83,141,2,1,4,-3,125,-213,0,1
"2535","14",255,1,3,0,1,-80,-131,-4,-4,166,135,1,1,4,3,-246,-266,-5,-5
"2536","14",104,2,1,1,0,-46,1,-1,-3,240,0,1,-3,4,2,-286,1,-2,0
"2537","14",100,8,4,1,3,228,-1,3,3,181,-3,3,3,4,-4,47,2,0,0
"2538","14",466,8,3,1,0,129,-118,1,3,-81,-122,-2,-2,4,-4,210,4,3,5
"2539","14",462,9,3,1,3,238,107,4,4,204,176,4,4,4,-5,34,-69,0,0
"2540","14",382,6,4,1,2,66,1,-1,1,56,-5,1,2,4,-2,10,6,-2,-1
"2541","14",333,6,4,1,1,48,7,1,1,-56,77,2,2,4,-2,104,-70,-1,-1
"2542","14",281,1,4,1,2,0,0,0,-4,-3,-246,0,-4,4,3,3,246,0,0
"2543","14",204,5,3,1,1,28,-16,0,0,114,-85,0,0,4,-1,-86,69,0,0
"2544","14",200,1,3,1,0,-201,-25,-4,-4,-153,-36,-4,-4,4,3,-48,11,0,0
"2545","14",270,5,3,0,1,1,-2,0,0,2,1,0,0,4,-1,-1,-3,0,0
"2546","14",267,4,3,1,1,-75,3,-1,-1,82,-14,1,1,4,0,-157,17,-2,-2
"2547","14",10,6,3,1,1,153,-7,0,1,235,-1,-2,-1,4,-2,-82,-6,2,2
"2548","14",48,1,3,1,0,11,-11,-4,-4,89,-83,-4,-4,4,3,-78,72,0,0
"2549","14",385,5,4,1,1,-45,-96,-1,0,67,58,1,1,4,-1,-112,-154,-2,-1
"2550","14",381,1,2,0,2,-234,11,-4,-4,16,92,2,2,4,3,-250,-81,-6,-6
"2551","14",332,1,1,0,0,-248,9,-3,-4,-246,60,-2,-2,4,3,-2,-51,-1,-2
"2552","14",256,5,3,1,1,99,0,0,0,114,120,1,1,4,-1,-15,-120,-1,-1
"2553","14",405,5,4,1,1,110,73,1,0,93,61,0,-2,4,-1,17,12,1,2
"2554","14",183,5,4,1,1,79,208,2,0,34,74,1,-3,4,-1,45,134,1,3
"2555","14",5,1,2,0,2,-224,7,-2,-4,-239,107,-2,-3,4,3,15,-100,0,-1
"2556","14",106,4,2,0,1,-171,-30,-1,-1,33,14,1,2,4,0,-204,-44,-2,-3
"2557","14",88,6,4,1,2,235,-32,2,1,153,-242,4,4,4,-2,82,210,-2,-3
"2558","14",468,8,1,0,3,37,22,1,3,-124,-56,1,1,4,-4,161,78,0,2
"2559","14",464,5,1,1,1,-70,-8,1,0,-85,16,1,-1,4,-1,15,-24,0,1
"2560","14",307,6,4,1,2,-30,-6,1,1,-20,2,-1,-1,4,-2,-10,-8,2,2
"2561","14",77,4,3,1,1,-89,5,-1,-1,-94,1,-1,-1,4,0,5,4,0,0
"2562","14",460,6,1,1,0,95,9,-2,1,202,46,-2,1,4,-2,-107,-37,0,0
"2563","14",457,4,3,1,1,114,-56,-1,-1,1,-233,3,0,4,0,113,177,-4,-1
"2564","14",453,4,4,1,2,15,-2,0,-1,-163,-1,0,-1,4,0,178,-1,0,0
"2565","14",45,6,3,1,0,35,54,-2,1,33,-27,2,2,4,-2,2,81,-4,-1
"2566","14",90,7,4,1,0,105,18,2,2,234,19,1,4,4,-3,-129,-1,1,-2
"2567","14",87,5,4,1,3,5,-11,0,0,0,-97,1,-1,4,-1,5,86,-1,1
"2568","14",470,4,1,1,1,-54,2,-1,-1,11,46,-1,-1,4,0,-65,-44,0,0
"2569","14",362,6,4,1,3,156,-109,2,1,105,-77,3,3,4,-2,51,-32,-1,-2
"2570","14",8,3,3,1,1,1,-10,2,-2,-96,94,-2,0,4,1,97,-104,4,-2
"2571","14",334,1,4,1,0,-203,56,-4,-4,-203,69,-4,-4,4,3,0,-13,0,0
"2572","14",282,8,3,1,3,51,-116,0,3,174,17,1,4,4,-4,-123,-133,-1,-1
"2573","14",205,6,1,0,2,26,-2,2,1,230,11,3,3,4,-2,-204,-13,-1,-2
"2574","14",428,3,1,0,0,-190,2,-2,-2,-222,-1,-2,-2,4,1,32,3,0,0
"2575","14",351,1,1,0,0,-246,-241,-4,-4,136,123,-4,-4,4,3,-382,-364,0,0
"2576","14",348,5,3,1,1,70,69,-1,0,131,96,0,-1,4,-1,-61,-27,-1,1
"2577","14",344,7,4,0,3,230,-25,2,2,-65,-44,-1,0,4,-3,295,19,3,2
"2578","14",47,7,4,1,3,94,8,2,2,200,4,3,2,4,-3,-106,4,-1,0
"2579","14",365,1,3,0,1,-222,5,4,-4,-229,7,0,-4,4,3,7,-2,4,0
"2580","14",82,9,4,1,2,41,220,4,4,42,-33,4,4,4,-5,-1,253,0,0
"2581","14",79,2,4,0,2,-234,33,-3,-3,-240,14,-3,-3,4,2,6,19,0,0
"2582","14",257,2,1,1,0,217,33,2,-3,171,55,2,-4,4,2,46,-22,0,1
"2583","14",406,4,2,1,2,-160,-71,-1,-1,15,-18,2,1,4,0,-175,-53,-3,-2
"2584","14",184,6,3,1,3,124,-7,1,1,127,2,1,1,4,-2,-3,-9,0,0
"2585","14",50,3,2,1,1,67,-1,1,-2,26,-1,0,-2,4,1,41,0,1,0
"2586","14",107,3,2,0,3,-133,127,1,-2,41,5,0,-2,4,1,-174,122,1,0
"2587","14",89,2,3,1,0,-100,1,-4,-3,-132,2,-4,-3,4,2,32,-1,0,0
"2588","14",469,1,4,1,0,130,63,-3,-4,130,47,-3,-4,4,3,0,16,0,0
"2589","14",465,7,4,1,3,12,220,1,2,19,-244,4,4,4,-3,-7,464,-3,-2
"2590","14",308,2,4,1,0,-250,-244,-4,-3,129,127,0,2,4,2,-379,-371,-4,-5
"2591","14",78,3,4,1,0,-182,-3,-2,-2,-180,-2,-2,-2,4,1,-2,-1,0,0
"2592","14",461,5,4,1,2,162,33,0,0,109,22,-1,-1,4,-1,53,11,1,1
"2593","14",458,3,1,0,1,-73,-62,-1,-2,76,83,-2,-2,4,1,-149,-145,1,0
"2594","14",454,5,4,1,3,-20,1,0,0,46,1,0,0,4,-1,-66,0,0,0
"2595","14",450,4,4,1,3,-1,103,-1,-1,-2,7,0,-1,4,0,1,96,-1,0
"2596","14",91,7,2,0,3,83,-2,1,2,110,15,2,2,4,-3,-27,-17,-1,0
"2597","14",346,7,3,1,0,-198,-1,-3,2,169,-1,3,3,4,-3,-367,0,-6,-1
"2598","14",342,3,3,1,1,77,-82,1,-2,-34,-212,1,-2,4,1,111,130,0,0
"2599","14",363,8,3,1,3,250,-8,3,3,248,-1,3,3,4,-4,2,-7,0,0
"2600","14",80,8,4,1,3,197,-2,3,3,205,-1,2,2,4,-4,-8,-1,1,1
"2601","14",335,4,2,1,1,-116,27,-2,-1,-80,35,1,-1,4,0,-36,-8,-3,0
"2602","14",283,6,1,0,1,-62,-127,-2,1,-165,-129,-2,1,4,-2,103,2,0,0
"2603","14",206,9,4,1,0,47,34,-1,4,116,42,-1,1,4,-5,-69,-8,0,3
"2604","14",429,1,2,0,0,-231,-181,-4,-4,-143,-75,0,-4,4,3,-88,-106,-4,0
"2605","14",352,5,2,0,1,10,-10,0,0,14,-17,0,0,4,-1,-4,7,0,0
"2606","14",349,2,4,1,1,-47,-58,-2,-3,-63,82,1,0,4,2,16,-140,-3,-3
"2607","14",345,4,1,1,0,7,-243,-3,-1,42,-188,-1,-3,4,0,-35,-55,-2,2
"2608","14",341,9,1,0,3,0,0,4,4,241,-26,3,4,4,-5,-241,26,1,0
"2609","14",366,9,4,1,3,184,-77,3,4,181,46,3,2,4,-5,3,-123,0,2
"2610","14",83,6,1,1,3,135,-140,2,1,127,-152,2,1,4,-2,8,12,0,0
"2611","14",439,5,2,1,1,3,4,0,0,9,-1,0,0,4,-1,-6,5,0,0
"2612","14",258,3,3,1,0,62,6,1,-2,2,1,-3,-3,4,1,60,5,4,1
"2613","14",407,1,2,0,2,-210,140,-4,-4,126,99,2,2,4,3,-336,41,-6,-6
"2614","14",185,6,4,1,2,74,-14,-1,1,212,-15,-1,2,4,-2,-138,1,0,-1
"2615","14",51,9,4,1,1,114,88,4,4,110,128,-2,1,4,-5,4,-40,6,3
"2616","14",108,9,2,0,3,198,39,4,4,211,67,0,4,4,-5,-13,-28,4,0
"2617","14",9,5,4,1,2,80,24,1,0,33,29,1,-1,4,-1,47,-5,0,1
"2618","14",340,4,1,1,1,-20,-10,0,-1,90,42,0,0,4,0,-110,-52,0,-1
"2619","14",420,4,4,1,3,-70,0,-2,-1,-1,4,1,0,4,0,-69,-4,-3,-1
"2620","14",417,5,2,0,2,0,0,0,0,-68,-69,-2,-2,4,-1,68,69,2,2
"2621","14",337,4,2,0,3,-132,33,-1,-1,242,-17,4,4,4,0,-374,50,-5,-5
"2622","14",285,6,2,1,1,-77,38,-2,1,-85,66,-3,-1,4,-2,8,-28,1,2
"2623","14",459,1,3,1,1,-44,33,4,-4,-152,-55,3,-4,4,3,108,88,1,0
"2624","14",455,1,2,0,2,-249,0,-4,-4,237,-2,4,4,4,3,-486,2,-8,-8
"2625","14",451,1,1,0,0,-229,-214,-4,-4,-233,-202,-4,-4,4,3,4,-12,0,0
"2626","14",92,4,4,1,2,-49,-33,-1,-1,-161,-184,-1,-1,4,0,112,151,0,0
"2627","14",347,2,1,1,3,-168,106,-2,-3,236,-185,3,4,4,2,-404,291,-5,-7
"2628","14",343,4,2,0,2,-86,5,-1,-1,-44,6,-1,-1,4,0,-42,-1,0,0
"2629","14",364,5,3,1,1,-12,33,0,0,1,69,-1,0,4,-1,-13,-36,1,0
"2630","14",81,3,1,0,0,-59,36,-2,-2,-98,83,-3,-3,4,1,39,-47,1,1
"2631","14",336,3,4,1,3,175,164,2,-2,180,145,2,-3,4,1,-5,19,0,1
"2632","14",284,1,3,1,1,114,121,-1,-4,-51,50,-3,-4,4,3,165,71,2,0
"2633","14",207,5,1,1,0,-1,-249,2,0,3,-1,1,2,4,-1,-4,-248,1,-2
"2634","14",43,1,3,1,0,-48,4,-3,-4,70,6,-3,-4,4,3,-118,-2,0,0
"2635","14",353,8,2,1,2,249,226,3,3,223,134,-1,-4,4,-4,26,92,4,7
"2636","14",35,3,1,0,3,106,163,3,-2,151,174,3,-2,4,1,-45,-11,0,0
"2637","14",155,3,2,0,1,-138,-146,0,-2,-94,-81,0,0,4,1,-44,-65,0,-2
"2638","14",370,9,1,1,3,40,-33,-4,4,-236,-12,-4,-4,4,-5,276,-21,0,8
"2639","14",367,5,3,1,1,77,76,1,0,-12,-13,1,0,4,-1,89,89,0,0
"2640","14",84,8,4,1,3,212,1,3,3,193,1,3,3,4,-4,19,0,0,0
"2641","14",44,2,2,1,2,187,25,1,-3,103,-9,0,-4,4,2,84,34,1,1
"2642","14",259,1,3,1,1,-58,22,4,-4,-91,33,4,-4,4,3,33,-11,0,0
"2643","14",408,4,1,1,0,-135,-7,-1,-1,-157,12,-1,-2,4,0,22,-19,0,1
"2644","14",186,5,2,1,2,-1,-1,0,0,4,-2,0,0,4,-1,-5,1,0,0
"2645","14",52,3,3,1,0,81,2,-1,-2,-81,0,-2,-3,4,1,162,2,1,1
"2646","14",109,2,1,0,1,-20,0,3,-3,-11,-1,3,-3,4,2,-9,1,0,0
"2647","14",154,4,4,1,3,-103,5,-1,-1,-2,159,0,0,4,0,-101,-154,-1,-1
"2648","14",37,3,1,0,0,-164,-23,-3,-2,-174,-14,-3,-3,4,1,10,-9,0,1
"2649","14",421,7,3,1,1,21,-17,1,2,73,48,0,1,4,-3,-52,-65,1,1
"2650","14",418,5,2,0,2,-229,-10,1,0,10,-7,0,0,4,-1,-239,-3,1,0
"2651","14",338,4,3,1,2,110,135,3,-1,146,180,2,-2,4,0,-36,-45,1,1
"2652","14",286,6,1,0,3,95,-1,1,1,64,-3,1,1,4,-2,31,2,0,0
"2653","14",46,2,1,0,0,-10,-247,-4,-3,-18,-241,-3,-3,4,2,8,-6,-1,0
"2654","14",456,1,1,1,0,-98,-4,-1,-4,1,-69,1,-3,4,3,-99,65,-2,-1
"2655","14",452,4,3,1,1,-68,2,-1,-1,-99,3,-1,-2,4,0,31,-1,0,1
"2656","14",93,5,1,1,1,-19,-13,-1,0,-100,20,-1,1,4,-1,81,-33,0,-1
"2657","14",157,4,3,1,2,49,51,-1,-1,147,110,-1,0,4,0,-98,-59,0,-1
"2658","14",424,3,2,0,2,-95,-10,-2,-2,133,80,1,-1,4,1,-228,-90,-3,-1
"2659","14",369,5,4,1,0,-33,-1,1,0,12,2,0,1,4,-1,-45,-3,1,-1
"2660","14",86,8,4,0,3,118,-8,2,3,164,-10,2,1,4,-4,-46,2,0,2
"2661","14",441,6,4,1,2,21,-13,1,1,3,-5,0,0,4,-2,18,-8,1,1
"2662","14",260,7,3,1,0,37,36,2,2,0,1,0,0,4,-3,37,35,2,2
"2663","14",208,5,4,0,2,-96,213,0,0,161,55,2,2,4,-1,-257,158,-2,-2
"2664","14",430,5,2,0,1,50,-54,0,0,182,-118,1,1,4,-1,-132,64,-1,-1
"2665","14",354,6,1,1,0,90,80,3,1,94,81,1,2,4,-2,-4,-1,2,-1
"2666","14",350,5,4,0,1,-240,8,0,0,3,-243,3,-1,4,-1,-243,251,-3,1
"2667","14",156,4,2,0,1,-38,2,-1,-1,70,9,1,1,4,0,-108,-7,-2,-2
"2668","14",371,7,3,1,0,219,31,-4,2,208,40,-4,2,4,-3,11,-9,0,0
"2669","14",368,9,3,1,3,-135,134,4,4,-131,131,4,4,4,-5,-4,3,0,0
"2670","14",85,1,2,0,2,-112,-107,-4,-4,-140,-101,-3,-4,4,3,28,-6,-1,0
"2671","14",440,3,3,1,0,-169,0,-2,-2,64,1,1,1,4,1,-233,-1,-3,-3
"2672","14",26,2,1,1,0,19,-168,1,-3,-46,-171,-4,-4,4,2,65,3,5,1
"2673","14",409,5,4,1,2,58,61,-1,0,112,110,2,2,4,-1,-54,-49,-3,-2
"2674","14",187,4,4,1,2,-90,-12,0,-1,-124,-37,-2,-2,4,0,34,25,2,1
"2675","14",53,7,4,1,3,201,0,2,2,68,8,2,2,4,-3,133,-8,0,0
"2676","14",11,6,4,1,1,-78,-123,0,1,-105,97,1,-1,4,-2,27,-220,-1,2
"2677","14",159,8,3,1,2,242,9,1,3,244,13,3,4,4,-4,-2,-4,-2,-1
"2678","14",426,4,4,1,3,16,3,0,-1,191,-5,2,2,4,0,-175,8,-2,-3
"2679","14",422,1,3,0,1,-137,-102,3,-4,-99,-236,2,-2,4,3,-38,134,1,-2
"2680","14",419,6,4,1,3,144,133,1,1,139,127,0,1,4,-2,5,6,1,0
"2681","14",339,5,3,1,1,25,35,1,0,-14,-16,-1,-1,4,-1,39,51,2,1
"2682","14",287,9,4,1,3,213,15,4,4,-136,2,-1,-1,4,-5,349,13,5,5
"2683","14",165,3,1,0,1,-110,17,-2,-2,70,63,1,1,4,1,-180,-46,-3,-3
"2684","14",230,7,1,1,0,-101,-13,-2,2,-216,27,-3,2,4,-3,115,-40,1,0
"2685","14",161,1,2,0,2,-244,113,-4,-4,96,62,1,-3,4,3,-340,51,-5,-1
"2686","14",94,6,4,1,1,54,-72,1,1,104,-69,1,1,4,-2,-50,-3,0,0
"2687","14",158,6,3,1,0,131,-31,1,1,-45,-22,-1,-2,4,-2,176,-9,2,3
"2688","14",425,6,4,1,2,52,41,1,1,-1,-2,1,1,4,-2,53,43,0,0
"2689","14",223,5,1,0,1,-3,-1,0,0,114,-38,-1,0,4,-1,-117,37,1,0
"2690","14",22,5,3,1,1,11,-16,0,0,104,12,1,1,4,-1,-93,-28,-1,-1
"2691","14",442,6,4,1,1,27,27,1,1,25,26,1,1,4,-2,2,1,0,0
"2692","14",261,9,1,1,3,-88,-113,4,4,110,101,4,4,4,-5,-198,-214,0,0
"2693","14",209,6,4,1,3,177,-3,3,1,-1,230,1,2,4,-2,178,-233,2,-1
"2694","14",431,3,3,1,0,-215,22,-3,-2,4,9,0,0,4,1,-219,13,-3,-2
"2695","14",355,5,2,1,2,32,123,1,0,-59,15,-3,-2,4,-1,91,108,4,2
"2696","14",132,7,4,1,1,21,-127,1,2,-12,56,0,1,4,-3,33,-183,1,1
"2697","14",160,7,2,1,0,-163,6,-4,2,-204,-1,-4,1,4,-3,41,7,0,1
"2698","14",372,3,3,1,0,-203,-182,-1,-2,-90,-175,-4,-3,4,1,-113,-7,3,1
"2699","14",226,1,1,0,0,131,4,-2,-4,201,-1,3,-4,4,3,-70,5,-5,0
"2700","14",129,3,4,1,1,-172,-2,-2,-2,-188,-3,-2,-2,4,1,16,1,0,0
"2701","14",125,4,4,1,0,-118,-22,-4,-1,244,-243,-4,-2,4,0,-362,221,0,1
"2702","14",289,8,1,0,3,232,-37,3,3,185,-170,3,3,4,-4,47,133,0,0
"2703","14",41,6,2,0,3,32,72,2,1,42,67,2,1,4,-2,-10,5,0,0
"2704","14",188,8,2,0,3,200,-3,3,3,200,-6,3,4,4,-4,0,3,0,-1
"2705","14",54,1,4,1,1,97,26,-2,-4,84,41,-4,-4,4,3,13,-15,2,0
"2706","14",110,6,1,0,1,-119,61,-3,1,76,69,3,-1,4,-2,-195,-8,-6,2
"2707","14",16,2,1,1,0,-144,12,-3,-3,-43,17,-2,-3,4,2,-101,-5,-1,0
"2708","14",427,3,4,1,1,119,28,2,-2,-241,-55,4,-4,4,1,360,83,-2,2
"2709","14",423,5,1,0,3,-41,-33,0,0,-79,-25,-1,3,4,-1,38,-8,1,-3
"2710","14",42,2,3,1,1,8,8,2,-3,-2,2,2,-2,4,2,10,6,0,-1
"2711","14",34,6,4,1,2,135,-75,1,1,113,-71,1,1,4,-2,22,-4,0,0
"2712","14",288,5,2,0,2,-3,-3,0,0,-121,57,-2,-3,4,-1,118,-60,2,3
"2713","14",166,4,4,1,2,222,220,-3,-1,213,218,-2,-2,4,0,9,2,-1,1
"2714","14",231,1,4,1,0,-46,-42,0,-4,-121,-116,-4,1,4,3,75,74,4,-5
"2715","14",162,9,3,1,3,124,153,-2,4,75,64,2,3,4,-5,49,89,-4,1
"2716","14",95,1,4,1,2,-240,1,-4,-4,-104,-1,-1,-1,4,3,-136,2,-3,-3
"2717","14",13,3,4,1,1,116,-80,1,-2,22,-114,0,-2,4,1,94,34,1,0
"2718","14",228,7,4,1,2,-161,176,2,2,-117,60,-2,1,4,-3,-44,116,4,1
"2719","14",224,2,2,0,2,-120,-24,-3,-3,162,75,2,1,4,2,-282,-99,-5,-4
"2720","14",220,1,4,0,2,-245,57,-4,-4,127,98,-2,-2,4,3,-372,-41,-2,-2
"2721","14",443,4,1,0,0,-61,-13,-1,-1,50,58,1,1,4,0,-111,-71,-2,-2
"2722","14",262,6,4,1,3,108,-2,1,1,76,70,1,1,4,-2,32,-72,0,0
"2723","14",21,2,4,1,2,-29,-20,-2,-3,107,110,1,-2,4,2,-136,-130,-3,-1
"2724","14",432,4,2,1,1,-30,-30,-1,-1,49,-38,0,0,4,0,-79,8,-1,-1
"2725","14",356,6,4,1,1,40,4,0,1,221,-1,1,3,4,-2,-181,5,-1,-2
"2726","14",133,4,2,0,1,233,9,1,-1,81,31,2,-2,4,0,152,-22,-1,1
"2727","14",222,2,1,0,0,-233,5,-3,-3,-228,-1,-3,-3,4,2,-5,6,0,0
"2728","14",227,5,3,1,3,177,86,2,0,69,23,1,-1,4,-1,108,63,1,1
"2729","14",297,6,3,1,2,85,27,1,1,16,17,1,1,4,-2,69,10,0,0
"2730","14",211,9,3,1,1,62,56,2,4,118,111,2,4,4,-5,-56,-55,0,0
"2731","14",126,3,2,0,2,-190,-152,-2,-2,-11,11,-2,-2,4,1,-179,-163,0,0
"2732","14",29,1,4,1,0,-85,45,-4,-4,237,229,-1,-1,4,3,-322,-184,-3,-3
"2733","14",410,8,1,1,0,-104,-51,-1,3,-180,-75,1,-4,4,-4,76,24,-2,7
"2734","14",189,2,1,1,1,-226,37,3,-3,-217,46,2,-3,4,2,-9,-9,1,0
"2735","14",55,5,4,1,1,0,8,0,0,17,-5,0,0,4,-1,-17,13,0,0
"2736","14",111,5,1,1,0,-4,3,0,0,-169,-85,-1,1,4,-1,165,88,1,-1
"2737","14",221,4,4,1,1,-27,4,-1,-1,23,5,1,1,4,0,-50,-1,-2,-2
"2738","14",23,3,1,1,3,191,156,4,-2,229,208,4,4,4,1,-38,-52,0,-6
"2739","14",3,3,3,1,0,129,3,2,-2,-2,1,-2,-3,4,1,131,2,4,1
"2740","14",210,1,4,0,2,-68,-44,2,-4,117,20,3,-1,4,3,-185,-64,-1,-3
"2741","14",445,6,4,1,3,78,-18,1,1,105,-76,0,2,4,-2,-27,58,1,-1
"2742","14",121,1,1,0,0,-66,15,-4,-4,239,-106,-1,-4,4,3,-305,121,-3,0
"2743","14",134,2,2,0,2,-97,-18,0,-3,-96,-20,0,-4,4,2,-1,2,0,1
"2744","14",434,8,4,0,3,212,-12,3,3,212,-12,2,2,4,-4,0,0,1,1
"2745","14",163,6,3,1,1,9,121,-1,1,124,-19,1,3,4,-2,-115,140,-2,-2
"2746","14",96,4,1,0,0,-27,3,-1,-1,-8,1,-3,-2,4,0,-19,2,2,1
"2747","14",130,9,1,0,3,162,41,4,4,163,24,4,4,4,-5,-1,17,0,0
"2748","14",229,2,1,0,1,-234,74,-3,-3,-230,-92,-3,-3,4,2,-4,166,0,0
"2749","14",225,7,2,0,2,144,27,2,2,42,137,2,2,4,-3,102,-110,0,0
"2750","14",411,1,2,0,2,-238,-237,-4,-4,228,231,1,1,4,3,-466,-468,-5,-5
"2751","14",444,3,2,1,2,-92,40,-2,-2,-177,43,-3,-4,4,1,85,-3,1,2
"2752","14",263,2,4,1,0,-242,-4,-2,-3,-233,5,-4,-4,4,2,-9,-9,2,1
"2753","14",112,9,4,1,3,6,247,4,4,4,248,4,4,4,-5,2,-1,0,0
"2754","14",433,1,1,0,0,-186,-236,-4,-4,198,187,4,-3,4,3,-384,-423,-8,-1
"2755","14",357,5,4,1,2,-33,13,0,0,107,64,-1,-1,4,-1,-140,-51,1,1
"2756","14",292,6,3,0,1,-88,-1,0,1,0,-47,0,0,4,-2,-88,46,0,1
"2757","14",413,6,1,1,1,181,11,2,1,219,-18,3,3,4,-2,-38,29,-1,-2
"2758","14",300,3,1,1,0,-89,29,-1,-2,95,112,1,2,4,1,-184,-83,-2,-4
"2759","14",298,2,1,0,0,-246,12,-1,-3,-123,12,-1,-2,4,2,-123,0,0,-1
"2760","14",212,1,1,1,1,-237,31,0,-4,-237,35,0,-3,4,3,0,-4,0,-1
"2761","14",127,2,1,0,0,-189,-75,-3,-3,-107,-1,-2,-3,4,2,-82,-74,-1,0
"2762","14",290,4,1,1,1,36,-52,0,-1,136,-153,0,-2,4,0,-100,101,0,1
"2763","14",97,2,1,0,1,-239,29,3,-3,65,25,3,-2,4,2,-304,4,0,-1
"2764","14",19,4,2,0,2,-115,-32,0,-1,-97,-23,0,-1,4,0,-18,-9,0,0
"2765","14",56,3,3,1,1,36,-133,-2,-2,38,-127,-2,-2,4,1,-2,-6,0,0
"2766","14",291,3,4,1,2,120,87,0,-2,132,44,-1,-1,4,1,-12,43,1,-1
"2767","14",412,9,1,1,0,-121,0,-4,4,-237,2,4,4,4,-5,116,-2,-8,0
"2768","14",30,3,2,1,2,131,-10,-1,-2,165,-51,2,1,4,1,-34,41,-3,-3
"2769","14",57,1,4,1,1,-2,-233,1,-4,2,-213,1,-4,4,3,-4,-20,0,0
"2770","14",113,6,2,0,2,121,207,1,1,179,43,1,1,4,-2,-58,164,0,0
"2771","14",446,5,4,1,1,16,11,0,0,225,15,-1,0,4,-1,-209,-4,1,0
"2772","14",122,1,1,0,0,-128,-140,-4,-4,-52,-44,1,0,4,3,-76,-96,-5,-4
"2773","14",135,2,1,0,1,-206,154,-3,-3,-160,96,-3,-3,4,2,-46,58,0,0
"2774","14",435,4,4,1,1,41,33,-1,-1,3,0,0,0,4,0,38,33,-1,-1
"2775","14",164,5,2,1,2,1,-1,0,0,73,59,2,1,4,-1,-72,-60,-2,-1
"2776","14",299,8,4,1,1,182,48,2,3,85,179,1,1,4,-4,97,-131,1,2
"2777","14",131,8,4,1,3,98,-41,-1,3,45,-4,1,3,4,-4,53,-37,-2,0
"2778","14",302,3,1,1,0,40,-17,-2,-2,231,238,-4,-2,4,1,-191,-255,2,0
"2779","14",36,4,3,1,3,151,105,3,-1,-89,182,3,-2,4,0,240,-77,0,1
"2780","14",303,1,3,1,2,-220,-175,-4,-4,-180,-30,-2,-2,4,3,-40,-145,-2,-2
"2781","14",449,6,4,1,3,0,85,1,1,1,106,2,0,4,-2,-1,-21,-1,1
"2782","14",437,6,1,1,0,77,1,1,1,29,4,1,1,4,-2,48,-3,0,0
"2783","14",296,6,1,0,3,185,-2,1,1,203,1,0,0,4,-2,-18,-3,1,1
"2784","14",191,2,1,0,0,-206,-30,-2,-3,-183,-54,-2,-3,4,2,-23,24,0,0
"2785","14",358,1,4,1,2,214,167,0,-4,-189,65,-4,-4,4,3,403,102,4,0
"2786","14",293,1,4,1,0,-237,4,-4,-4,-171,12,-4,-4,4,3,-66,-8,0,0
"2787","14",414,6,1,1,0,24,17,1,1,106,100,2,2,4,-2,-82,-83,-1,-1
"2788","14",301,6,4,1,1,72,0,2,1,-84,2,-1,-2,4,-2,156,-2,3,3
"2789","14",123,3,4,1,2,29,16,-2,-2,-202,31,-3,-3,4,1,231,-15,1,1
"2790","14",213,4,2,1,1,-104,1,-1,-1,99,1,1,-1,4,0,-203,0,-2,0
"2791","14",128,5,1,0,3,51,-100,0,0,131,-189,0,2,4,-1,-80,89,0,-2
"2792","14",448,1,2,1,2,-204,1,-3,-4,1,-1,0,-4,4,3,-205,2,-3,0
"2793","14",124,9,1,1,3,64,-68,3,4,148,-247,1,3,4,-5,-84,179,2,1
"2794","14",190,7,4,1,3,211,217,2,2,38,212,2,2,4,-3,173,5,0,0
"2795","14",416,1,4,1,0,-238,229,-4,-4,-202,223,-4,-4,4,3,-36,6,0,0
"2796","14",360,1,3,1,0,-46,-29,-1,-4,23,35,0,-4,4,3,-69,-64,-1,0
"2797","14",215,2,1,0,0,-165,33,-2,-3,90,26,-2,-3,4,2,-255,7,0,0
"2798","14",438,5,4,1,3,1,-1,0,0,0,-1,4,0,4,-1,1,0,-4,0
"2799","14",58,7,4,1,1,-236,-1,-2,2,-9,239,4,4,4,-3,-227,-240,-6,-2
"2800","14",114,2,4,1,1,109,100,1,-3,201,192,1,-3,4,2,-92,-92,0,0
"2801","14",447,3,4,1,2,-98,5,-2,-2,105,44,2,1,4,1,-203,-39,-4,-3
"2802","14",359,9,4,1,3,236,12,4,4,233,14,4,4,4,-5,3,-2,0,0
"2803","14",136,3,1,1,0,188,54,-3,-2,202,-185,-3,-1,4,1,-14,239,0,-1
"2804","14",436,7,4,1,3,9,27,3,2,128,116,1,0,4,-3,-119,-89,2,2
"2805","14",193,1,1,0,0,-221,-63,-4,-4,191,-38,1,1,4,3,-412,-25,-5,-5
"2806","14",6,4,4,1,2,-136,0,-1,-1,-90,0,-2,-2,4,0,-46,0,1,1
"2807","14",214,9,1,1,3,216,-69,4,4,195,-4,4,4,4,-5,21,-65,0,0
"2808","14",116,8,2,0,3,172,-14,3,3,104,-21,1,-1,4,-4,68,7,2,4
"2809","14",194,8,1,1,0,-23,33,-3,3,-207,11,-4,3,4,-4,184,22,1,0
"2810","14",304,4,2,0,2,-205,9,-2,-1,105,-23,2,2,4,0,-310,32,-4,-3
"2811","14",219,2,4,1,3,248,4,4,-3,249,0,4,-2,4,2,-1,4,0,-1
"2812","14",195,1,1,0,1,-213,210,4,-4,161,-131,3,-2,4,3,-374,341,1,-2
"2813","14",361,4,1,1,0,0,-246,1,-1,247,2,4,4,4,0,-247,-248,-3,-5
"2814","14",192,6,4,1,1,-2,-67,1,1,-1,-122,1,1,4,-2,-1,55,0,0
"2815","14",143,6,1,0,3,-9,12,4,1,61,-102,2,2,4,-2,-70,114,2,-1
"2816","14",294,7,1,0,3,67,0,2,2,0,3,0,2,4,-3,67,-3,2,0
"2817","14",415,5,2,0,2,-1,-3,0,0,111,171,0,1,4,-1,-112,-174,0,-1
"2818","14",217,2,4,0,2,-54,20,-1,-3,16,20,1,-3,4,2,-70,0,-2,0
"2819","14",144,5,3,1,0,80,0,1,0,236,1,2,0,4,-1,-156,-1,-1,0
"2820","14",137,7,1,1,1,37,-40,-3,2,141,-56,-3,1,4,-3,-104,16,0,1
"2821","14",148,4,1,1,1,-1,-114,2,-1,-210,111,2,-3,4,0,209,-225,0,2
"2822","14",218,8,4,1,3,-125,13,4,3,-192,-10,4,3,4,-4,67,23,0,0
"2823","14",60,7,1,1,3,191,-8,2,2,192,-22,2,2,4,-3,-1,14,0,0
"2824","14",138,5,3,1,1,43,-14,0,0,-89,-51,-1,-1,4,-1,132,37,1,1
"2825","14",153,6,1,0,3,-3,4,1,1,-27,23,1,2,4,-2,24,-19,0,-1
"2826","14",146,2,2,0,0,-181,-203,-3,-3,-186,-186,-3,-3,4,2,5,-17,0,0
"2827","14",216,5,3,0,1,51,2,-1,0,-5,4,0,0,4,-1,56,-2,-1,0
"2828","14",150,5,3,1,1,-4,-1,0,0,53,1,0,0,4,-1,-57,-2,0,0
"2829","14",59,5,1,1,0,1,1,0,0,42,2,2,2,4,-1,-41,-1,-2,-2
"2830","14",115,5,3,1,3,0,3,0,0,-4,-3,2,0,4,-1,4,6,-2,0
"2831","14",306,5,3,1,3,104,101,1,0,142,159,1,0,4,-1,-38,-58,0,0
"2832","14",151,1,2,0,1,-232,7,0,-4,-235,10,0,-4,4,3,3,-3,0,0
"2833","14",295,5,1,0,1,-2,6,0,0,2,1,0,0,4,-1,-4,5,0,0
"2834","14",117,2,4,1,2,-229,-4,-3,-3,-213,2,-2,-2,4,2,-16,-6,-1,-1
"2835","14",140,5,1,0,1,66,-8,0,0,15,21,1,0,4,-1,51,-29,-1,0
"2836","14",145,4,1,0,1,-116,-5,-1,-1,-192,-113,0,1,4,0,76,108,-1,-2
"2837","14",64,3,1,1,1,-59,40,-2,-2,158,-34,-3,-3,4,1,-217,74,1,1
"2838","14",196,3,3,0,0,-102,-91,-2,-2,1,185,4,4,4,1,-103,-276,-6,-6
"2839","14",141,1,1,0,0,-171,18,-3,-4,-33,-18,-1,-3,4,3,-138,36,-2,-1
"2840","14",305,8,4,1,3,143,85,2,3,35,160,2,2,4,-4,108,-75,0,1
"2841","14",139,1,4,1,2,-227,-43,-4,-4,18,226,4,4,4,3,-245,-269,-8,-8
"2842","14",63,7,4,1,1,208,1,0,2,1,-2,1,0,4,-3,207,3,-1,2
"2843","14",62,9,2,1,3,-217,-10,-4,4,220,247,4,4,4,-5,-437,-257,-8,0
"2844","14",147,4,2,0,3,-75,51,-1,-1,111,121,2,2,4,0,-186,-70,-3,-3
"2845","14",14,4,3,1,1,-19,-2,0,-1,109,-11,0,0,4,0,-128,9,0,-1
"2846","14",198,5,1,1,1,110,38,-3,0,-103,27,-1,-2,4,-1,213,11,-2,2
"2847","14",149,6,3,1,1,196,-9,-3,1,247,6,-3,1,4,-2,-51,-15,0,0
"2848","14",119,5,3,1,3,81,137,1,0,58,-102,1,1,4,-1,23,239,0,-1
"2849","14",152,5,1,1,0,26,-1,0,0,-22,-4,0,-1,4,-1,48,3,0,1
"2850","14",12,9,4,1,3,0,2,4,4,-1,2,4,4,4,-5,1,0,0,0
"2851","14",118,6,3,1,1,-1,-41,-1,1,-38,-34,-2,1,4,-2,37,-7,1,0
"2852","14",61,1,1,0,3,246,34,4,-4,24,-2,0,-3,4,3,222,36,4,-1
"2853","14",15,7,4,1,3,188,32,2,2,45,25,1,2,4,-3,143,7,1,0
"2854","14",197,3,4,1,3,-245,-1,4,-2,-237,11,4,-4,4,1,-8,-12,0,2
"2855","14",142,5,2,1,2,89,-25,-4,0,2,-45,-3,-1,4,-1,87,20,-1,1
"2856","14",120,7,3,0,1,145,65,2,2,41,-23,0,0,4,-3,104,88,2,2
"2857","15",320,1,2,0,2,-249,147,-4,-4,-245,140,-3,-3,2,1,-4,7,-1,-1
"2858","15",321,1,1,0,0,-236,-215,-4,-4,-42,-34,-1,-1,2,1,-194,-181,-3,-3
"2859","15",318,1,2,1,2,-186,-179,-4,-4,185,72,-4,0,2,1,-371,-251,0,-4
"2860","15",322,4,4,1,3,-43,22,-1,-1,225,-226,3,3,2,-2,-268,248,-4,-4
"2861","15",312,5,4,1,1,-77,97,0,0,48,129,4,0,2,-3,-125,-32,-4,0
"2862","15",32,5,1,0,1,-7,0,0,0,185,-173,3,-4,2,-3,-192,173,-3,4
"2863","15",313,3,3,1,0,-110,-129,-2,-2,95,77,1,1,2,-1,-205,-206,-3,-3
"2864","15",244,3,4,1,2,-88,-67,-2,-2,236,234,3,2,2,-1,-324,-301,-5,-4
"2865","15",31,3,1,0,0,-152,-87,-2,-2,-113,-106,-1,-1,2,-1,-39,19,-1,-1
"2866","15",352,3,2,0,1,18,-66,0,-2,15,-21,0,0,2,-1,3,-45,0,-2
"2867","15",241,1,4,1,2,-87,-47,-2,-4,201,174,2,-1,2,1,-288,-221,-4,-3
"2868","15",319,4,1,0,1,-169,111,-1,-1,222,224,3,4,2,-2,-391,-113,-4,-5
"2869","15",310,4,4,1,2,-14,0,-1,-1,51,-3,1,1,2,-2,-65,3,-2,-2
"2870","15",243,2,2,0,2,-202,242,-4,-3,243,65,1,-1,2,0,-445,177,-5,-2
"2871","15",242,3,4,1,2,35,-1,1,-2,32,0,1,-3,2,-1,3,-1,0,1
"2872","15",351,1,1,0,0,-246,-245,-4,-4,136,117,-4,-4,2,1,-382,-362,0,0
"2873","15",232,1,1,0,0,-247,-245,-4,-4,-161,-57,-1,-4,2,1,-86,-188,-3,0
"2874","15",317,4,4,1,2,-48,48,-1,-1,30,-24,0,0,2,-2,-78,72,-1,-1
"2875","15",309,5,4,1,2,45,28,-1,0,181,158,-2,-3,2,-3,-136,-130,1,3
"2876","15",233,3,2,0,2,-232,56,-3,-2,-167,25,-2,0,2,-1,-65,31,-1,-2
"2877","15",314,1,4,1,1,-246,10,4,-4,-241,12,4,-4,2,1,-5,-2,0,0
"2878","15",471,6,3,0,2,-99,70,1,1,-80,154,0,0,2,-4,-19,-84,1,1
"2879","15",353,9,2,0,2,-246,10,-4,4,232,183,2,-2,2,-7,-478,-173,-6,6
"2880","15",234,4,3,1,3,83,58,0,-1,37,115,0,1,2,-2,46,-57,0,-2
"2881","15",315,8,3,1,3,231,-2,3,3,231,11,3,3,2,-6,0,-13,0,0
"2882","15",323,1,4,1,1,2,-92,-4,-4,198,-2,-2,-4,2,1,-196,-90,-2,0
"2883","15",355,2,2,0,2,-161,98,-4,-3,-112,72,-3,-2,2,0,-49,26,-1,-1
"2884","15",316,2,3,0,0,-72,-89,-3,-3,-112,-102,-3,-3,2,0,40,13,0,0
"2885","15",324,1,2,0,0,8,-2,-4,-4,-233,1,-4,-4,2,1,241,-3,0,0
"2886","15",356,3,4,1,1,-113,-8,-2,-2,243,-1,4,4,2,-1,-356,-7,-6,-6
"2887","15",248,3,4,0,3,-13,-112,-2,-2,17,118,1,1,2,-1,-30,-230,-3,-3
"2888","15",240,6,2,0,1,90,-79,2,1,153,-20,-1,-1,2,-4,-63,-59,3,2
"2889","15",325,9,1,0,1,-124,-123,-4,4,-16,-18,-3,3,2,-7,-108,-105,-1,1
"2890","15",245,1,1,0,0,-176,-4,-3,-4,-65,-4,-3,-3,2,1,-111,0,0,-1
"2891","15",463,8,4,1,3,112,-13,1,3,244,-16,4,0,2,-6,-132,3,-3,3
"2892","15",354,4,1,0,0,-80,-124,0,-1,200,231,2,4,2,-2,-280,-355,-2,-5
"2893","15",326,7,4,1,2,163,66,2,2,157,97,2,2,2,-5,6,-31,0,0
"2894","15",246,7,4,1,3,176,-3,3,2,177,-2,4,2,2,-5,-1,-1,-1,0
"2895","15",311,1,2,0,2,-140,12,-4,-4,192,9,4,-4,2,1,-332,3,-8,0
"2896","15",396,1,1,0,1,-239,241,4,-4,-137,132,4,-4,2,1,-102,109,0,0
"2897","15",247,5,3,1,0,4,-3,0,0,196,-4,1,1,2,-3,-192,1,-1,-1
"2898","15",24,1,2,1,2,-246,248,-4,-4,244,0,4,4,2,1,-490,248,-8,-8
"2899","15",397,6,4,0,3,64,-89,1,1,-101,-132,1,1,2,-4,165,43,0,0
"2900","15",236,5,1,0,1,-72,-25,0,0,29,-23,1,0,2,-3,-101,-2,-1,0
"2901","15",474,1,1,0,0,0,-52,0,-4,0,-87,0,-4,2,1,0,35,0,0
"2902","15",398,5,4,0,2,2,1,0,0,-1,-1,0,0,2,-3,3,2,0,0
"2903","15",237,4,2,0,2,-249,33,-1,-1,42,0,1,1,2,-2,-291,33,-2,-2
"2904","15",249,1,3,1,0,-216,-222,-3,-4,-186,-124,-2,-4,2,1,-30,-98,-1,0
"2905","15",395,7,3,1,1,-182,15,-1,2,229,13,-1,3,2,-5,-411,2,0,-1
"2906","15",399,6,4,1,3,112,16,1,1,102,2,1,1,2,-4,10,14,0,0
"2907","15",238,2,3,1,1,-122,67,1,-3,71,-64,-2,2,2,0,-193,131,3,-5
"2908","15",472,1,1,0,0,-209,9,-4,-4,-14,13,-4,-4,2,1,-195,-4,0,0
"2909","15",476,6,3,1,0,-50,-59,0,1,111,108,0,2,2,-4,-161,-167,0,-1
"2910","15",235,2,3,0,0,-211,4,-2,-3,246,6,4,4,2,0,-457,-2,-6,-7
"2911","15",473,3,3,1,0,-78,-63,-1,-2,11,7,0,0,2,-1,-89,-70,-1,-2
"2912","15",199,3,4,0,2,100,43,-2,-2,157,34,0,1,2,-1,-57,9,-2,-3
"2913","15",328,4,3,1,1,-59,14,-1,-1,47,15,1,1,2,-2,-106,-1,-2,-2
"2914","15",462,9,3,1,3,228,113,4,4,224,143,4,4,2,-7,4,-30,0,0
"2915","15",2,6,4,1,1,42,-115,4,1,-96,-94,1,0,2,-4,138,-21,3,1
"2916","15",357,6,4,1,2,142,17,1,1,170,85,1,1,2,-4,-28,-68,0,0
"2917","15",470,4,1,0,1,-133,-76,-1,-1,-47,31,1,1,2,-2,-86,-107,-2,-2
"2918","15",475,8,3,1,3,121,-87,1,3,85,-111,-1,1,2,-6,36,24,2,2
"2919","15",20,2,3,1,0,-118,-120,-2,-3,222,217,4,4,2,0,-340,-337,-6,-7
"2920","15",358,1,4,1,2,-157,82,-4,-4,197,201,0,-4,2,1,-354,-119,-4,0
"2921","15",464,4,1,0,1,-191,33,0,-1,10,7,1,0,2,-2,-201,26,-1,-1
"2922","15",468,7,1,0,3,178,43,3,2,-57,-86,1,1,2,-5,235,129,2,1
"2923","15",327,3,4,1,3,-171,148,0,-2,79,-111,2,-1,2,-1,-250,259,-2,-1
"2924","15",201,9,3,0,1,183,0,4,4,69,-2,1,-3,2,-7,114,2,3,7
"2925","15",465,7,4,0,3,17,-241,2,2,-15,204,4,2,2,-5,32,-445,-2,0
"2926","15",40,7,1,0,2,-171,70,-3,2,186,134,2,1,2,-5,-357,-64,-5,1
"2927","15",202,4,1,0,1,-158,32,-3,-1,-87,33,2,-1,2,-2,-71,-1,-5,0
"2928","15",466,3,3,1,0,-135,-53,-2,-2,-89,-91,-1,-1,2,-1,-46,38,-1,-1
"2929","15",400,4,4,0,2,-144,128,-4,-1,22,-19,1,0,2,-2,-166,147,-5,-1
"2930","15",329,6,4,1,3,196,190,1,1,-1,-1,0,0,2,-4,197,191,1,1
"2931","15",467,5,1,0,3,-83,-92,4,0,20,79,4,0,2,-3,-103,-171,0,0
"2932","15",179,3,1,0,1,18,-2,4,-2,235,3,0,4,2,-1,-217,-5,4,-6
"2933","15",401,1,2,0,1,-153,25,1,-4,192,56,1,1,2,1,-345,-31,0,-5
"2934","15",25,3,4,1,2,-70,-88,-2,-2,58,93,0,-1,2,-1,-128,-181,-2,-1
"2935","15",168,7,1,0,3,105,-114,1,2,168,-121,1,1,2,-5,-63,7,0,1
"2936","15",4,5,3,0,1,-3,-1,0,0,219,127,1,3,2,-3,-222,-128,-1,-3
"2937","15",239,6,1,0,1,91,-67,1,1,60,60,-3,1,2,-4,31,-127,4,0
"2938","15",388,4,4,1,0,-249,9,-4,-1,-246,6,-2,-1,2,-2,-3,3,-2,0
"2939","15",48,1,3,0,0,-3,1,-4,-4,64,-63,-4,-4,2,1,-67,64,0,0
"2940","15",47,7,4,0,3,154,-122,1,2,74,2,1,1,2,-5,80,-124,0,1
"2941","15",251,2,3,0,1,-165,-11,-3,-3,180,35,3,-3,2,0,-345,-46,-6,0
"2942","15",49,3,4,1,1,-144,-83,-2,-2,-71,-135,-3,-3,2,-1,-73,52,1,1
"2943","15",297,6,3,1,2,72,34,1,1,26,19,1,1,2,-4,46,15,0,0
"2944","15",203,9,4,1,3,215,10,4,4,211,15,4,4,2,-7,4,-5,0,0
"2945","15",167,7,1,0,3,90,-116,2,2,-130,74,-2,-2,2,-5,220,-190,4,4
"2946","15",394,1,3,0,0,-247,246,-4,-4,-233,240,-4,-4,2,1,-14,6,0,0
"2947","15",1,4,1,0,1,-96,-75,-1,-1,23,26,1,2,2,-2,-119,-101,-2,-3
"2948","15",204,5,3,0,1,84,-109,0,0,153,-65,1,1,2,-3,-69,-44,-1,-1
"2949","15",200,1,3,1,0,-209,-50,-4,-4,-189,-54,-3,-4,2,1,-20,4,-1,0
"2950","15",359,9,4,1,3,237,14,4,4,233,16,4,4,2,-7,4,-2,0,0
"2951","15",250,6,1,0,3,88,20,1,1,91,22,1,1,2,-4,-3,-2,0,0
"2952","15",469,1,4,1,0,40,42,-4,-4,78,54,-4,-4,2,1,-38,-12,0,0
"2953","15",230,6,1,0,0,-207,25,-3,1,-150,-22,-2,2,2,-4,-57,47,-1,-1
"2954","15",100,9,4,0,3,201,2,3,4,198,0,3,2,2,-7,3,2,0,2
"2955","15",178,5,1,0,1,-2,1,0,0,3,0,0,0,2,-3,-5,1,0,0
"2956","15",393,1,1,0,0,0,-2,-4,-4,-226,-16,-4,-4,2,1,226,14,0,0
"2957","15",101,1,3,0,0,-245,245,-4,-4,228,234,-3,-3,2,1,-473,11,-1,-1
"2958","15",252,4,4,1,1,-184,-87,-1,-1,117,-110,1,0,2,-2,-301,23,-2,-1
"2959","15",5,1,2,0,2,-246,232,-2,-4,-240,8,-2,-4,2,1,-6,224,0,0
"2960","15",33,8,3,0,1,49,-84,-3,3,-45,58,0,0,2,-6,94,-142,-3,3
"2961","15",102,8,4,1,3,170,-34,2,3,113,144,1,1,2,-6,57,-178,1,2
"2962","15",18,2,3,1,1,-41,-80,0,-3,-1,1,-1,-3,2,0,-40,-81,1,0
"2963","15",402,1,3,1,0,-243,-28,-4,-4,113,4,2,-2,2,1,-356,-32,-6,-2
"2964","15",10,4,3,1,1,-7,-7,0,-1,8,1,0,-1,2,-2,-15,-8,0,0
"2965","15",169,1,3,0,0,-206,206,-4,-4,-145,99,-4,-4,2,1,-61,107,0,0
"2966","15",428,5,1,1,0,0,0,0,0,201,213,2,-2,2,-3,-201,-213,-2,2
"2967","15",36,9,3,1,3,-97,173,4,4,-107,-125,3,3,2,-7,10,298,1,1
"2968","15",389,5,3,0,2,7,0,1,0,1,1,0,0,2,-3,6,-1,1,0
"2969","15",133,2,2,0,1,-191,-229,1,-3,210,-20,2,0,2,0,-401,-209,-1,-3
"2970","15",231,6,4,1,0,-153,-140,-4,1,28,21,-4,3,2,-4,-181,-161,0,-2
"2971","15",349,8,4,0,1,-97,30,1,3,74,-82,1,1,2,-6,-171,112,0,2
"2972","15",345,6,1,0,0,-201,224,-4,1,12,-240,-2,-2,2,-4,-213,464,-2,3
"2973","15",298,2,1,0,0,-239,14,-1,-3,9,-229,-1,0,2,0,-248,243,0,-3
"2974","15",390,4,2,1,2,15,-7,-1,-1,208,19,4,4,2,-2,-193,-26,-5,-5
"2975","15",143,4,1,0,3,232,-12,-4,-1,133,-84,3,3,2,-2,99,72,-7,-4
"2976","15",172,1,2,1,3,-220,169,-4,-4,-111,90,1,1,2,1,-109,79,-5,-5
"2977","15",330,5,2,0,2,-235,1,1,0,212,176,1,1,2,-3,-447,-175,0,-1
"2978","15",205,7,1,0,2,-77,9,3,2,214,9,4,4,2,-5,-291,0,-1,-2
"2979","15",132,5,4,1,1,48,-124,1,0,28,137,1,2,2,-3,20,-261,0,-2
"2980","15",403,2,1,0,0,-180,-50,0,-3,163,-100,1,2,2,0,-343,50,-1,-5
"2981","15",206,2,4,1,0,-63,18,-3,-3,93,67,0,2,2,0,-156,-49,-3,-5
"2982","15",344,6,4,1,3,-10,0,2,1,-52,-69,-1,0,2,-4,42,69,3,1
"2983","15",429,1,2,0,0,-242,-3,-4,-4,-198,-144,-4,-4,2,1,-44,141,0,0
"2984","15",39,5,3,0,1,-191,-2,-2,0,150,-187,3,0,2,-3,-341,185,-5,0
"2985","15",146,2,2,0,0,-183,-176,-3,-3,-187,-183,-3,-3,2,0,4,7,0,0
"2986","15",175,3,4,1,1,-119,136,0,-2,184,130,1,3,2,-1,-303,6,-1,-5
"2987","15",386,1,1,0,0,-248,176,-4,-4,12,14,1,1,2,1,-260,162,-5,-5
"2988","15",253,6,3,0,3,64,67,0,1,59,77,1,1,2,-4,5,-10,-1,0
"2989","15",50,3,2,0,1,2,-2,0,-2,143,1,2,-2,2,-1,-141,-3,-2,0
"2990","15",299,5,4,1,1,-214,35,-1,0,115,146,2,2,2,-3,-329,-111,-3,-2
"2991","15",103,4,2,0,3,87,-4,1,-1,77,62,1,1,2,-2,10,-66,0,-2
"2992","15",180,1,2,1,2,-44,3,-2,-4,-250,-1,-3,-3,2,1,206,4,1,-1
"2993","15",173,4,4,1,3,193,15,1,-1,186,11,0,0,2,-2,7,4,1,-1
"2994","15",348,5,3,1,1,55,56,-2,0,76,82,0,0,2,-3,-21,-26,-2,0
"2995","15",17,1,3,0,0,-28,56,-2,-4,144,104,-2,-4,2,1,-172,-48,0,0
"2996","15",174,5,4,1,3,174,77,1,0,125,51,0,1,2,-3,49,26,1,-1
"2997","15",360,1,3,1,0,-72,-88,-2,-4,146,192,2,-4,2,1,-218,-280,-4,0
"2998","15",207,4,1,1,0,-249,-1,-2,-1,230,0,4,4,2,-2,-479,-1,-6,-5
"2999","15",134,5,2,0,2,-50,-8,0,0,-50,-8,0,-3,2,-3,0,0,0,3
"3000","15",43,1,3,0,0,-240,5,-4,-4,75,7,-1,-3,2,1,-315,-2,-3,-1
"3001","15",35,4,1,0,3,38,169,0,-1,129,166,2,-1,2,-2,-91,3,-2,0
"3002","15",346,7,3,1,0,-249,-121,-4,2,180,5,2,3,2,-5,-429,-126,-6,-1
"3003","15",176,8,1,0,1,-221,22,-4,3,166,60,-3,-3,2,-6,-387,-38,-1,6
"3004","15",391,7,2,0,3,165,162,2,2,151,94,0,0,2,-5,14,68,2,2
"3005","15",144,3,3,1,0,-208,8,-2,-2,248,0,-1,1,2,-1,-456,8,-1,-3
"3006","15",307,1,4,1,2,-196,136,-3,-4,152,-75,2,2,2,1,-348,211,-5,-6
"3007","15",331,2,1,0,0,-17,-175,-4,-3,-29,-196,-4,-3,2,0,12,21,0,0
"3008","15",255,5,3,0,1,-79,-75,0,0,-60,-162,1,0,2,-3,-19,87,-1,0
"3009","15",52,2,3,0,0,-195,3,1,-3,115,4,1,-2,2,0,-310,-1,0,-1
"3010","15",404,4,1,0,1,53,-53,1,-1,53,-51,1,-1,2,-2,0,-2,0,0
"3011","15",105,6,1,0,0,-180,-12,-2,1,132,9,2,2,2,-4,-312,-21,-4,-1
"3012","15",182,6,4,1,3,-8,-165,3,1,-5,-196,4,4,2,-4,-3,31,-1,-3
"3013","15",341,9,1,0,3,241,-44,4,4,248,-29,3,4,2,-7,-7,-15,1,0
"3014","15",171,5,1,1,1,35,22,0,0,33,17,0,1,2,-3,2,5,0,-1
"3015","15",147,6,2,0,3,148,-152,-1,1,105,134,2,2,2,-4,43,-286,-3,-1
"3016","15",366,9,4,1,3,166,-45,3,4,103,-57,2,3,2,-7,63,12,1,1
"3017","15",387,2,3,0,1,-134,-143,-4,-3,187,191,3,2,2,0,-321,-334,-7,-5
"3018","15",254,8,2,0,3,151,-27,3,3,175,-78,-4,-1,2,-6,-24,51,7,4
"3019","15",51,4,4,1,1,-23,-33,1,-1,-68,-60,0,-2,2,-2,45,27,1,1
"3020","15",3,2,3,0,0,-130,1,-3,-3,-3,2,2,-2,2,0,-127,-1,-5,-1
"3021","15",104,1,1,0,0,-240,3,-1,-4,232,1,1,-3,2,1,-472,2,-2,-1
"3022","15",181,7,4,1,3,-77,27,1,2,31,-54,1,1,2,-5,-108,81,0,1
"3023","15",340,4,1,0,1,-71,-24,0,-1,34,22,0,0,2,-2,-105,-46,0,-1
"3024","15",170,1,2,0,0,-242,-242,-4,-4,12,10,0,0,2,1,-254,-252,-4,-4
"3025","15",121,1,1,0,0,-207,-27,-4,-4,245,-103,-1,-4,2,1,-452,76,-3,0
"3026","15",337,7,2,0,3,-10,-11,2,2,236,-6,4,4,2,-5,-246,-5,-2,-2
"3027","15",361,7,1,1,0,-2,-249,2,2,-246,1,-1,-1,2,-5,244,-250,3,3
"3028","15",208,4,4,1,2,-158,-199,-1,-1,204,177,-4,4,2,-2,-362,-376,3,-5
"3029","15",135,5,1,0,1,-241,172,-3,0,-115,30,-2,-2,2,-3,-126,142,-1,2
"3030","15",430,5,2,0,1,62,-48,0,0,143,-107,2,-1,2,-3,-81,59,-2,1
"3031","15",350,5,4,0,1,-244,7,0,0,243,1,4,0,2,-3,-487,6,-4,0
"3032","15",347,6,1,0,3,106,116,-3,1,-146,92,1,2,2,-4,252,24,-4,-1
"3033","15",177,5,4,1,1,178,56,4,0,71,148,4,2,2,-3,107,-92,0,-2
"3034","15",392,3,1,0,0,-151,109,-2,-2,-137,9,-2,-2,2,-1,-14,100,0,0
"3035","15",145,2,1,0,1,-231,-221,-4,-3,-227,-245,-2,-2,2,0,-4,24,-2,-1
"3036","15",308,1,4,1,0,-247,-246,-4,-4,4,1,0,1,2,1,-251,-247,-4,-5
"3037","15",332,1,1,0,0,-249,129,-4,-4,-246,55,-3,-3,2,1,-3,74,-1,-1
"3038","15",256,5,3,0,1,-1,3,0,0,79,112,1,1,2,-3,-80,-109,-1,-1
"3039","15",53,7,4,1,3,213,-3,2,2,201,-1,2,1,2,-5,12,-2,0,1
"3040","15",405,2,4,1,1,-211,171,-3,-3,84,63,1,-2,2,0,-295,108,-4,-1
"3041","15",106,6,2,0,1,-76,25,1,1,-86,22,1,1,2,-4,10,3,0,0
"3042","15",183,3,4,1,1,17,-21,1,-2,30,39,1,-2,2,-1,-13,-60,0,0
"3043","15",342,4,3,0,1,68,75,1,-1,-17,-71,1,-1,2,-2,85,146,0,0
"3044","15",127,1,1,0,0,-226,6,-4,-4,122,1,1,-3,2,1,-348,5,-5,-1
"3045","15",148,2,1,0,1,-238,-113,2,-3,-182,-106,2,-3,2,0,-56,-7,0,0
"3046","15",367,5,3,1,1,12,9,2,0,-12,-17,2,0,2,-3,24,26,0,0
"3047","15",363,2,3,0,3,-247,1,2,-3,1,-248,3,3,2,0,-248,249,-1,-6
"3048","15",460,1,1,0,0,-192,120,-4,-4,219,72,-2,1,2,1,-411,48,-2,-5
"3049","15",384,2,1,0,0,-123,1,-3,-3,1,102,-2,-2,2,0,-124,-101,-1,-1
"3050","15",30,7,2,0,2,182,-4,2,2,161,-2,0,1,2,-5,21,-2,2,1
"3051","15",158,4,3,0,0,-157,-24,-3,-1,54,-22,0,0,2,-2,-211,-2,-3,-1
"3052","15",154,6,4,1,3,127,124,1,1,-88,81,-1,-1,2,-4,215,43,2,2
"3053","15",66,4,1,1,1,80,2,1,-1,-160,4,0,0,2,-2,240,-2,1,-1
"3054","15",126,3,2,0,2,-231,-231,-2,-2,-112,-83,-2,-2,2,-1,-119,-148,0,0
"3055","15",122,5,1,0,0,7,-73,0,0,194,189,2,0,2,-3,-187,-262,-2,0
"3056","15",338,2,3,1,2,25,-46,-2,-3,245,246,4,4,2,0,-220,-292,-6,-7
"3057","15",362,7,4,1,3,137,79,2,2,64,176,4,1,2,-5,73,-97,-2,1
"3058","15",209,6,4,1,3,129,-27,2,1,-3,162,1,1,2,-4,132,-189,1,0
"3059","15",136,3,1,0,0,-164,54,-3,-2,209,-60,-3,-2,2,-1,-373,114,0,0
"3060","15",431,2,3,0,0,-212,39,-3,-3,22,32,-1,-1,2,0,-234,7,-2,-2
"3061","15",279,7,4,1,3,63,-46,3,2,-59,-97,3,1,2,-5,122,51,0,1
"3062","15",275,3,4,1,2,-228,5,2,-2,0,-239,4,-1,2,-1,-228,244,-2,-1
"3063","15",65,7,1,0,3,18,80,1,2,-80,59,1,2,2,-5,98,21,0,0
"3064","15",125,5,4,1,0,-178,-30,-3,0,236,-239,-4,-2,2,-3,-414,209,1,2
"3065","15",15,7,4,1,3,119,30,3,2,134,74,3,2,2,-5,-15,-44,0,0
"3066","15",369,3,4,1,0,-204,0,-2,-2,48,1,1,1,2,-1,-252,-1,-3,-3
"3067","15",333,7,4,1,1,135,-26,2,2,73,-65,1,2,2,-5,62,39,1,0
"3068","15",257,1,1,0,0,130,53,2,-4,176,147,2,-4,2,1,-46,-94,0,0
"3069","15",54,2,4,1,1,50,14,1,-3,55,37,0,0,2,0,-5,-23,1,-3
"3070","15",406,7,2,0,2,-183,-125,2,2,71,17,2,1,2,-5,-254,-142,0,1
"3071","15",107,7,2,0,3,198,-55,-2,2,-41,-37,-2,2,2,-5,239,-18,0,0
"3072","15",184,6,3,0,3,105,-5,1,1,90,1,1,1,2,-4,15,-6,0,0
"3073","15",343,5,2,0,2,-37,3,0,0,-48,0,-1,-1,2,-3,11,3,1,1
"3074","15",128,7,1,0,3,202,2,2,2,202,2,2,2,2,-5,0,0,0,0
"3075","15",149,5,3,1,1,-201,-7,-4,0,244,4,-3,1,2,-3,-445,-11,-1,-1
"3076","15",368,9,3,1,3,-128,118,4,4,-134,137,4,4,2,-7,6,-19,0,0
"3077","15",364,5,3,1,1,-2,38,0,0,-46,-2,0,0,2,-3,44,40,0,0
"3078","15",461,5,4,1,2,103,34,1,0,111,47,1,1,2,-3,-8,-13,0,-1
"3079","15",385,5,4,1,1,154,38,0,0,-36,-29,-1,0,2,-3,190,67,1,0
"3080","15",300,4,1,0,0,-132,38,-1,-1,109,73,1,1,2,-2,-241,-35,-2,-2
"3081","15",159,2,3,1,2,243,-1,2,-3,227,3,4,4,2,0,16,-4,-2,-7
"3082","15",155,5,2,0,1,-168,-201,0,0,-113,-109,0,0,2,-3,-55,-92,0,0
"3083","15",67,2,1,0,0,-239,17,-4,-3,67,-102,1,1,2,0,-306,119,-5,-4
"3084","15",374,5,4,1,2,-80,-12,0,0,109,11,1,1,2,-3,-189,-23,-1,-1
"3085","15",123,2,4,1,2,-175,22,-3,-3,-48,8,-3,-3,2,0,-127,14,0,0
"3086","15",339,6,3,1,1,16,19,0,1,15,17,-1,1,2,-4,1,2,1,0
"3087","15",335,3,2,0,1,-169,-8,-2,-2,-93,44,-1,-2,2,-1,-76,-52,-1,0
"3088","15",21,2,4,1,2,-24,-10,-2,-3,130,141,3,-2,2,0,-154,-151,-5,-1
"3089","15",137,7,1,0,1,-159,-25,-2,2,184,-17,-3,2,2,-5,-343,-8,1,0
"3090","15",432,5,2,0,1,-38,-33,0,0,37,-19,0,0,2,-3,-75,-14,0,0
"3091","15",28,4,4,1,1,-38,-43,-1,-1,13,-25,-1,-1,2,-2,-51,-18,0,0
"3092","15",276,7,4,1,3,176,-1,2,2,181,8,3,2,2,-5,-5,-9,-1,0
"3093","15",377,5,1,0,0,198,15,4,0,237,11,4,0,2,-3,-39,4,0,0
"3094","15",373,1,3,0,0,-226,-35,0,-4,-214,-70,0,-4,2,1,-12,35,0,0
"3095","15",150,5,3,1,1,1,-2,0,0,2,-2,0,0,2,-3,-1,0,0,0
"3096","15",37,1,1,0,0,-215,14,-3,-4,-48,-12,-3,-1,2,1,-167,26,0,-3
"3097","15",334,1,4,1,0,-234,195,-4,-4,-232,58,-4,-4,2,1,-2,137,0,0
"3098","15",258,1,3,0,0,114,4,1,-4,-8,2,-2,-2,2,1,122,2,3,-2
"3099","15",55,5,4,1,1,4,4,0,0,-13,-12,0,0,2,-3,17,16,0,0
"3100","15",407,1,2,1,2,92,-73,-4,-4,57,-119,1,1,2,1,35,46,-5,-5
"3101","15",108,9,2,0,3,236,39,4,4,172,55,4,4,2,-7,64,-16,0,0
"3102","15",185,6,4,1,2,30,-13,-3,1,223,-16,-1,0,2,-4,-193,3,-2,1
"3103","15",69,4,4,1,1,46,142,-1,-1,48,-127,-1,-2,2,-2,-2,269,0,1
"3104","15",129,3,4,1,1,-211,2,-2,-2,-225,-115,-2,-2,2,-1,14,117,0,0
"3105","15",271,4,3,0,1,-119,-3,-1,-1,227,4,4,4,2,-2,-346,-7,-5,-5
"3106","15",268,8,4,1,3,124,-72,2,3,104,-89,2,3,2,-6,20,17,0,0
"3107","15",365,1,3,1,1,-226,1,4,-4,-244,-2,0,-4,2,1,18,3,4,0
"3108","15",211,8,3,1,1,23,24,4,3,148,171,2,4,2,-6,-125,-147,2,-1
"3109","15",305,8,4,1,3,82,132,3,3,205,41,3,3,2,-6,-123,91,0,0
"3110","15",301,3,4,1,1,-33,1,-1,-2,78,-2,0,2,2,-1,-111,3,-1,-4
"3111","15",16,1,1,0,0,-218,14,-3,-4,196,19,3,1,2,1,-414,-5,-6,-5
"3112","15",156,5,2,1,1,7,2,0,0,46,4,1,1,2,-3,-39,-2,-1,-1
"3113","15",68,2,4,1,0,69,1,0,-3,179,1,0,-2,2,0,-110,0,0,-1
"3114","15",375,5,3,0,1,13,-1,0,0,0,-1,0,0,2,-3,13,0,0,0
"3115","15",124,8,1,0,3,-12,-27,4,3,235,-2,2,3,2,-6,-247,-25,2,0
"3116","15",34,7,4,1,2,105,-82,1,2,86,-51,3,2,2,-5,19,-31,-2,0
"3117","15",336,2,4,1,3,210,153,3,-3,151,187,3,-3,2,0,59,-34,0,0
"3118","15",210,8,4,1,2,59,-54,3,3,115,-70,1,-1,2,-6,-56,16,2,4
"3119","15",138,4,3,1,1,41,-116,-1,-1,61,-54,0,0,2,-2,-20,-62,-1,-1
"3120","15",433,2,1,0,0,194,225,-3,-3,202,165,4,-3,2,0,-8,60,-7,0
"3121","15",280,6,2,0,1,234,-17,2,1,69,102,2,-1,2,-4,165,-119,0,2
"3122","15",277,1,4,1,1,-80,53,4,-4,36,-47,3,1,2,1,-116,100,1,-5
"3123","15",378,3,4,1,1,-179,1,0,-2,-138,-1,-2,-2,2,-1,-41,2,2,0
"3124","15",130,9,1,0,3,181,40,4,4,193,40,4,4,2,-7,-12,0,0,0
"3125","15",151,1,2,0,1,-249,7,0,-4,-244,10,0,-4,2,1,-5,-3,0,0
"3126","15",370,9,1,0,3,235,-19,4,4,231,-13,0,-4,2,-7,4,-6,4,8
"3127","15",217,2,4,0,2,-124,32,-1,-3,64,35,1,-1,2,0,-188,-3,-2,-2
"3128","15",259,1,3,0,1,-118,34,4,-4,0,1,4,-4,2,1,-118,33,0,0
"3129","15",56,4,3,0,1,48,-126,-2,-1,67,-103,-2,0,2,-2,-19,-23,0,-1
"3130","15",408,3,1,0,0,-146,-11,0,-2,11,-4,1,0,2,-1,-157,-7,-1,-2
"3131","15",109,1,1,0,1,-13,0,4,-4,-7,0,2,-4,2,1,-6,0,2,0
"3132","15",186,5,2,1,2,-26,7,0,0,200,166,0,0,2,-3,-226,-159,0,0
"3133","15",7,6,1,0,3,104,42,1,1,49,41,-1,1,2,-4,55,1,2,0
"3134","15",13,5,4,1,1,56,-104,2,0,60,-60,1,-2,2,-3,-4,-44,1,2
"3135","15",272,5,4,1,2,72,30,0,0,60,42,1,1,2,-3,12,-12,-1,-1
"3136","15",269,2,4,1,2,-249,110,0,-3,-250,94,-4,-4,2,0,1,16,4,1
"3137","15",216,6,3,1,1,-23,-14,0,1,-7,1,0,0,2,-4,-16,-15,0,1
"3138","15",212,1,1,0,1,-213,21,0,-4,-229,27,0,-4,2,1,16,-6,0,0
"3139","15",306,5,3,0,3,138,120,1,0,121,130,1,0,2,-3,17,-10,0,0
"3140","15",302,3,1,1,0,-112,-25,-3,-2,197,51,-2,-2,2,-1,-309,-76,-1,0
"3141","15",160,7,2,0,0,-224,3,-4,2,-93,8,2,2,2,-5,-131,-5,-6,0
"3142","15",157,1,3,1,2,-147,3,-4,-4,3,11,-2,0,2,1,-150,-8,-2,-4
"3143","15",38,6,4,0,3,82,2,1,1,227,-40,1,1,2,-4,-145,42,0,0
"3144","15",376,3,4,1,1,67,-11,-2,-2,107,-43,-1,-1,2,-1,-40,32,-1,-1
"3145","15",153,6,1,0,3,-144,-92,3,1,-13,-24,0,1,2,-4,-131,-68,3,0
"3146","15",372,2,3,1,0,-100,-37,-2,-3,-12,-89,-2,-2,2,0,-88,52,0,-1
"3147","15",264,4,4,1,2,-3,4,-1,-1,133,62,0,0,2,-2,-136,-58,-1,-1
"3148","15",260,4,3,1,0,-53,-35,-1,-1,0,-1,0,0,2,-2,-53,-34,-1,-1
"3149","15",139,1,4,1,2,-238,-25,-4,-4,-245,-5,-4,-4,2,1,7,-20,0,0
"3150","15",434,6,4,1,3,106,-10,1,1,144,-15,1,1,2,-4,-38,5,0,0
"3151","15",281,1,4,0,2,-241,6,-4,-4,-230,1,-4,-4,2,1,-11,5,0,0
"3152","15",278,5,4,0,1,-226,-223,4,0,-227,-226,4,-4,2,-3,1,3,0,4
"3153","15",379,5,3,1,1,63,-52,-2,0,-19,-38,1,-1,2,-3,82,-14,-3,1
"3154","15",131,8,4,1,3,72,-16,0,3,72,-8,0,3,2,-6,0,-8,0,0
"3155","15",152,4,1,0,0,-2,1,0,-1,20,-3,0,0,2,-2,-22,4,0,-1
"3156","15",371,3,3,0,0,-214,-150,-2,-2,214,-37,-2,2,2,-1,-428,-113,0,-4
"3157","15",218,8,4,1,3,-101,13,4,3,-100,4,4,3,2,-6,-1,9,0,0
"3158","15",26,1,1,0,0,-215,63,-4,-4,28,-93,-2,-4,2,1,-243,156,-2,0
"3159","15",57,1,4,0,1,-7,-139,-1,-4,1,-226,1,-4,2,1,-8,87,-2,0
"3160","15",409,3,4,1,2,-115,-109,-2,-2,122,121,2,1,2,-1,-237,-230,-4,-3
"3161","15",11,7,4,1,1,4,-5,0,2,-156,87,-1,1,2,-5,160,-92,1,1
"3162","15",187,1,4,0,2,-244,1,-4,-4,-67,-9,-1,0,2,1,-177,10,-3,-4
"3163","15",70,1,2,0,2,-226,-71,2,-4,195,105,1,-2,2,1,-421,-176,1,-2
"3164","15",458,2,1,0,1,-92,-80,0,-3,76,77,-1,-2,2,0,-168,-157,1,-1
"3165","15",273,1,1,0,0,-209,-225,-3,-4,157,59,1,0,2,1,-366,-284,-4,-4
"3166","15",27,5,2,0,2,-29,-41,0,0,27,-19,0,0,2,-3,-56,-22,0,0
"3167","15",266,4,1,1,1,-109,-4,-1,-1,-94,-1,-1,-1,2,-2,-15,-3,0,0
"3168","15",213,4,2,0,1,-2,1,0,-1,24,0,1,0,2,-2,-26,1,-1,-1
"3169","15",140,4,1,0,1,-19,33,1,-1,3,35,-1,0,2,-2,-22,-2,2,-1
"3170","15",303,1,3,0,2,-228,-222,-4,-4,-147,-93,-3,-4,2,1,-81,-129,-1,0
"3171","15",161,1,2,0,2,-244,222,-4,-4,83,48,1,-3,2,1,-327,174,-5,-1
"3172","15",380,1,4,1,1,-211,-43,3,-4,170,-61,3,-3,2,1,-381,18,0,-1
"3173","15",98,1,3,1,0,-234,23,-3,-4,142,206,4,4,2,1,-376,-183,-7,-8
"3174","15",457,1,3,1,1,-26,-8,-4,-4,119,-234,2,2,2,1,-145,226,-6,-6
"3175","15",453,3,4,0,2,-124,-1,-2,-2,-128,3,1,0,2,-1,4,-4,-3,-2
"3176","15",45,2,3,1,0,-165,74,-3,-3,37,46,-1,-1,2,0,-202,28,-2,-2
"3177","15",265,9,1,0,3,161,1,3,4,-3,0,0,0,2,-7,164,1,3,4
"3178","15",261,9,1,0,3,57,58,4,4,156,204,4,4,2,-7,-99,-146,0,0
"3179","15",14,4,3,0,1,-3,-3,0,-1,137,-33,1,0,2,-2,-140,30,-1,-1
"3180","15",435,4,4,0,1,-54,-27,0,-1,-64,-96,-1,1,2,-2,10,69,1,-2
"3181","15",282,9,3,0,3,48,-112,1,4,164,23,0,4,2,-7,-116,-135,1,0
"3182","15",72,5,1,1,0,63,91,0,0,148,162,2,2,2,-3,-85,-71,-2,-2
"3183","15",270,5,3,1,1,0,2,0,0,-3,246,4,4,2,-3,3,-244,-4,-4
"3184","15",46,1,1,0,0,-202,-243,0,-4,-8,-245,-4,-4,2,1,-194,2,4,0
"3185","15",456,2,1,0,0,-1,-125,-1,-3,-3,116,2,-3,2,0,2,-241,-3,0
"3186","15",452,3,3,1,1,-11,-103,-2,-2,-32,3,-1,-1,2,-1,21,-106,-1,-1
"3187","15",219,5,4,1,3,249,-1,4,0,-3,-244,4,-2,2,-3,252,243,0,2
"3188","15",215,2,1,0,0,-148,26,-2,-3,116,37,-2,-3,2,0,-264,-11,0,0
"3189","15",58,9,4,1,1,-246,1,-4,4,2,246,4,4,2,-7,-248,-245,-8,0
"3190","15",41,6,2,0,3,4,78,2,1,30,62,2,1,2,-4,-26,16,0,0
"3191","15",110,2,1,0,1,-98,56,3,-3,109,-113,-3,1,2,0,-207,169,6,-4
"3192","15",188,9,2,0,3,218,1,4,4,221,5,4,4,2,-7,-3,-4,0,0
"3193","15",71,4,3,1,1,-74,30,-1,-1,19,17,-1,0,2,-2,-93,13,0,-1
"3194","15",459,1,3,0,1,-123,169,4,-4,75,36,3,-4,2,1,-198,133,1,0
"3195","15",274,6,4,1,2,61,-33,1,1,84,-67,2,2,2,-4,-23,34,-1,-1
"3196","15",6,3,4,1,2,-245,0,-2,-2,-129,0,-1,-1,2,-1,-116,0,-1,-1
"3197","15",267,4,3,0,1,100,1,-1,-1,100,2,1,1,2,-2,0,-1,-2,-2
"3198","15",214,9,1,0,3,128,-129,4,4,139,-146,4,4,2,-7,-11,17,0,0
"3199","15",141,1,1,1,0,-220,18,3,-4,220,25,2,3,2,1,-440,-7,1,-7
"3200","15",304,1,2,0,2,-238,-9,-4,-4,62,-21,2,2,2,1,-300,12,-6,-6
"3201","15",162,7,3,0,3,25,34,-1,2,187,158,4,4,2,-5,-162,-124,-5,-2
"3202","15",381,2,2,0,2,-225,-241,-3,-3,239,249,4,4,2,0,-464,-490,-7,-7
"3203","15",99,9,4,1,3,233,-14,4,4,25,-239,4,4,2,-7,208,225,0,0
"3204","15",22,5,3,0,1,92,5,0,0,100,-11,1,1,2,-3,-8,16,-1,-1
"3205","15",454,4,4,0,3,-60,1,-1,-1,-60,1,-1,-1,2,-2,0,0,0,0
"3206","15",450,6,4,1,3,-3,116,4,1,96,4,0,-1,2,-4,-99,112,4,2
"3207","15",220,1,4,1,2,-232,218,-4,-4,162,84,-2,-2,2,1,-394,134,-2,-2
"3208","15",262,6,4,1,3,114,67,1,1,114,79,1,1,2,-4,0,-12,0,0
"3209","15",189,3,1,1,1,-213,52,2,-2,-185,43,2,-3,2,-1,-28,9,0,1
"3210","15",436,4,4,1,3,75,10,4,-1,86,-111,3,1,2,-2,-11,121,1,-2
"3211","15",283,6,1,0,1,-85,-113,-2,1,144,-71,-2,2,2,-4,-229,-42,0,-1
"3212","15",73,4,4,1,2,-96,-87,1,-1,-125,-123,-1,1,2,-2,29,36,2,-2
"3213","15",23,9,1,0,3,-206,-188,-4,4,201,186,4,4,2,-7,-407,-374,-8,0
"3214","15",424,3,2,0,2,-106,-13,-2,-2,126,80,1,-1,2,-1,-232,-93,-3,-1
"3215","15",420,6,4,1,3,-1,-77,2,1,1,3,0,0,2,-4,-2,-80,2,1
"3216","15",227,4,3,1,3,34,-20,1,-1,80,54,1,-1,2,-2,-46,-74,0,0
"3217","15",438,5,4,0,3,-1,8,0,0,2,3,4,0,2,-3,-3,5,-4,0
"3218","15",87,6,4,1,3,106,19,2,1,0,48,1,1,2,-4,106,-29,1,0
"3219","15",59,1,1,1,0,-133,2,-4,-4,-3,-48,1,1,2,1,-130,50,-5,-5
"3220","15",410,1,1,0,0,-224,-135,1,-4,-157,-43,1,-3,2,1,-67,-92,0,-1
"3221","15",111,3,1,1,0,90,136,-2,-2,107,102,1,-1,2,-1,-17,34,-3,-1
"3222","15",455,1,2,0,2,-190,-9,-4,-4,236,-6,4,4,2,1,-426,-3,-8,-8
"3223","15",451,1,1,0,0,-223,-225,-4,-4,-170,-217,-4,-4,2,1,-53,-8,0,0
"3224","15",221,5,4,0,1,5,-4,1,0,2,-10,0,1,2,-3,3,6,1,-1
"3225","15",263,6,4,1,0,-188,-8,-2,1,-197,1,-4,-3,2,-4,9,-9,2,4
"3226","15",60,7,1,0,3,185,-1,2,2,186,-1,2,2,2,-5,-1,0,0,0
"3227","15",437,4,1,1,0,77,-3,-1,-1,52,1,1,1,2,-2,25,-4,-2,-2
"3228","15",284,2,3,0,1,-73,-117,-2,-3,71,40,-3,-4,2,0,-144,-157,1,1
"3229","15",142,5,2,0,2,-25,23,-4,0,5,-56,-4,0,2,-3,-30,79,0,0
"3230","15",61,2,1,0,3,245,25,3,-3,-38,-8,4,-4,2,0,283,33,-1,1
"3231","15",163,5,3,0,1,-158,9,1,0,94,-1,0,2,2,-3,-252,10,1,-2
"3232","15",382,6,4,1,2,93,-1,2,1,63,-6,1,1,2,-4,30,5,1,0
"3233","15",228,2,4,1,2,-23,32,-3,-3,62,116,2,2,2,0,-85,-84,-5,-5
"3234","15",426,7,4,0,3,1,-246,2,2,42,2,1,1,2,-5,-41,-248,1,1
"3235","15",88,1,4,1,2,-234,-17,-4,-4,179,-46,4,4,2,1,-413,29,-8,-8
"3236","15",443,1,1,0,0,-231,-213,-4,-4,49,35,1,0,2,1,-280,-248,-5,-4
"3237","15",411,1,2,0,2,-227,-231,-4,-4,-179,-195,1,-4,2,1,-48,-36,-5,0
"3238","15",112,7,4,1,3,14,-237,3,2,17,242,4,4,2,-5,-3,-479,-1,-2
"3239","15",19,2,2,0,2,-207,-194,-3,-3,-120,-102,-1,-1,2,0,-87,-92,-2,-2
"3240","15",444,1,2,0,2,-161,85,-3,-4,-1,32,-2,-2,2,1,-160,53,-1,-2
"3241","15",222,2,1,0,0,-241,6,-3,-3,-227,1,-3,-3,2,0,-14,5,0,0
"3242","15",74,1,3,1,0,-221,144,-4,-4,10,9,0,0,2,1,-231,135,-4,-4
"3243","15",190,9,4,1,3,166,174,4,4,236,221,2,2,2,-7,-70,-47,2,2
"3244","15",425,5,4,1,2,-28,-114,0,0,-23,46,1,1,2,-3,-5,-160,-1,-1
"3245","15",421,5,3,0,1,-123,-46,-1,0,24,-46,1,4,2,-3,-147,0,-2,-4
"3246","15",442,6,4,1,1,-31,27,-1,1,28,29,1,1,2,-4,-59,-2,-2,0
"3247","15",439,5,2,0,1,-1,-1,0,0,-2,1,-2,-3,2,-3,1,-2,2,3
"3248","15",164,3,2,0,2,1,-143,-2,-2,-4,-2,0,0,2,-1,5,-141,-2,-2
"3249","15",383,5,4,1,1,1,-5,0,0,1,1,0,0,2,-3,0,-6,0,0
"3250","15",229,6,1,0,1,14,-25,1,1,-234,214,-3,-3,2,-4,248,-239,4,4
"3251","15",427,1,4,1,1,-207,-25,4,-4,-210,-46,4,-4,2,1,3,21,0,0
"3252","15",89,4,3,1,0,-236,1,-3,-1,-3,-33,-4,-3,2,-2,-233,34,1,2
"3253","15",77,5,3,1,1,33,-1,0,0,63,-3,-2,1,2,-3,-30,2,2,-1
"3254","15",412,9,1,0,0,-236,1,-2,4,110,-38,4,4,2,-7,-346,39,-6,0
"3255","15",9,4,4,1,2,18,11,1,-1,30,18,1,-1,2,-2,-12,-7,0,0
"3256","15",93,6,1,0,1,-134,32,-2,1,-29,-11,-1,0,2,-4,-105,43,-1,1
"3257","15",413,6,1,0,1,177,7,1,1,156,-4,2,2,2,-4,21,11,-1,-1
"3258","15",285,4,2,1,1,-145,129,-4,-1,-28,38,-2,1,2,-2,-117,91,-2,-2
"3259","15",75,2,4,0,2,223,34,3,-3,243,239,4,-3,2,0,-20,-205,-1,0
"3260","15",62,9,2,0,3,-233,-6,-4,4,226,220,4,4,2,-7,-459,-226,-8,0
"3261","15",224,2,2,0,2,-194,-46,-3,-3,158,69,2,1,2,0,-352,-115,-5,-4
"3262","15",422,2,3,0,1,-5,-85,2,-3,-102,-89,3,-3,2,0,97,4,-1,0
"3263","15",63,3,4,1,1,-2,-1,0,-2,-67,1,-1,1,2,-1,65,-2,1,-3
"3264","15",44,1,2,0,2,-197,1,-4,-4,195,53,0,-4,2,1,-392,-52,-4,0
"3265","15",165,5,1,0,1,148,60,0,0,120,88,1,1,2,-3,28,-28,-1,-1
"3266","15",423,4,1,0,3,191,-28,3,-1,137,81,0,2,2,-2,54,-109,3,-3
"3267","15",64,4,1,0,1,116,-33,-2,-1,165,-35,-2,-2,2,-2,-49,2,0,1
"3268","15",113,3,2,0,2,37,-91,-2,-2,61,80,2,2,2,-1,-24,-171,-4,-4
"3269","15",166,1,4,1,2,-135,81,-2,-4,195,194,-2,-1,2,1,-330,-113,0,-3
"3270","15",445,6,4,1,3,84,-65,1,1,153,-121,2,2,2,-4,-69,56,-1,-1
"3271","15",223,5,1,0,1,0,0,0,0,0,-1,0,0,2,-3,0,1,0,0
"3272","15",90,4,4,1,0,-50,16,-1,-1,244,11,4,3,2,-2,-294,5,-5,-4
"3273","15",191,3,1,0,0,-219,-28,-2,-2,-203,-36,-2,-2,2,-1,-16,8,0,0
"3274","15",414,5,1,0,0,20,-9,0,0,80,85,2,2,2,-3,-60,-94,-2,-2
"3275","15",286,6,1,0,3,65,12,1,1,57,5,1,1,2,-4,8,7,0,0
"3276","15",76,6,4,0,3,90,-1,1,1,86,1,1,1,2,-4,4,-2,0,0
"3277","15",447,4,4,0,2,-101,-1,-2,-1,177,75,2,2,2,-2,-278,-76,-4,-3
"3278","15",225,6,2,1,2,-163,-25,-1,1,-174,-29,-2,-2,2,-4,11,4,1,3
"3279","15",287,7,4,0,3,124,11,2,2,170,-4,2,2,2,-5,-46,15,0,0
"3280","15",193,1,1,0,0,-223,-151,-4,-4,140,-67,1,1,2,1,-363,-84,-5,-5
"3281","15",226,1,1,1,0,78,3,-2,-4,122,6,2,-3,2,1,-44,-3,-4,-1
"3282","15",416,1,4,1,0,-220,234,-4,-4,-240,242,-4,-4,2,1,20,-8,0,0
"3283","15",78,3,4,1,0,-185,9,-2,-2,-157,-21,-2,-2,2,-1,-28,30,0,0
"3284","15",441,6,4,1,2,9,-9,0,1,23,-22,1,1,2,-4,-14,13,-1,0
"3285","15",114,2,4,1,1,-67,-84,1,-3,165,174,1,-3,2,0,-232,-258,0,0
"3286","15",94,6,4,1,1,71,-94,1,1,226,228,4,4,2,-4,-155,-322,-3,-3
"3287","15",446,4,4,0,1,-95,26,-1,-1,8,3,0,0,2,-2,-103,23,-1,-1
"3288","15",293,1,4,1,0,-250,11,-4,-4,-192,15,-4,-4,2,1,-58,-4,0,0
"3289","15",91,5,2,1,3,108,1,1,0,64,5,1,1,2,-3,44,-4,0,-1
"3290","15",192,7,4,1,1,-155,-2,1,2,1,93,1,1,2,-5,-156,-95,0,1
"3291","15",415,4,2,0,2,0,-1,0,-1,145,200,0,1,2,-2,-145,-201,0,-2
"3292","15",294,7,1,0,3,102,-1,2,2,49,1,3,3,2,-5,53,-2,-1,-1
"3293","15",92,4,4,1,2,-69,-59,-1,-1,-108,-102,-1,-1,2,-2,39,43,0,0
"3294","15",440,5,3,1,0,-1,-2,1,0,1,0,0,0,2,-3,-2,-2,1,0
"3295","15",197,1,4,1,3,-228,-195,4,-4,-233,-1,4,-2,2,1,5,-194,0,-2
"3296","15",97,2,1,0,1,-242,-48,4,-3,29,19,2,-2,2,0,-271,-67,2,-1
"3297","15",449,7,4,1,3,-4,91,0,2,-2,77,1,1,2,-5,-2,14,-1,1
"3298","15",417,5,2,0,2,1,-2,0,0,-133,-102,-2,-3,2,-3,134,100,2,3
"3299","15",289,8,1,1,3,175,-210,3,3,213,108,3,3,2,-6,-38,-318,0,0
"3300","15",79,2,4,1,2,-232,26,-3,-3,-225,21,-3,-3,2,0,-7,5,0,0
"3301","15",195,1,1,0,1,-216,213,4,-4,30,-22,2,0,2,1,-246,235,2,-4
"3302","15",115,5,3,0,3,-6,2,0,0,248,4,1,2,2,-3,-254,-2,-1,-2
"3303","15",95,2,4,0,2,-179,-3,-3,-3,-165,-3,-1,-1,2,0,-14,0,-2,-2
"3304","15",8,2,3,1,1,86,33,-1,-3,-71,-193,-1,2,2,0,157,226,0,-5
"3305","15",196,1,3,1,0,-18,-246,0,-4,241,244,4,4,2,1,-259,-490,-4,-8
"3306","15",116,2,2,1,3,-224,-18,-3,-3,71,0,0,1,2,0,-295,-18,-3,-4
"3307","15",448,6,2,0,2,-245,0,-4,1,-63,0,-1,-4,2,-4,-182,0,-3,5
"3308","15",12,9,4,1,3,-1,-1,4,4,1,0,4,4,2,-7,-2,-1,0,0
"3309","15",288,4,2,1,2,-120,0,-3,-1,-208,4,-3,0,2,-2,88,-4,0,-1
"3310","15",194,8,1,0,0,-182,9,-4,3,-125,11,-4,3,2,-6,-57,-2,0,0
"3311","15",81,3,1,0,0,-229,168,2,-2,21,45,1,-3,2,-1,-250,123,1,1
"3312","15",296,5,1,0,3,13,3,0,0,-26,175,0,0,2,-3,39,-172,0,0
"3313","15",118,5,3,0,1,-65,-27,-2,0,-1,26,0,1,2,-3,-64,-53,-2,-1
"3314","15",292,4,3,1,1,-1,109,0,-1,200,-1,-3,0,2,-2,-201,110,3,-1
"3315","15",418,4,2,0,2,-20,-38,-1,-1,226,30,1,1,2,-2,-246,-68,-2,-2
"3316","15",29,1,4,1,0,-245,17,-4,-4,182,179,-1,-1,2,1,-427,-162,-3,-3
"3317","15",119,5,3,0,3,-78,95,0,0,-209,-87,-2,-2,2,-3,131,182,2,2
"3318","15",295,5,1,0,1,2,-1,0,0,0,2,0,0,2,-3,2,-3,0,0
"3319","15",419,6,4,1,3,201,116,1,1,181,110,0,0,2,-4,20,6,1,1
"3320","15",80,6,4,1,3,194,-14,3,1,197,2,2,2,2,-4,-3,-16,1,-1
"3321","15",198,5,1,1,1,-102,70,-1,0,108,96,1,-1,2,-3,-210,-26,-2,1
"3322","15",85,1,2,0,2,-174,110,-3,-4,-128,138,-3,-2,2,1,-46,-28,0,-2
"3323","15",117,1,4,0,2,-243,-1,-3,-4,-219,0,-2,-2,2,1,-24,-1,-1,-2
"3324","15",291,3,4,1,2,22,1,-3,-2,1,-96,-1,-1,2,-1,21,97,-2,-1
"3325","15",86,7,4,1,3,159,-27,1,2,148,-7,1,2,2,-5,11,-20,0,0
"3326","15",120,2,3,1,1,-54,109,-3,-3,216,-99,2,2,2,0,-270,208,-5,-5
"3327","15",84,9,4,1,3,189,1,2,4,203,0,3,3,2,-7,-14,1,-1,1
"3328","15",82,9,4,1,2,202,-17,4,4,56,-215,4,4,2,-7,146,198,0,0
"3329","15",96,3,1,0,0,-153,-8,-2,-2,-46,-2,-2,-2,2,-1,-107,-6,0,0
"3330","15",290,2,1,0,1,-116,-90,-2,-3,51,-106,-2,-2,2,0,-167,16,0,-1
"3331","15",83,5,1,0,3,22,-21,0,0,158,-144,2,1,2,-3,-136,123,-2,-1
"3332","15",42,2,3,0,1,-13,-28,2,-3,7,13,2,-2,2,0,-20,-41,0,-1
"3333","16",323,5,4,1,1,1,-86,0,0,226,0,0,-4,3,-2,-225,-86,0,4
"3334","16",468,4,1,0,3,131,63,2,-1,69,-64,1,2,3,-1,62,127,1,-3
"3335","16",470,4,1,0,1,-63,24,-1,-1,-50,10,1,-1,3,-1,-13,14,-2,0
"3336","16",324,2,2,1,0,48,4,-3,-3,-238,0,-4,-4,3,1,286,4,1,1
"3337","16",322,5,4,1,3,25,-28,0,0,232,-235,3,3,3,-2,-207,207,-3,-3
"3338","16",320,1,2,0,2,-248,127,-4,-4,-250,154,-4,-4,3,2,2,-27,0,0
"3339","16",32,5,1,0,1,7,0,0,0,179,-168,0,3,3,-2,-172,168,0,-3
"3340","16",319,3,1,0,1,-77,38,-1,-2,54,67,2,3,3,0,-131,-29,-3,-5
"3341","16",47,7,4,1,3,249,-14,1,2,117,-1,1,1,3,-4,132,-13,0,1
"3342","16",321,3,1,0,0,-185,-171,-2,-2,-161,-164,-2,-2,3,0,-24,-7,0,0
"3343","16",397,6,4,1,3,97,-9,1,1,119,-76,1,1,3,-3,-22,67,0,0
"3344","16",462,9,3,1,3,223,122,4,4,214,181,4,4,3,-6,9,-59,0,0
"3345","16",467,5,1,1,3,-74,36,4,0,72,185,4,0,3,-2,-146,-149,0,0
"3346","16",466,3,3,1,0,-129,-80,-2,-2,-102,-34,-1,-1,3,0,-27,-46,-1,-1
"3347","16",463,9,4,1,3,0,0,4,4,235,0,2,4,3,-6,-235,0,2,0
"3348","16",471,5,3,1,2,-160,5,-2,0,74,142,0,1,3,-2,-234,-137,-2,-1
"3349","16",318,1,2,0,2,-181,-170,-4,-4,177,62,-4,0,3,2,-358,-232,0,-4
"3350","16",399,6,4,1,3,99,-8,1,1,131,-108,1,1,3,-3,-32,100,0,0
"3351","16",469,1,4,1,0,130,25,-3,-4,65,54,-3,-4,3,2,65,-29,0,0
"3352","16",472,1,1,0,0,-73,9,-4,-4,-40,11,-4,-4,3,2,-33,-2,0,0
"3353","16",476,6,3,1,0,150,-124,1,1,85,-88,0,0,3,-3,65,-36,1,1
"3354","16",327,4,4,0,3,111,-2,0,-1,-8,50,0,-2,3,-1,119,-52,0,1
"3355","16",473,4,3,0,0,-41,13,-1,-1,5,-9,-1,-2,3,-1,-46,22,0,1
"3356","16",48,1,3,1,0,61,-64,-4,-4,76,-60,-4,-4,3,2,-15,-4,0,0
"3357","16",40,8,1,0,2,-134,104,-3,3,117,77,-2,1,3,-5,-251,27,-1,2
"3358","16",474,1,1,1,0,2,-67,0,-4,1,-81,0,-4,3,2,1,14,0,0
"3359","16",398,6,4,1,2,10,14,1,1,109,33,1,1,3,-3,-99,-19,0,0
"3360","16",400,6,4,1,2,88,-17,-1,1,42,-52,2,2,3,-3,46,35,-3,-1
"3361","16",325,9,1,0,1,-119,-99,0,4,-32,-28,4,4,3,-6,-87,-71,-4,0
"3362","16",475,8,3,1,3,161,-32,2,3,146,-180,2,-2,3,-5,15,148,0,5
"3363","16",5,2,2,0,2,-241,5,-2,-3,-237,4,-3,-4,3,1,-4,1,1,1
"3364","16",326,7,4,1,2,162,57,2,2,170,85,2,2,3,-4,-8,-28,0,0
"3365","16",33,5,3,0,1,93,-48,-2,0,59,-56,-1,1,3,-2,34,8,-1,-1
"3366","16",169,1,3,1,0,-239,77,-4,-4,-240,147,-4,-4,3,2,1,-70,0,0
"3367","16",4,4,3,1,1,1,6,-2,-1,243,168,3,4,3,-1,-242,-162,-5,-5
"3368","16",76,6,4,1,3,110,1,1,1,73,5,1,1,3,-3,37,-4,0,0
"3369","16",330,5,2,0,2,-218,1,1,0,204,161,1,1,3,-2,-422,-160,0,-1
"3370","16",431,5,3,1,0,4,10,0,0,27,36,0,0,3,-2,-23,-26,0,0
"3371","16",328,4,3,1,1,43,8,-1,-1,74,26,1,1,3,-1,-31,-18,-2,-2
"3372","16",49,3,4,1,1,0,0,-2,-2,-115,-115,-1,-2,3,0,115,115,-1,0
"3373","16",432,5,2,0,1,30,-61,0,0,36,-30,0,0,3,-2,-6,-31,0,0
"3374","16",244,4,4,1,2,-77,-56,-1,-1,159,164,2,2,3,-1,-236,-220,-3,-3
"3375","16",329,3,4,1,3,150,-58,2,-2,83,-75,0,0,3,0,67,17,2,-2
"3376","16",171,5,1,1,1,30,22,0,0,7,14,0,0,3,-2,23,8,0,0
"3377","16",464,4,1,1,1,-160,12,0,-1,-78,25,1,-1,3,-1,-82,-13,-1,0
"3378","16",245,1,1,1,0,-123,-6,-3,-4,-112,-8,-2,-3,3,2,-11,2,-1,-1
"3379","16",232,1,1,0,0,-239,-50,-2,-4,-229,-43,-4,-4,3,2,-10,-7,2,0
"3380","16",50,3,2,1,1,0,0,0,-2,141,1,2,-2,3,0,-141,-1,-2,0
"3381","16",465,9,4,1,3,128,5,4,4,-17,-232,4,3,3,-6,145,237,0,1
"3382","16",246,6,4,1,3,209,-3,3,1,-3,73,2,0,3,-3,212,-76,1,1
"3383","16",17,1,3,1,0,66,46,-1,-4,175,115,-2,-4,3,2,-109,-69,1,0
"3384","16",243,2,2,0,2,-248,7,-4,-3,246,191,-2,-1,3,1,-494,-184,-2,-2
"3385","16",77,6,3,0,1,61,-5,0,1,1,16,-2,1,3,-3,60,-21,2,0
"3386","16",170,1,2,1,0,-234,-239,-4,-4,9,9,0,0,3,2,-243,-248,-4,-4
"3387","16",429,1,2,0,0,-219,-172,-4,-4,-229,-138,-4,-4,3,2,10,-34,0,0
"3388","16",248,6,4,1,3,7,76,1,1,33,-27,0,0,3,-3,-26,103,1,1
"3389","16",78,2,4,1,0,-174,-9,-3,-3,-158,-3,-3,-3,3,1,-16,-6,0,0
"3390","16",401,2,2,1,1,-65,16,1,-3,179,75,1,0,3,1,-244,-59,0,-3
"3391","16",43,1,3,1,0,-155,77,-4,-4,112,7,-2,-4,3,2,-267,70,-2,0
"3392","16",249,1,3,1,0,-179,-221,-3,-4,-226,-201,-4,-4,3,2,47,-20,1,0
"3393","16",172,7,2,1,3,104,104,2,2,-179,83,-3,-3,3,-4,283,21,5,5
"3394","16",402,1,3,1,0,-239,-111,2,-4,107,-3,3,-2,3,2,-346,-108,-1,-2
"3395","16",310,3,4,1,2,14,-1,-1,-2,30,-1,2,2,3,0,-16,0,-3,-4
"3396","16",233,6,2,0,2,18,16,1,1,-203,27,-1,0,3,-3,221,-11,2,1
"3397","16",428,4,1,0,0,-37,-107,-1,-1,208,214,2,-2,3,-1,-245,-321,-3,1
"3398","16",247,4,3,1,0,-120,-3,-1,-1,239,-7,2,2,3,-1,-359,4,-3,-3
"3399","16",331,2,1,0,0,20,-200,-4,-3,2,-191,-4,-3,3,1,18,-9,0,0
"3400","16",52,1,3,1,0,-188,2,-2,-4,-79,6,-2,-3,3,2,-109,-4,0,-1
"3401","16",404,5,1,0,1,61,-39,1,0,50,-72,1,0,3,-2,11,33,0,0
"3402","16",352,5,2,0,1,-48,-108,0,0,9,-110,0,-1,3,-2,-57,2,0,1
"3403","16",433,7,1,1,0,-66,-76,2,2,222,221,3,3,3,-4,-288,-297,-1,-1
"3404","16",168,6,1,1,3,145,-200,1,1,119,-80,2,2,3,-3,26,-120,-1,-1
"3405","16",313,7,3,1,0,121,139,2,2,124,128,1,1,3,-4,-3,11,1,1
"3406","16",79,3,4,1,2,-207,-196,-2,-2,-237,-17,-3,-2,3,0,30,-179,1,0
"3407","16",434,6,4,1,3,210,-21,1,1,211,-97,2,2,3,-3,-1,76,-1,-1
"3408","16",430,6,2,1,1,56,-34,1,1,167,-78,1,0,3,-3,-111,44,0,1
"3409","16",25,4,4,1,2,-48,-96,-2,-1,31,40,0,0,3,-1,-79,-136,-2,-1
"3410","16",51,1,4,1,1,44,49,-1,-4,40,74,-2,0,3,2,4,-25,1,-4
"3411","16",403,6,1,0,0,-212,-15,-2,1,-137,-22,0,-2,3,-3,-75,7,-2,3
"3412","16",351,1,1,0,0,-219,-194,-4,-4,121,125,-4,-4,3,2,-340,-319,0,0
"3413","16",174,5,4,1,3,176,67,1,0,90,184,1,0,3,-2,86,-117,0,0
"3414","16",167,4,1,0,3,-163,115,-1,-1,163,-181,3,3,3,-1,-326,296,-4,-4
"3415","16",312,1,4,1,1,-188,100,0,-4,-78,-66,4,-4,3,2,-110,166,-4,0
"3416","16",175,3,4,1,1,-85,-41,-2,-2,-73,-56,-1,-3,3,0,-12,15,-1,1
"3417","16",53,7,4,1,3,204,-4,2,2,-1,-77,2,2,3,-4,205,73,0,0
"3418","16",405,3,4,1,1,-223,151,1,-2,104,-69,-2,-2,3,0,-327,220,3,0
"3419","16",353,4,2,1,2,102,34,2,-1,230,81,0,3,3,-1,-128,-47,2,-4
"3420","16",176,7,1,0,1,-143,23,-4,2,171,59,-3,-4,3,-4,-314,-36,-1,6
"3421","16",314,1,4,1,1,-240,13,4,-4,-240,8,4,-4,3,2,0,5,0,0
"3422","16",241,4,4,1,2,145,76,2,-1,174,156,2,0,3,-1,-29,-80,0,-1
"3423","16",173,7,4,1,3,137,6,2,2,168,11,0,0,3,-4,-31,-5,2,2
"3424","16",435,5,4,1,1,-12,9,1,0,110,-25,-1,0,3,-2,-122,34,2,0
"3425","16",311,1,2,0,2,-192,5,-4,-4,187,18,4,-4,3,2,-379,-13,-8,0
"3426","16",234,4,3,1,3,135,37,0,-1,132,50,1,-1,3,-1,3,-13,-1,0
"3427","16",388,6,4,1,0,7,-230,-1,1,-238,4,-4,-4,3,-3,245,-234,3,5
"3428","16",98,2,3,1,0,-226,59,-2,-3,102,-143,4,4,3,1,-328,202,-6,-7
"3429","16",332,2,1,0,0,-249,145,-2,-3,-249,99,-3,-3,3,1,0,46,1,0
"3430","16",179,5,1,1,1,0,-1,3,0,2,3,0,0,3,-2,-2,-4,3,0
"3431","16",317,4,4,1,2,-24,24,-1,-1,-35,38,-1,-1,3,-1,11,-14,0,0
"3432","16",349,6,4,1,1,67,-116,2,1,-106,93,0,1,3,-3,173,-209,2,0
"3433","16",31,4,1,0,0,-182,-77,-1,-1,-121,-82,-3,-3,3,-1,-61,5,2,2
"3434","16",54,3,4,1,1,37,11,1,-2,39,19,0,0,3,0,-2,-8,1,-2
"3435","16",406,7,2,1,2,100,-40,-1,2,65,34,2,0,3,-4,35,-74,-3,2
"3436","16",8,2,3,0,1,22,-29,2,-3,-228,-122,1,0,3,1,250,93,1,-3
"3437","16",177,1,4,1,1,111,140,4,-4,42,185,3,-3,3,2,69,-45,1,-1
"3438","16",359,9,4,1,3,226,36,4,4,233,14,3,3,3,-6,-7,22,1,1
"3439","16",250,6,1,0,3,69,27,1,1,83,23,1,1,3,-3,-14,4,0,0
"3440","16",178,3,1,1,1,-124,4,-2,-2,-2,-4,0,0,3,0,-122,8,-2,-2
"3441","16",316,5,3,1,0,179,-102,0,0,-103,-76,-2,-2,3,-2,282,-26,2,2
"3442","16",251,4,3,1,1,-1,1,2,-1,-1,-170,0,-2,3,-1,0,171,2,1
"3443","16",309,4,4,1,2,101,43,-1,-1,88,33,-1,0,3,-1,13,10,0,-1
"3444","16",389,5,3,1,2,-8,4,0,0,2,1,-1,0,3,-2,-10,3,1,0
"3445","16",99,7,4,1,3,201,16,2,2,4,10,0,0,3,-4,197,6,2,2
"3446","16",333,6,4,1,1,27,7,0,1,17,-72,1,1,3,-3,10,79,-1,0
"3447","16",18,3,3,1,1,-49,-66,0,-2,80,36,1,1,3,0,-129,-102,-1,-3
"3448","16",1,6,1,0,1,-18,-22,-1,1,-10,12,-1,1,3,-3,-8,-34,0,0
"3449","16",354,6,1,1,0,25,30,1,1,128,117,2,2,3,-3,-103,-87,-1,-1
"3450","16",395,7,3,1,1,-91,21,-1,2,225,9,-1,3,3,-4,-316,12,0,-1
"3451","16",315,8,3,1,3,0,0,3,3,227,9,3,2,3,-5,-227,-9,0,1
"3452","16",242,2,4,1,2,-35,3,0,-3,24,1,-1,-3,3,1,-59,2,1,0
"3453","16",80,7,4,1,3,192,-3,2,2,203,-3,2,-2,3,-4,-11,0,0,4
"3454","16",436,2,4,1,3,25,-183,-2,-3,-26,173,4,3,3,1,51,-356,-6,-6
"3455","16",348,5,3,1,1,96,68,-2,0,109,101,0,0,3,-2,-13,-33,-2,0
"3456","16",235,7,3,1,0,143,5,2,2,117,-2,2,2,3,-4,26,7,0,0
"3457","16",7,5,1,0,3,-116,39,-1,0,96,-7,1,-1,3,-2,-212,46,-2,1
"3458","16",101,2,3,1,0,-132,130,-3,-3,227,234,-3,-3,3,1,-359,-104,0,0
"3459","16",252,5,4,0,1,-134,-130,0,0,-109,-152,0,0,3,-2,-25,22,0,0
"3460","16",90,5,4,1,0,-75,12,0,0,-179,16,-1,4,3,-2,104,-4,1,-4
"3461","16",240,4,2,1,1,-98,5,-1,-1,128,-29,1,-1,3,-1,-226,34,-2,0
"3462","16",35,2,1,1,3,30,157,0,-3,124,167,3,-2,3,1,-94,-10,-3,-1
"3463","16",334,1,4,1,0,-225,-131,-4,-4,-226,-98,-4,-4,3,2,1,-33,0,0
"3464","16",55,5,4,1,1,18,5,0,0,19,17,0,0,3,-2,-1,-12,0,0
"3465","16",407,3,2,1,2,-130,-37,-2,-2,110,24,2,2,3,0,-240,-61,-4,-4
"3466","16",355,2,2,1,2,-98,48,-3,-3,-90,36,-3,-3,3,1,-8,12,0,0
"3467","16",69,1,4,1,1,38,181,-3,-4,-59,41,-1,-4,3,2,97,140,-2,0
"3468","16",36,8,3,1,3,136,-152,3,3,95,-169,3,3,3,-5,41,17,0,0
"3469","16",356,3,4,1,1,-96,-10,-1,-2,199,60,2,3,3,0,-295,-70,-3,-5
"3470","16",199,6,4,1,2,83,58,1,1,68,37,1,1,3,-3,15,21,0,0
"3471","16",24,1,2,0,2,-250,229,-4,-4,244,1,4,4,3,2,-494,228,-8,-8
"3472","16",94,5,4,1,1,1,-4,0,0,-109,-121,-3,-3,3,-2,110,117,3,3
"3473","16",393,1,1,0,0,-247,0,-4,-4,-1,-1,-4,-4,3,2,-246,1,0,0
"3474","16",39,4,3,0,1,163,-173,-2,-1,114,-108,1,0,3,-1,49,-65,-3,-1
"3475","16",386,2,1,0,0,-136,-4,-1,-3,11,16,0,-1,3,1,-147,-20,-1,-2
"3476","16",253,7,3,1,3,59,88,2,2,57,72,1,1,3,-4,2,16,1,1
"3477","16",180,1,2,1,2,-121,1,-3,-4,-239,1,-3,1,3,2,118,0,0,-5
"3478","16",10,6,3,1,1,116,-4,1,1,-1,-7,0,0,3,-3,117,3,1,1
"3479","16",350,1,4,1,1,-245,6,-3,-4,-6,-242,3,1,3,2,-239,248,-6,-5
"3480","16",396,1,1,1,1,-204,169,4,-4,-184,140,4,-4,3,2,-20,29,0,0
"3481","16",100,9,4,1,3,243,4,4,4,237,4,4,4,3,-6,6,0,0,0
"3482","16",201,1,3,1,1,40,-1,2,-4,59,-1,1,-3,3,2,-19,0,1,-1
"3483","16",81,2,1,0,0,-48,-108,-3,-3,-247,180,-4,-4,3,1,199,-288,1,1
"3484","16",437,2,1,0,0,-96,2,-3,-3,-67,-4,-1,-1,3,1,-29,6,-2,-2
"3485","16",360,1,3,1,0,-97,-61,-3,-4,90,91,0,-4,3,2,-187,-152,-3,0
"3486","16",357,4,4,1,2,-140,-16,-1,-1,151,55,-1,-1,3,-1,-291,-71,0,0
"3487","16",70,1,2,1,2,-40,38,1,-4,51,64,-1,-4,3,2,-91,-26,2,0
"3488","16",102,5,4,1,3,25,90,-4,0,-83,82,2,0,3,-2,108,8,-6,0
"3489","16",95,4,4,1,2,-141,-6,-1,-1,-116,3,-1,-1,3,-1,-25,-9,0,0
"3490","16",91,5,2,0,3,107,3,0,0,103,-3,1,2,3,-2,4,6,-1,-2
"3491","16",88,6,4,1,2,-27,-38,1,1,199,-164,4,4,3,-3,-226,126,-3,-3
"3492","16",307,2,4,1,2,74,-21,-3,-3,135,70,1,2,3,1,-61,-91,-4,-5
"3493","16",335,3,2,1,1,-106,50,-2,-2,-93,31,0,0,3,0,-13,19,-2,-2
"3494","16",56,4,3,1,1,43,-118,-1,-1,46,-114,-2,0,3,-1,-3,-4,1,-1
"3495","16",408,2,1,0,0,-75,-3,-1,-3,-171,3,-1,-2,3,1,96,-6,0,-1
"3496","16",255,6,3,1,1,119,-50,1,1,-78,-99,0,0,3,-3,197,49,1,1
"3497","16",182,6,4,1,3,-5,-141,2,1,3,-180,2,2,3,-3,-8,39,0,-1
"3498","16",66,6,1,0,1,110,0,1,1,136,3,-1,1,3,-3,-26,-3,2,0
"3499","16",202,4,1,0,1,-81,18,-2,-1,-10,26,2,-1,3,-1,-71,-8,-4,0
"3500","16",2,6,4,1,1,-14,48,1,1,153,0,2,0,3,-3,-167,48,-1,1
"3501","16",87,9,4,1,3,-54,129,3,4,-108,174,3,3,3,-6,54,-45,0,1
"3502","16",237,5,2,0,2,-250,-1,-1,0,49,0,2,1,3,-2,-299,-1,-3,-1
"3503","16",394,1,3,0,0,-246,246,-4,-4,-242,244,-4,-4,3,2,-4,2,0,0
"3504","16",390,6,2,0,2,116,-28,1,1,195,44,4,3,3,-3,-79,-72,-3,-2
"3505","16",387,2,3,1,1,-143,-133,-3,-3,205,191,2,1,3,1,-348,-324,-5,-4
"3506","16",254,4,2,1,3,120,-27,0,-1,97,-34,-2,-1,3,-1,23,7,2,0
"3507","16",181,2,4,1,3,-130,32,-3,-3,174,81,2,-1,3,1,-304,-49,-5,-2
"3508","16",65,7,1,0,3,17,105,2,2,12,18,2,2,3,-4,5,87,0,0
"3509","16",97,2,1,1,1,6,11,3,-3,-229,12,2,-3,3,1,235,-1,1,0
"3510","16",93,6,1,0,1,-106,15,-2,1,-33,-18,-1,0,3,-3,-73,33,-1,1
"3511","16",344,5,4,1,3,45,103,0,0,140,-107,2,2,3,-2,-95,210,-2,-2
"3512","16",236,5,1,0,1,-1,-4,0,0,-42,-34,0,0,3,-2,41,30,0,0
"3513","16",82,9,4,1,2,232,27,4,4,33,220,4,4,3,-6,199,-193,0,0
"3514","16",438,5,4,1,3,82,5,2,0,84,3,4,0,3,-2,-2,2,-2,0
"3515","16",361,2,1,0,0,-246,0,4,-3,2,248,4,4,3,1,-248,-248,0,-7
"3516","16",358,1,4,1,2,-87,69,-3,-4,-216,57,-4,-4,3,2,129,12,1,0
"3517","16",71,4,3,1,1,-63,39,-1,-1,50,27,-1,0,3,-1,-113,12,0,-1
"3518","16",103,6,2,0,3,68,-11,0,1,-187,51,-2,-2,3,-3,255,-62,2,3
"3519","16",96,2,1,0,0,-201,0,-3,-3,-30,-3,-1,-1,3,1,-171,3,-2,-2
"3520","16",92,4,4,1,2,-96,-103,-1,-1,-141,-122,-1,-1,3,-1,45,19,0,0
"3521","16",89,1,3,1,0,-93,4,-1,-4,-244,2,-4,-2,3,2,151,2,3,-2
"3522","16",308,2,4,1,0,-137,-116,-4,-3,93,103,0,1,3,1,-230,-219,-4,-4
"3523","16",336,3,4,1,3,176,152,3,-2,168,139,2,-3,3,0,8,13,1,1
"3524","16",57,1,4,1,1,42,-192,-3,-4,-25,-182,-4,-4,3,2,67,-10,1,0
"3525","16",409,2,4,1,2,-109,-110,-3,-3,111,119,0,2,3,1,-220,-229,-3,-5
"3526","16",256,5,3,0,1,-79,1,0,0,47,5,0,0,3,-2,-126,-4,0,0
"3527","16",183,3,4,1,1,73,62,1,-2,30,154,1,-2,3,0,43,-92,0,0
"3528","16",67,6,1,1,0,85,-89,1,1,155,-132,2,2,3,-3,-70,43,-1,-1
"3529","16",203,9,4,0,3,228,14,4,4,238,13,4,4,3,-6,-10,1,0,0
"3530","16",20,5,3,1,0,-35,-37,-2,0,-179,-176,-3,0,3,-2,144,139,1,0
"3531","16",346,7,3,1,0,-246,-89,-3,2,248,-1,4,4,3,-4,-494,-88,-7,-2
"3532","16",238,2,3,1,1,-6,-3,0,-3,94,-82,1,2,3,1,-100,79,-1,-5
"3533","16",84,8,4,1,3,213,1,3,3,230,3,3,3,3,-5,-17,-2,0,0
"3534","16",391,7,2,1,3,165,204,1,2,114,-73,0,0,3,-4,51,277,1,2
"3535","16",460,4,1,0,0,-177,9,-3,-1,226,87,-2,1,3,-1,-403,-78,-1,-2
"3536","16",165,5,1,1,1,83,77,-1,0,65,51,1,1,3,-2,18,26,-2,-1
"3537","16",230,6,1,0,0,-146,36,-3,1,-125,-11,-3,1,3,-3,-21,47,0,0
"3538","16",105,6,1,1,0,-114,9,-1,1,103,4,1,1,3,-3,-217,5,-2,0
"3539","16",30,6,2,1,2,130,-20,1,1,-110,-2,-1,-2,3,-3,240,-18,2,3
"3540","16",297,2,3,1,2,14,15,1,-3,-46,17,0,-2,3,1,60,-2,1,-1
"3541","16",345,1,1,1,0,-103,99,-4,-4,-3,-87,-1,-3,3,2,-100,186,-3,-1
"3542","16",341,9,1,0,3,247,-30,2,4,246,-28,4,4,3,-6,1,-2,-2,0
"3543","16",83,6,1,1,3,133,-147,2,1,154,-103,2,1,3,-3,-21,-44,0,0
"3544","16",439,5,2,1,1,-8,2,0,0,5,-4,-3,0,3,-2,-13,6,3,0
"3545","16",362,1,4,0,3,-116,134,4,-4,109,96,3,2,3,2,-225,38,1,-6
"3546","16",209,6,4,1,3,24,-103,-2,1,15,234,-1,-1,3,-3,9,-337,-1,2
"3547","16",72,5,1,1,0,21,25,0,0,92,94,2,2,3,-2,-71,-69,-2,-2
"3548","16",104,3,1,1,0,-2,-182,-1,-2,51,0,1,-3,3,0,-53,-182,-2,1
"3549","16",205,5,1,0,2,-6,1,0,0,211,0,3,3,3,-2,-217,1,-3,-3
"3550","16",282,9,3,0,3,166,-50,1,4,178,25,1,4,3,-6,-12,-75,0,0
"3551","16",9,4,4,1,2,37,20,1,-1,32,23,1,-1,3,-1,5,-3,0,0
"3552","16",340,4,1,0,1,-29,-16,0,-1,39,14,0,0,3,-1,-68,-30,0,-1
"3553","16",337,9,2,1,3,235,-25,4,4,238,-21,4,4,3,-6,-3,-4,0,0
"3554","16",58,6,4,1,1,-250,3,1,1,-3,223,4,4,3,-3,-247,-220,-3,-3
"3555","16",41,6,2,1,3,16,64,3,1,15,70,2,1,3,-3,1,-6,1,0
"3556","16",257,1,1,1,0,82,88,2,-4,126,72,2,-4,3,2,-44,16,0,0
"3557","16",184,7,3,1,3,116,-6,2,2,103,-5,0,1,3,-4,13,-1,2,1
"3558","16",68,2,4,1,0,89,-7,0,-3,183,8,-1,-3,3,1,-94,-15,1,0
"3559","16",204,6,3,1,1,106,-54,1,1,-132,-202,0,0,3,-3,238,148,1,1
"3560","16",200,1,3,1,0,116,-24,-3,-4,-223,-49,-4,-4,3,2,339,25,1,0
"3561","16",347,3,1,1,3,128,132,2,-2,122,108,2,3,3,0,6,24,0,-5
"3562","16",239,1,1,0,1,-214,-162,-4,-4,97,107,3,-2,3,2,-311,-269,-7,-2
"3563","16",85,1,2,0,2,-161,102,-3,-4,-132,102,-2,-3,3,2,-29,0,-1,-1
"3564","16",392,2,1,1,0,-208,207,-3,-3,-169,128,-2,-2,3,1,-39,79,-1,-1
"3565","16",461,6,4,1,2,137,48,1,1,55,31,-1,-1,3,-3,82,17,2,2
"3566","16",166,1,4,1,2,-32,-21,-1,-4,195,193,-2,-1,3,2,-227,-214,1,-3
"3567","16",231,5,4,1,0,2,-1,0,0,-2,1,-4,1,3,-2,4,-2,4,-1
"3568","16",106,4,2,1,1,-106,-30,-1,-1,-91,20,-1,-1,3,-1,-15,-50,0,0
"3569","16",300,4,1,0,0,-144,47,-1,-1,53,110,1,2,3,-1,-197,-63,-2,-3
"3570","16",298,4,1,1,0,-106,15,0,-1,2,-242,-1,0,3,-1,-108,257,1,-1
"3571","16",450,5,4,1,3,156,3,1,0,-6,128,0,-1,3,-2,162,-125,1,1
"3572","16",342,3,3,1,1,-30,-20,1,-2,-39,-193,1,-1,3,0,9,173,0,-1
"3573","16",339,6,3,1,1,36,23,1,1,45,47,-1,0,3,-3,-9,-24,2,1
"3574","16",44,1,2,0,2,-250,3,-4,-4,189,52,0,-4,3,2,-439,-49,-4,0
"3575","16",363,8,3,1,3,250,-1,3,3,-248,-1,-3,-3,3,-5,498,0,6,6
"3576","16",21,2,4,1,2,30,31,-2,-3,42,43,-3,-2,3,1,-12,-12,1,-1
"3577","16",73,5,4,1,2,-91,-119,0,0,-109,-130,0,0,3,-2,18,11,0,0
"3578","16",133,1,2,1,1,-86,-246,0,-4,241,18,3,0,3,2,-327,-264,-3,-4
"3579","16",206,3,4,1,0,-96,22,-2,-2,-48,18,-1,2,3,0,-48,4,-1,-4
"3580","16",283,6,1,0,1,-119,38,-3,1,162,99,-2,3,3,-3,-281,-61,-1,-2
"3581","16",45,4,3,1,0,20,-25,2,-1,28,-52,1,-1,3,-1,-8,27,1,0
"3582","16",373,3,3,1,0,-221,-37,1,-2,-224,-44,0,-4,3,0,3,7,1,2
"3583","16",338,2,3,1,2,51,34,-2,-3,247,248,4,-4,3,1,-196,-214,-6,1
"3584","16",59,3,1,1,0,-79,2,-2,-2,83,0,2,2,3,0,-162,2,-4,-4
"3585","16",410,2,1,0,0,-139,-30,1,-3,-133,-13,2,-3,3,1,-6,-17,-1,0
"3586","16",258,2,3,1,0,-4,8,-2,-3,42,4,1,-2,3,1,-46,4,-3,-1
"3587","16",185,6,4,1,2,-67,-8,-2,1,213,-19,-1,2,3,-3,-280,11,-1,-1
"3588","16",132,7,4,1,1,-56,17,1,2,4,84,1,2,3,-4,-60,-67,0,0
"3589","16",302,3,1,1,0,-46,-18,-2,-2,229,232,-4,-2,3,0,-275,-250,2,0
"3590","16",3,1,3,1,0,1,3,1,-4,0,-2,0,-2,3,2,1,5,1,-2
"3591","16",279,6,4,1,3,148,48,1,1,153,59,2,2,3,-3,-5,-11,-1,-1
"3592","16",424,3,2,1,2,-22,-11,-1,-2,145,90,1,-1,3,0,-167,-101,-2,-1
"3593","16",86,8,4,1,3,142,-5,0,3,-1,-119,1,2,3,-5,143,114,-1,1
"3594","16",441,7,4,1,2,26,-169,2,2,19,-85,2,2,3,-4,7,-84,0,0
"3595","16",365,1,3,1,1,-234,6,4,-4,-240,4,4,-4,3,2,6,2,0,0
"3596","16",211,6,3,1,1,-9,-11,-1,1,171,188,-2,2,3,-3,-180,-199,1,-1
"3597","16",305,8,4,1,3,192,15,3,3,205,43,3,3,3,-5,-13,-28,0,0
"3598","16",107,9,2,0,3,9,-11,2,4,-112,53,-2,2,3,-6,121,-64,4,2
"3599","16",301,3,4,1,1,-46,-1,-1,-2,-91,4,-1,-2,3,0,45,-5,0,0
"3600","16",299,4,4,1,1,-205,55,-2,-1,132,114,2,3,3,-1,-337,-59,-4,-4
"3601","16",451,1,1,1,0,-182,-204,-4,-4,-194,-142,-4,-4,3,2,12,-62,0,0
"3602","16",343,6,2,1,2,-25,0,1,1,-18,2,-1,0,3,-3,-7,-2,2,1
"3603","16",34,7,4,1,2,124,-71,2,2,95,-81,2,1,3,-4,29,10,0,1
"3604","16",440,5,3,1,0,-1,1,0,0,-1,-1,0,0,3,-2,0,2,0,0
"3605","16",364,5,3,0,1,-17,-17,0,0,10,8,-1,0,3,-2,-27,-25,1,0
"3606","16",210,4,4,1,2,208,171,3,-1,172,95,3,0,3,-1,36,76,0,-1
"3607","16",74,1,3,1,0,-141,93,-4,-4,-224,221,-4,-4,3,2,83,-128,0,0
"3608","16",134,4,2,1,2,-154,-8,1,-1,-47,-6,0,-1,3,-1,-107,-2,1,0
"3609","16",207,5,1,0,0,-1,0,0,0,243,-2,0,0,3,-2,-244,2,0,0
"3610","16",284,2,3,1,1,-179,-69,-2,-3,-185,-53,-2,-4,3,1,6,-16,0,1
"3611","16",280,7,2,1,1,223,73,-1,2,233,-15,1,0,3,-4,-10,88,-2,2
"3612","16",374,6,4,1,2,37,10,1,1,51,11,1,1,3,-3,-14,-1,0,0
"3613","16",220,1,4,0,2,-231,89,-4,-4,119,86,-2,-2,3,2,-350,3,-2,-2
"3614","16",6,4,4,1,2,-202,0,-1,-1,-245,0,-2,-2,3,-1,43,0,1,1
"3615","16",411,1,2,0,2,-232,-231,-4,-4,-215,-213,-4,-4,3,2,-17,-18,0,0
"3616","16",259,1,3,1,1,-36,18,4,-4,-1,3,4,-4,3,2,-35,15,0,0
"3617","16",186,5,2,0,2,62,60,0,0,70,42,0,0,3,-2,-8,18,0,0
"3618","16",109,2,1,1,1,-16,-2,2,-3,-15,0,3,-3,3,1,-1,-2,-1,0
"3619","16",287,5,4,1,3,108,-10,0,0,-187,-4,-2,-4,3,-2,295,-6,2,4
"3620","16",457,2,3,1,1,-108,89,-2,-3,-124,-1,0,2,3,1,16,90,-2,-5
"3621","16",28,4,4,1,1,-46,-41,-1,-1,15,-61,-1,-1,3,-1,-61,20,0,0
"3622","16",425,6,4,1,2,-12,-14,0,1,0,-13,0,1,3,-3,-12,-1,0,0
"3623","16",22,6,3,1,1,8,-62,1,1,67,14,1,1,3,-3,-59,-76,0,0
"3624","16",442,6,4,1,1,-27,25,-1,1,29,28,1,1,3,-3,-56,-3,-2,0
"3625","16",366,7,4,1,3,192,-50,4,2,193,-72,3,2,3,-4,-1,22,1,0
"3626","16",212,5,1,0,1,-35,9,4,0,-220,24,4,-2,3,-2,185,-15,0,2
"3627","16",306,5,3,1,3,98,140,1,0,115,145,1,0,3,-2,-17,-5,0,0
"3628","16",108,9,2,1,3,227,34,4,4,237,37,4,4,3,-6,-10,-3,0,0
"3629","16",286,6,1,0,3,81,-9,1,1,51,-3,0,1,3,-3,30,-6,1,0
"3630","16",46,1,1,1,0,-202,-244,-4,-4,-112,-247,-4,-2,3,2,-90,3,0,-2
"3631","16",452,5,3,0,1,7,-41,0,0,-7,-83,-1,0,3,-2,14,42,1,0
"3632","16",376,4,4,1,1,85,-13,-1,-1,101,-16,-1,-1,3,-1,-16,3,0,0
"3633","16",420,4,4,1,3,1,1,0,-1,1,43,2,0,3,-1,0,-42,-2,-1
"3634","16",61,1,1,0,3,221,-8,4,-4,222,-53,3,-2,3,2,-1,45,1,-2
"3635","16",413,4,1,0,1,-109,-19,-3,-1,166,-137,1,1,3,-1,-275,118,-4,-2
"3636","16",260,5,3,1,0,2,-4,0,0,-68,-69,-1,-1,3,-2,70,65,1,1
"3637","16",75,3,4,1,2,-19,20,3,-2,226,30,0,-2,3,0,-245,-10,3,0
"3638","16",135,5,1,0,1,-205,-90,0,0,-201,-57,0,0,3,-2,-4,-33,0,0
"3639","16",208,3,4,0,2,-180,-137,-2,-2,209,233,-3,-3,3,0,-389,-370,1,1
"3640","16",285,5,2,0,1,-8,2,0,0,-90,-55,0,0,3,-2,82,57,0,0
"3641","16",281,1,4,1,2,-233,0,-4,-4,-1,-232,-1,0,3,2,-232,232,-3,-4
"3642","16",375,5,3,1,1,0,-1,1,0,12,1,1,0,3,-2,-12,-2,0,0
"3643","16",221,3,4,0,1,49,-9,0,-2,35,1,1,1,3,0,14,-10,-1,-3
"3644","16",60,7,1,0,3,189,-4,2,2,214,4,2,2,3,-4,-25,-8,0,0
"3645","16",412,9,1,0,0,-125,-101,-4,4,131,-47,4,4,3,-6,-256,-54,-8,0
"3646","16",26,1,1,0,0,-198,-97,-4,-4,14,-46,-1,-3,3,2,-212,-51,-3,-1
"3647","16",187,6,4,1,2,55,36,1,1,220,-3,2,3,3,-3,-165,39,-1,-2
"3648","16",11,4,4,1,1,183,-127,1,-1,111,-56,0,-2,3,-1,72,-71,1,1
"3649","16",288,7,2,0,2,-136,72,-2,2,-134,62,-2,-2,3,-4,-2,10,0,4
"3650","16",458,3,1,1,1,2,3,-1,-2,62,83,-1,-2,3,0,-60,-80,0,0
"3651","16",454,4,4,1,3,-122,1,-1,-1,-121,-1,-1,-1,3,-1,-1,2,0,0
"3652","16",426,8,4,1,3,177,-2,3,3,153,2,2,2,3,-5,24,-4,1,1
"3653","16",422,1,3,1,1,-98,-123,1,-4,-92,-108,3,-2,3,2,-6,-15,-2,-2
"3654","16",443,4,1,1,0,-17,-5,-1,-1,74,28,1,1,3,-1,-91,-33,-2,-2
"3655","16",367,5,3,1,1,14,11,1,0,12,9,2,2,3,-2,2,2,-1,-2
"3656","16",213,6,2,1,1,38,0,1,1,-2,-119,-1,0,3,-3,40,119,2,1
"3657","16",140,5,1,1,1,-36,15,1,0,-16,42,0,0,3,-2,-20,-27,1,0
"3658","16",303,3,3,1,2,-142,-118,-2,-2,-195,-147,-3,-3,3,0,53,29,1,1
"3659","16",38,5,4,1,3,14,-8,0,0,27,-35,0,0,3,-2,-13,27,0,0
"3660","16",222,2,1,0,0,-246,-2,-3,-3,-235,-3,-3,-3,3,1,-11,1,0,0
"3661","16",453,6,4,1,2,9,-136,1,1,-153,15,0,-1,3,-3,162,-151,1,2
"3662","16",377,1,1,0,0,-125,5,-4,-4,244,6,4,0,3,2,-369,-1,-8,-4
"3663","16",421,9,3,1,1,10,-7,0,4,45,15,0,3,3,-6,-35,-22,0,1
"3664","16",62,9,2,1,3,-222,166,-4,4,220,216,3,4,3,-6,-442,-50,-7,0
"3665","16",414,6,1,0,0,109,72,1,1,103,86,2,2,3,-3,6,-14,-1,-1
"3666","16",261,9,1,1,3,189,166,4,4,30,-74,4,4,3,-6,159,240,0,0
"3667","16",14,3,3,1,1,-19,1,-1,-2,140,-49,0,1,3,0,-159,50,-1,-3
"3668","16",136,3,1,0,0,-227,136,-3,-2,148,-112,-3,-2,3,0,-375,248,0,0
"3669","16",427,1,4,1,1,-216,-46,4,-4,-230,-80,4,-4,3,2,14,34,0,0
"3670","16",423,4,1,0,3,100,-12,4,-1,129,-1,1,0,3,-1,-29,-11,3,-1
"3671","16",456,2,1,1,0,-130,-3,0,-3,-48,4,1,-3,3,1,-82,-7,-1,0
"3672","16",368,9,3,1,3,-127,148,4,4,-129,126,4,4,3,-6,2,22,0,0
"3673","16",214,9,1,0,3,158,-154,4,4,161,-158,4,4,3,-6,-3,4,0,0
"3674","16",445,6,4,1,3,89,-61,1,1,116,-115,1,1,3,-3,-27,54,0,0
"3675","16",369,4,4,1,0,-76,-1,-1,-1,55,1,1,0,3,-1,-131,-2,-2,-1
"3676","16",215,2,1,1,0,-166,25,-2,-3,-144,33,-2,-3,3,1,-22,-8,0,0
"3677","16",188,9,2,1,3,229,0,3,4,239,1,4,4,3,-6,-10,-1,-1,0
"3678","16",110,6,1,1,1,-102,-136,-2,1,90,148,3,3,3,-3,-192,-284,-5,-2
"3679","16",289,8,1,1,3,0,0,3,3,230,-5,3,3,3,-5,-230,5,0,0
"3680","16",459,7,3,1,1,-49,-109,4,2,41,-85,2,-4,3,-4,-90,-24,2,6
"3681","16",455,2,2,1,2,-233,-6,-3,-3,247,-1,1,4,3,1,-480,-5,-4,-7
"3682","16",415,5,2,1,2,3,-1,0,0,171,196,0,1,3,-2,-168,-197,0,-1
"3683","16",262,6,4,1,3,91,33,0,1,107,76,1,1,3,-3,-16,-43,-1,0
"3684","16",444,1,2,0,2,-206,-1,-3,-4,-208,99,-3,-4,3,2,2,-100,0,0
"3685","16",137,2,1,0,1,-231,236,-4,-3,204,213,-4,-1,3,1,-435,23,0,-2
"3686","16",383,1,4,1,1,-4,3,0,-4,-1,4,0,0,3,2,-3,-1,0,-4
"3687","16",141,5,1,0,0,-61,41,-2,0,129,12,0,0,3,-2,-190,29,-2,0
"3688","16",304,4,2,1,2,-80,-24,-1,-1,94,-22,1,1,3,-1,-174,-2,-2,-2
"3689","16",380,2,4,1,1,65,-40,3,-3,-185,-37,3,-4,3,1,250,-3,0,1
"3690","16",223,5,1,1,1,33,0,0,0,-3,-1,0,0,3,-2,36,1,0,0
"3691","16",385,4,4,1,1,-26,69,-1,-1,-56,-159,0,1,3,-1,30,228,-1,-2
"3692","16",378,3,4,1,1,-155,-1,-2,-2,-177,1,-2,-2,3,0,22,-2,0,0
"3693","16",224,4,2,1,2,-42,-15,-1,-1,174,71,2,1,3,-1,-216,-86,-3,-2
"3694","16",63,5,4,1,1,-5,-4,0,0,3,-1,2,1,3,-2,-8,-3,-2,-1
"3695","16",111,6,1,1,0,-72,-47,-2,1,-9,14,-1,-2,3,-3,-63,-61,-1,3
"3696","16",379,3,3,1,1,-5,-105,1,-2,33,21,1,0,3,0,-38,-126,0,-2
"3697","16",19,7,2,1,2,70,33,1,2,82,-39,-2,-2,3,-4,-12,72,3,4
"3698","16",64,1,1,1,1,-231,75,-3,-4,176,-33,-2,-1,3,2,-407,108,-1,-3
"3699","16",416,1,4,1,0,-202,103,-4,-4,-199,202,-4,-4,3,2,-3,-99,0,0
"3700","16",275,3,4,1,2,247,-1,2,-2,228,4,2,-1,3,0,19,-5,0,-1
"3701","16",384,2,1,0,0,-205,1,-3,-3,0,137,-2,-2,3,1,-205,-136,-1,-1
"3702","16",417,4,2,1,2,0,0,-1,-1,-79,-71,-2,-4,3,-1,79,71,1,3
"3703","16",264,1,4,1,2,-59,-49,-3,-4,-18,14,-2,-3,3,2,-41,-63,-1,-1
"3704","16",446,5,4,0,1,19,6,3,0,57,3,0,0,3,-2,-38,3,3,0
"3705","16",37,1,1,1,0,-133,15,-3,-4,-199,28,-4,-4,3,2,66,-13,1,0
"3706","16",216,6,3,1,1,-25,-8,1,1,-21,1,1,0,3,-3,-4,-9,0,1
"3707","16",189,2,1,1,1,-211,33,3,-3,-198,41,2,-3,3,1,-13,-8,1,0
"3708","16",447,6,4,1,2,120,14,-1,1,82,50,2,2,3,-3,38,-36,-3,-1
"3709","16",370,9,1,0,3,231,40,4,4,226,-24,-2,-4,3,-6,5,64,6,8
"3710","16",225,5,2,1,2,34,-39,1,0,51,-146,2,1,3,-2,-17,107,-1,-1
"3711","16",144,1,3,0,0,-233,-11,-3,-4,217,5,0,0,3,2,-450,-16,-3,-4
"3712","16",112,8,4,1,3,5,-243,2,3,14,244,4,2,3,-5,-9,-487,-2,1
"3713","16",263,2,4,1,0,-178,-9,-3,-3,-172,1,-3,-2,3,1,-6,-10,0,-1
"3714","16",271,4,3,1,1,-79,-2,-1,-1,217,-2,3,3,3,-1,-296,0,-4,-4
"3715","16",138,6,3,1,1,129,-150,1,1,16,-15,-1,-1,3,-3,113,-135,2,2
"3716","16",372,2,3,1,0,-215,-221,-3,-3,-86,-143,-3,-3,3,1,-129,-78,0,0
"3717","16",142,4,2,1,2,-15,3,-4,-1,1,-18,-4,0,3,-1,-16,21,0,-1
"3718","16",139,1,4,1,2,-249,-3,-4,-4,-242,-2,-4,-4,3,2,-7,-1,0,0
"3719","16",381,1,2,0,2,-233,-9,-4,-4,228,246,0,0,3,2,-461,-255,-4,-4
"3720","16",277,1,4,0,1,-80,88,4,-4,-25,-78,3,-4,3,2,-55,166,1,0
"3721","16",143,4,1,1,3,-14,26,-1,-1,62,-13,3,3,3,-1,-76,39,-4,-4
"3722","16",29,1,4,1,0,-246,73,-4,-4,147,153,0,-1,3,2,-393,-80,-4,-3
"3723","16",217,2,4,1,2,-47,21,-1,-3,-30,25,-1,-3,3,1,-17,-4,0,0
"3724","16",278,1,4,1,1,-129,-219,4,-4,-235,-234,4,-4,3,2,106,15,0,0
"3725","16",448,6,2,1,2,13,-2,1,1,1,-17,4,4,3,-3,12,15,-3,-3
"3726","16",371,3,3,1,0,59,-159,-1,-2,212,24,-3,2,3,0,-153,-183,2,-4
"3727","16",190,7,4,1,3,202,95,2,2,169,-164,2,2,3,-4,33,259,0,0
"3728","16",449,6,4,1,3,89,79,2,1,22,86,1,1,3,-3,67,-7,1,0
"3729","16",113,8,2,1,2,0,0,2,3,-119,56,-1,0,3,-5,119,-56,3,3
"3730","16",276,7,4,1,3,185,3,2,2,184,4,2,2,3,-4,1,-1,0,0
"3731","16",272,5,4,1,2,45,38,0,0,56,33,0,1,3,-2,-11,5,0,-1
"3732","16",418,6,2,1,2,47,-12,1,1,39,15,-1,-1,3,-3,8,-27,2,2
"3733","16",265,4,1,1,3,-20,-1,-2,-1,0,0,0,0,3,-1,-20,-1,-2,-1
"3734","16",228,7,4,1,2,-181,60,2,2,72,123,3,4,3,-4,-253,-63,-1,-2
"3735","16",273,5,1,1,0,-1,1,0,0,175,66,1,0,3,-2,-176,-65,-1,0
"3736","16",382,5,4,1,2,9,-12,1,0,141,12,1,1,3,-2,-132,-24,0,-1
"3737","16",266,4,1,1,1,-75,5,-1,-1,-104,0,-1,-1,3,-1,29,5,0,0
"3738","16",193,1,1,0,0,187,109,-4,-4,216,169,1,1,3,2,-29,-60,-5,-5
"3739","16",290,4,1,0,1,93,-67,0,-1,64,-55,0,-2,3,-1,29,-12,0,1
"3740","16",226,1,1,0,0,-51,2,-2,-4,111,4,2,-3,3,2,-162,-2,-4,-1
"3741","16",145,1,1,1,1,-198,-162,-4,-4,-245,-143,-3,-3,3,2,47,-19,-1,-1
"3742","16",157,2,3,1,2,-115,0,-3,-3,-16,2,-3,-4,3,1,-99,-2,0,1
"3743","16",219,5,4,1,3,-1,249,4,0,249,2,4,0,3,-2,-250,247,0,0
"3744","16",191,2,1,0,0,-213,-36,-2,-3,-168,-66,-2,-2,3,1,-45,30,0,-1
"3745","16",114,2,4,1,1,35,46,1,-3,137,160,1,-3,3,1,-102,-114,0,0
"3746","16",13,3,4,1,1,41,-92,0,-2,19,-72,0,-2,3,0,22,-20,0,0
"3747","16",150,5,3,1,1,-9,0,0,0,64,9,0,0,3,-2,-73,-9,0,0
"3748","16",192,4,4,1,1,-76,1,-1,-1,0,72,1,2,3,-1,-76,-71,-2,-3
"3749","16",419,6,4,1,3,147,114,1,1,154,117,1,1,3,-3,-7,-3,0,0
"3750","16",130,9,1,0,3,181,76,4,4,145,28,4,4,3,-6,36,48,0,0
"3751","16",229,6,1,1,1,59,68,-1,1,33,-49,2,2,3,-3,26,117,-3,-1
"3752","16",274,5,4,1,2,-17,-143,0,0,49,-127,2,2,3,-2,-66,-16,-2,-2
"3753","16",218,8,4,1,3,-167,-18,4,3,-109,14,4,3,3,-5,-58,-32,0,0
"3754","16",23,9,1,0,3,-198,-208,4,4,209,205,4,4,3,-6,-407,-413,0,0
"3755","16",194,8,1,1,0,-162,11,-4,3,-187,11,-4,3,3,-5,25,0,0,0
"3756","16",129,3,4,1,1,-198,-4,-2,-2,-214,8,-2,-2,3,0,16,-12,0,0
"3757","16",227,4,3,1,3,84,33,0,-1,158,-4,1,-1,3,-1,-74,37,-1,0
"3758","16",154,5,4,1,3,31,-39,0,0,82,208,0,0,3,-2,-51,-247,0,0
"3759","16",292,1,3,1,1,-184,-4,-4,-4,-6,-30,0,0,3,2,-178,26,-4,-4
"3760","16",118,5,3,1,1,-46,-67,-1,0,-27,-20,-1,0,3,-2,-19,-47,0,0
"3761","16",162,8,3,1,3,91,125,-1,3,150,153,3,4,3,-5,-59,-28,-4,-1
"3762","16",115,6,3,1,3,97,1,1,1,111,-8,1,0,3,-3,-14,9,0,1
"3763","16",293,1,4,1,0,-217,20,-4,-4,-11,-234,-4,-4,3,2,-206,254,0,0
"3764","16",151,1,2,0,1,-235,7,0,-4,-243,5,0,-4,3,2,8,2,0,0
"3765","16",148,4,1,1,1,-5,-66,3,-1,-108,-82,2,-4,3,-1,103,16,1,3
"3766","16",42,3,3,1,1,3,-33,2,-2,-2,12,2,-2,3,0,5,-45,0,0
"3767","16",267,4,3,0,1,6,0,-1,-1,38,-16,1,0,3,-1,-32,16,-2,-1
"3768","16",164,7,2,1,2,51,23,2,2,-1,-220,-3,-3,3,-4,52,243,5,5
"3769","16",291,4,4,1,2,30,35,-2,-1,0,-16,-3,-3,3,-1,30,51,1,2
"3770","16",268,8,4,1,3,172,116,3,3,119,-124,2,2,3,-5,53,240,1,1
"3771","16",146,2,2,0,0,-171,-199,-3,-3,-171,-158,-3,-3,3,1,0,-41,0,0
"3772","16",158,5,3,1,0,-44,-212,2,0,-74,-218,0,0,3,-2,30,6,2,0
"3773","16",15,8,4,1,3,-49,70,2,3,34,108,-1,-2,3,-5,-83,-38,3,5
"3774","16",269,1,4,1,2,-250,89,-4,-4,-248,91,-4,-4,3,2,-2,-2,0,0
"3775","16",155,5,2,1,1,-118,-154,0,0,-13,-14,0,0,3,-2,-105,-140,0,0
"3776","16",159,4,3,1,2,244,0,1,-1,227,11,3,3,3,-1,17,-11,-2,-4
"3777","16",119,6,3,1,3,105,-61,2,1,85,129,1,1,3,-3,20,-190,1,0
"3778","16",163,6,3,0,1,-101,7,-1,1,50,127,2,1,3,-3,-151,-120,-3,0
"3779","16",116,4,2,1,3,43,-15,1,-1,60,-12,1,1,3,-1,-17,-3,0,-2
"3780","16",131,8,4,1,3,109,14,1,3,65,-12,0,3,3,-5,44,26,1,0
"3781","16",152,4,1,1,0,-2,-11,0,-1,-2,-6,0,0,3,-1,0,-5,0,-1
"3782","16",160,7,2,0,0,-213,-1,-4,2,-217,6,-4,2,3,-4,4,-7,0,0
"3783","16",117,3,4,1,2,51,2,-1,-2,-239,-1,-3,-4,3,0,290,3,2,2
"3784","16",161,1,2,0,2,-208,34,2,-4,56,53,1,-3,3,2,-264,-19,1,-1
"3785","16",195,3,1,1,1,-158,117,2,-2,-112,101,3,-3,3,0,-46,16,-1,1
"3786","16",124,8,1,0,3,249,49,3,3,185,-250,4,0,3,-5,64,299,-1,3
"3787","16",296,6,1,0,3,135,2,1,1,196,4,2,2,3,-3,-61,-2,-1,-1
"3788","16",147,1,2,1,3,82,-34,-3,-4,156,81,2,2,3,2,-74,-115,-5,-6
"3789","16",196,3,3,1,0,-8,-205,-2,-2,214,225,3,3,3,0,-222,-430,-5,-5
"3790","16",126,4,2,1,2,22,23,-1,-1,-226,-238,-2,-2,3,-1,248,261,1,1
"3791","16",27,4,2,0,2,-48,72,-1,-1,-35,-14,0,0,3,-1,-13,86,-1,-1
"3792","16",156,4,2,0,1,-59,0,-1,-1,43,2,1,1,3,-1,-102,-2,-2,-2
"3793","16",294,5,1,0,3,10,2,0,0,122,6,2,2,3,-2,-112,-4,-2,-2
"3794","16",12,9,4,1,3,-1,0,4,4,-3,0,4,4,3,-6,2,0,0,0
"3795","16",149,6,3,1,1,0,-1,-3,1,245,4,-3,1,3,-3,-245,-5,0,0
"3796","16",198,4,1,0,1,-104,64,0,-1,-83,-116,-1,-2,3,-1,-21,180,1,1
"3797","16",153,5,1,1,3,-2,2,1,0,-124,-52,1,1,3,-2,122,54,0,-1
"3798","16",120,7,3,0,1,61,-78,2,2,104,75,1,1,3,-4,-43,-153,1,1
"3799","16",127,2,1,1,0,88,43,2,-3,58,87,2,-3,3,1,30,-44,0,0
"3800","16",125,3,4,1,0,80,-47,-3,-2,-27,-18,-3,0,3,0,107,-29,0,-2
"3801","16",121,1,1,0,0,-173,-22,-4,-4,234,-146,0,-4,3,2,-407,124,-4,0
"3802","16",16,2,1,0,0,-214,10,-2,-3,230,22,2,1,3,1,-444,-12,-4,-4
"3803","16",128,7,1,0,3,176,-14,2,2,196,-46,2,2,3,-4,-20,32,0,0
"3804","16",122,1,1,0,0,-187,-179,-4,-4,216,208,4,4,3,2,-403,-387,-8,-8
"3805","16",197,2,4,1,3,-196,-135,2,-3,-245,-9,3,-2,3,1,49,-126,-1,-1
"3806","16",295,5,1,0,1,1,-2,0,0,-3,5,0,0,3,-2,4,-7,0,0
"3807","16",270,5,3,1,1,55,3,1,0,62,7,1,-1,3,-2,-7,-4,0,1
"3808","16",123,3,4,1,2,-163,31,-3,-2,-152,44,-3,-3,3,0,-11,-13,0,1
"3809","17",397,7,4,1,3,190,-81,0,2,-161,-136,-2,1,2,-5,351,55,2,1
"3810","17",398,4,4,0,2,-46,-32,-1,-1,43,32,1,1,2,-2,-89,-64,-2,-2
"3811","17",244,2,4,1,2,-79,-158,-1,-3,56,-54,1,1,2,0,-135,-104,-2,-4
"3812","17",242,2,4,1,2,22,0,-1,-3,-33,4,0,-3,2,0,55,-4,-1,0
"3813","17",241,1,4,0,2,-145,-75,-2,-4,189,175,2,0,2,1,-334,-250,-4,-4
"3814","17",247,3,3,1,0,-196,-8,-2,-2,224,-3,2,2,2,-1,-420,-5,-4,-4
"3815","17",245,1,1,0,0,-217,-2,-3,-4,-151,-23,-3,-4,2,1,-66,21,0,0
"3816","17",400,2,4,0,2,-119,48,-2,-3,40,21,1,2,2,0,-159,27,-3,-5
"3817","17",243,2,2,0,2,-241,124,-4,-3,218,246,-2,-1,2,0,-459,-122,-2,-2
"3818","17",251,2,3,0,1,-49,-49,-3,-3,0,-4,2,0,2,0,-49,-45,-5,-3
"3819","17",246,7,4,1,3,134,-6,2,2,2,-130,2,3,2,-5,132,124,0,-1
"3820","17",401,5,2,0,1,-48,1,2,0,148,56,1,-2,2,-3,-196,-55,1,2
"3821","17",248,2,4,1,3,-140,-13,-2,-3,-13,65,0,-1,2,0,-127,-78,-2,-2
"3822","17",252,4,4,0,1,-106,-144,-1,-1,-169,-113,0,0,2,-2,63,-31,-1,-1
"3823","17",47,7,4,1,3,103,1,1,2,77,-1,0,1,2,-5,26,2,1,1
"3824","17",402,1,3,1,0,-218,-2,-4,-4,79,-1,1,-3,2,1,-297,-1,-5,-1
"3825","17",25,4,4,1,2,-55,-69,0,-1,-4,-4,-2,-2,2,-2,-51,-65,2,1
"3826","17",40,7,1,0,2,125,-182,2,2,154,63,2,2,2,-5,-29,-245,0,0
"3827","17",403,1,1,0,0,-243,-12,-2,-4,-11,-23,-2,-3,2,1,-232,11,0,-1
"3828","17",250,6,1,0,3,85,22,1,1,92,22,1,1,2,-4,-7,0,0,0
"3829","17",473,4,3,0,0,-15,8,-1,-1,-28,-8,-1,-1,2,-2,13,16,0,0
"3830","17",404,5,1,0,1,148,-98,0,0,40,-42,1,0,2,-3,108,-56,-1,0
"3831","17",408,4,1,0,0,-114,-103,-2,-1,-133,-6,0,-1,2,-2,19,-97,-2,0
"3832","17",399,6,4,1,3,133,58,1,1,123,17,1,1,2,-4,10,41,0,0
"3833","17",467,5,1,0,3,-48,-90,4,0,84,71,4,0,2,-3,-132,-161,0,0
"3834","17",249,1,3,1,0,-227,-128,-3,-4,-234,-236,-3,-4,2,1,7,108,0,0
"3835","17",409,4,4,1,2,-90,-82,-3,-1,113,114,2,2,2,-2,-203,-196,-5,-3
"3836","17",4,5,3,0,1,0,4,0,0,231,198,2,4,2,-3,-231,-194,-2,-4
"3837","17",468,7,1,0,3,67,7,1,2,108,47,1,0,2,-5,-41,-40,0,2
"3838","17",406,4,2,0,2,-197,-153,2,-1,188,175,-2,1,2,-2,-385,-328,4,-2
"3839","17",472,1,1,0,0,-185,11,-4,-4,-75,8,-4,-4,2,1,-110,3,0,0
"3840","17",476,5,3,1,0,84,75,0,0,160,-87,1,1,2,-3,-76,162,-1,-1
"3841","17",407,1,2,0,2,-205,129,-4,-4,94,65,3,3,2,1,-299,64,-7,-7
"3842","17",254,6,2,0,3,16,-8,2,1,133,-176,-4,-1,2,-4,-117,168,6,2
"3843","17",466,2,3,1,0,-116,77,-3,-3,-62,-83,-2,-2,2,0,-54,160,-1,-1
"3844","17",100,8,4,0,3,189,9,3,3,3,198,3,3,2,-6,186,-189,0,0
"3845","17",470,4,1,0,1,-71,36,-1,-1,-148,32,-2,-2,2,-2,77,4,1,1
"3846","17",474,1,1,0,0,2,-71,0,-4,3,-77,0,-4,2,1,-1,6,0,0
"3847","17",405,2,4,1,1,-137,136,-3,-3,87,-70,-1,-1,2,0,-224,206,-2,-2
"3848","17",105,6,1,1,0,-90,1,-2,1,-44,1,-1,1,2,-4,-46,0,-1,0
"3849","17",471,4,3,0,2,-105,99,-1,-1,-35,-108,0,0,2,-2,-70,207,-1,-1
"3850","17",475,5,3,1,3,133,-58,1,0,-76,231,0,0,2,-3,209,-289,1,0
"3851","17",102,5,4,1,3,-103,-80,1,0,46,-80,1,2,2,-3,-149,0,0,-2
"3852","17",253,5,3,0,3,3,2,0,0,22,43,1,1,2,-3,-19,-41,-1,-1
"3853","17",257,1,1,0,0,-221,45,-1,-4,105,106,1,-4,2,1,-326,-61,-2,0
"3854","17",469,1,4,1,0,-37,2,-2,-4,122,59,-3,-4,2,1,-159,-57,1,0
"3855","17",410,1,1,0,0,-209,-10,2,-4,-180,-9,1,0,2,1,-29,-1,1,-4
"3856","17",48,1,3,0,0,-1,0,-4,-4,74,-82,-4,-4,2,1,-75,82,0,0
"3857","17",69,4,4,1,1,152,78,0,-1,-168,-17,-1,-4,2,-2,320,95,1,3
"3858","17",255,1,3,0,1,-108,-96,-4,-4,18,-52,0,0,2,1,-126,-44,-4,-4
"3859","17",73,4,4,1,2,-48,-41,0,-1,-60,-39,0,0,2,-2,12,-2,0,-1
"3860","17",101,1,3,0,0,-245,243,-4,-4,232,233,-4,-4,2,1,-477,10,0,0
"3861","17",393,1,1,0,0,-1,-1,-4,-4,-248,-2,-4,-4,2,1,247,1,0,0
"3862","17",256,5,3,1,1,-34,3,0,0,27,28,0,0,2,-3,-61,-25,0,0
"3863","17",74,3,3,1,0,-225,207,-4,-2,239,238,4,4,2,-1,-464,-31,-8,-6
"3864","17",394,1,3,1,0,-242,246,-4,-4,-245,248,-4,-4,2,1,3,-2,0,0
"3865","17",41,6,2,0,3,12,70,3,1,15,72,3,1,2,-4,-3,-2,0,0
"3866","17",464,3,1,0,1,-233,59,1,-2,-124,5,0,-1,2,-1,-109,54,1,-1
"3867","17",50,3,2,0,1,-1,2,0,-2,161,1,2,-2,2,-1,-162,1,-2,0
"3868","17",103,4,2,0,3,125,6,1,-1,159,-4,2,2,2,-2,-34,10,-1,-3
"3869","17",72,5,1,0,0,13,11,0,0,93,99,2,2,2,-3,-80,-88,-2,-2
"3870","17",258,1,3,1,0,80,6,-2,-4,65,7,2,-2,2,1,15,-1,-4,-2
"3871","17",98,1,3,1,0,-235,53,-2,-4,213,-187,3,4,2,1,-448,240,-5,-8
"3872","17",411,1,2,0,2,-239,-231,-4,-4,-194,-235,-4,-4,2,1,-45,4,0,0
"3873","17",49,1,4,1,1,-133,-28,-3,-4,-156,-80,-2,-2,2,1,23,52,-1,-2
"3874","17",7,4,1,1,3,131,47,2,-1,5,38,0,1,2,-2,126,9,2,-2
"3875","17",99,7,4,1,3,243,-13,2,2,216,-22,2,2,2,-5,27,9,0,0
"3876","17",320,1,2,0,2,-249,127,-4,-4,-247,140,-4,-4,2,1,-2,-13,0,0
"3877","17",5,1,2,0,2,-244,221,-3,-4,-241,201,-2,-4,2,1,-3,20,-1,0
"3878","17",106,4,2,0,1,-67,-73,1,-1,-33,-56,0,0,2,-2,-34,-17,1,-1
"3879","17",390,3,2,1,2,-40,-46,-2,-2,238,176,4,4,2,-1,-278,-222,-6,-6
"3880","17",75,7,4,0,2,168,43,2,2,237,195,3,2,2,-5,-69,-152,-1,0
"3881","17",169,1,3,1,0,-245,213,-4,-4,-223,167,-4,-4,2,1,-22,46,0,0
"3882","17",233,4,2,0,2,-226,71,-1,-1,18,21,0,0,2,-2,-244,50,-1,-1
"3883","17",465,9,4,0,3,214,14,3,4,41,-229,3,3,2,-7,173,243,0,1
"3884","17",104,2,1,0,0,-235,2,-3,-3,-78,-1,-3,-3,2,0,-157,3,0,0
"3885","17",65,7,1,0,3,51,103,2,2,35,28,2,2,2,-5,16,75,0,0
"3886","17",259,1,3,1,1,-67,33,4,-4,1,0,4,-4,2,1,-68,33,0,0
"3887","17",462,9,3,1,3,227,103,4,4,205,181,4,4,2,-7,22,-78,0,0
"3888","17",66,2,1,1,1,50,0,-1,-3,-125,-2,1,-1,2,0,175,2,-2,-2
"3889","17",39,3,3,0,1,-228,-4,-2,-2,170,193,3,2,2,-1,-398,-197,-5,-4
"3890","17",463,9,4,1,3,184,-8,4,4,16,-12,1,2,2,-7,168,4,3,2
"3891","17",171,5,1,1,1,25,17,0,0,17,26,1,0,2,-3,8,-9,-1,0
"3892","17",232,1,1,0,0,-250,-216,-4,-4,-179,-93,0,-4,2,1,-71,-123,-4,0
"3893","17",321,2,1,0,0,-218,-214,-3,-3,-221,-116,-2,-2,2,0,3,-98,-1,-1
"3894","17",71,4,3,1,1,-59,25,-1,-1,26,12,-1,0,2,-2,-85,13,0,-1
"3895","17",107,2,2,0,3,21,-38,2,-3,-226,28,-2,1,2,0,247,-66,4,-4
"3896","17",391,5,2,0,3,203,213,0,0,130,-117,0,0,2,-3,73,330,0,0
"3897","17",51,4,4,1,1,-2,-171,-2,-1,-87,-69,2,-1,2,-2,85,-102,-4,0
"3898","17",17,1,3,0,0,-118,24,-2,-4,87,92,-1,-4,2,1,-205,-68,-1,0
"3899","17",32,5,1,0,1,-1,0,0,0,182,-152,2,-4,2,-3,-183,152,-2,4
"3900","17",165,4,1,0,1,-170,6,-1,-1,78,57,1,1,2,-2,-248,-51,-2,-2
"3901","17",170,1,2,0,0,-240,-240,-4,-4,13,12,0,0,2,1,-253,-252,-4,-4
"3902","17",412,7,1,0,0,-231,-21,-4,2,-165,1,4,4,2,-5,-66,-22,-8,-2
"3903","17",26,2,1,0,0,-208,-127,-3,-3,-111,-95,-3,-4,2,0,-97,-32,0,1
"3904","17",70,1,2,0,2,-218,-33,4,-4,38,201,-1,-3,2,1,-256,-234,5,-1
"3905","17",67,2,1,0,0,-232,20,-4,-3,195,-217,4,2,2,0,-427,237,-8,-5
"3906","17",168,7,1,0,3,137,-80,1,2,54,67,-1,0,2,-5,83,-147,2,2
"3907","17",318,1,2,0,2,-185,-194,-4,-4,191,53,-4,0,2,1,-376,-247,0,-4
"3908","17",172,9,2,0,3,-219,214,3,4,-143,131,-2,4,2,-7,-76,83,5,0
"3909","17",76,7,4,0,3,122,-1,1,2,72,-2,3,3,2,-5,50,1,-2,-1
"3910","17",209,7,4,1,3,159,-7,2,2,26,154,2,2,2,-5,133,-161,0,0
"3911","17",431,3,3,0,0,-207,3,-3,-2,55,55,-1,-1,2,-1,-262,-52,-2,-1
"3912","17",234,4,3,0,3,93,44,0,-1,117,39,1,0,2,-2,-24,5,-1,-1
"3913","17",323,5,4,0,1,-1,-53,0,0,-2,-228,-4,-4,2,-3,1,175,4,4
"3914","17",52,2,3,0,0,-214,1,-3,-3,-55,3,0,-2,2,0,-159,-2,-3,-1
"3915","17",109,1,1,0,1,0,-8,3,-4,0,-4,4,-4,2,1,0,-4,-1,0
"3916","17",324,2,2,0,0,-193,1,-3,-3,-7,1,-4,-4,2,0,-186,0,1,1
"3917","17",175,4,4,1,1,-84,-10,-2,-1,-44,-79,-1,-2,2,-2,-40,69,-1,1
"3918","17",90,5,4,1,0,-230,14,0,0,150,11,2,2,2,-3,-380,3,-2,-2
"3919","17",413,4,1,0,1,-67,-10,-1,-1,224,6,-3,-3,2,-2,-291,-16,2,2
"3920","17",260,5,3,1,0,0,3,0,0,-1,-1,0,0,2,-3,1,4,0,0
"3921","17",54,9,4,0,1,-236,-17,2,4,43,34,-1,1,2,-7,-279,-51,3,3
"3922","17",68,1,4,1,0,41,4,-3,-4,192,2,1,-3,2,1,-151,2,-4,-1
"3923","17",322,4,4,1,3,-61,55,-1,-1,234,-225,4,4,2,-2,-295,280,-5,-5
"3924","17",319,4,1,0,1,75,-89,-1,-1,41,-63,-1,0,2,-2,34,-26,0,-1
"3925","17",108,9,2,0,3,214,29,4,4,214,40,4,4,2,-7,0,-11,0,0
"3926","17",392,3,1,0,0,-144,49,-1,-2,-234,214,-2,-2,2,-1,90,-165,1,0
"3927","17",174,5,4,1,3,170,97,1,0,161,59,0,1,2,-3,9,38,1,-1
"3928","17",93,6,1,0,1,-164,51,-1,1,-45,-15,-1,1,2,-4,-119,66,0,0
"3929","17",167,3,1,0,3,-114,-177,-3,-2,-129,-90,-1,-1,2,-1,15,-87,-2,-1
"3930","17",166,1,4,1,2,-71,-45,-1,-4,172,187,-2,1,2,1,-243,-232,1,-5
"3931","17",53,7,4,1,3,195,3,2,2,168,1,1,1,2,-5,27,2,1,1
"3932","17",11,3,4,1,1,148,-88,1,-2,145,-138,2,1,2,-1,3,50,-1,-3
"3933","17",325,9,1,0,1,-16,-11,0,4,8,7,0,4,2,-7,-24,-18,0,0
"3934","17",176,8,1,0,1,-215,49,-4,3,192,50,-3,-2,2,-6,-407,-1,-1,5
"3935","17",91,5,2,0,3,149,-1,1,0,64,-9,1,2,2,-3,85,8,0,-2
"3936","17",395,4,3,1,1,-137,25,-1,-1,197,25,-1,2,2,-2,-334,0,0,-3
"3937","17",388,4,4,1,0,-224,12,-4,-1,-233,2,1,-1,2,-2,9,10,-5,0
"3938","17",173,7,4,1,3,171,10,2,2,168,-1,0,1,2,-5,3,11,2,1
"3939","17",77,5,3,0,1,-44,-1,0,0,1,-51,-1,-1,2,-3,-45,50,1,1
"3940","17",21,2,4,0,2,-36,-23,-1,-3,42,35,-1,-3,2,0,-78,-58,0,0
"3941","17",432,3,2,1,1,-135,-4,-2,-2,42,-44,0,0,2,-1,-177,40,-2,-2
"3942","17",235,5,3,1,0,4,1,0,0,114,0,2,2,2,-3,-110,1,-2,-2
"3943","17",328,4,3,1,1,-14,19,0,-1,16,18,1,1,2,-2,-30,1,-1,-2
"3944","17",179,5,1,1,1,-4,2,0,0,3,1,0,0,2,-3,-7,1,0,0
"3945","17",94,3,4,1,1,-4,-3,-2,-2,55,-46,-1,2,2,-1,-59,43,-1,-4
"3946","17",297,6,3,1,2,28,23,1,1,-18,20,1,-1,2,-4,46,3,0,2
"3947","17",237,4,2,0,2,-246,62,-3,-1,24,-1,-1,1,2,-2,-270,63,-2,-2
"3948","17",387,2,3,1,1,-148,-180,-3,-3,34,40,1,2,2,0,-182,-220,-4,-5
"3949","17",414,5,1,0,0,-5,-7,0,0,121,121,2,2,2,-3,-126,-128,-2,-2
"3950","17",261,9,1,0,3,210,207,4,4,193,185,4,4,2,-7,17,22,0,0
"3951","17",55,5,4,1,1,-13,-4,0,0,-2,-5,0,0,2,-3,-11,1,0,0
"3952","17",428,3,1,0,0,-116,-9,-2,-2,128,111,1,-2,2,-1,-244,-120,-3,0
"3953","17",327,5,4,1,3,32,-201,2,0,118,0,2,-1,2,-3,-86,-201,0,1
"3954","17",178,5,1,0,1,-2,3,0,0,71,2,1,1,2,-3,-73,1,-1,-1
"3955","17",429,1,2,0,0,-226,-227,-4,-4,-174,-158,-4,-4,2,1,-52,-69,0,0
"3956","17",275,4,4,1,2,-250,1,2,-1,1,238,3,3,2,-2,-251,-237,-1,-4
"3957","17",236,5,1,0,1,-1,1,0,0,-9,2,0,0,2,-3,8,-1,0,0
"3958","17",386,1,1,0,0,-238,210,-4,-4,-12,15,-2,-3,2,1,-226,195,-2,-1
"3959","17",79,2,4,0,2,-224,112,-2,-3,-223,191,-3,-3,2,0,-1,-79,1,0
"3960","17",312,9,4,1,1,-113,-142,-4,4,108,-120,4,4,2,-7,-221,-22,-8,0
"3961","17",309,7,4,1,2,70,63,1,2,109,62,1,-1,2,-5,-39,1,0,3
"3962","17",110,6,1,0,1,-63,61,-4,1,35,-106,-3,2,2,-4,-98,167,-1,-1
"3963","17",326,7,4,1,2,166,81,2,2,156,93,2,2,2,-5,10,-12,0,0
"3964","17",177,6,4,1,1,128,105,3,1,107,90,4,-4,2,-4,21,15,-1,5
"3965","17",92,4,4,1,2,-92,-70,-1,-1,-100,-80,-1,-1,2,-2,8,10,0,0
"3966","17",396,1,1,0,1,-217,176,3,-4,-165,92,4,-4,2,1,-52,84,-1,0
"3967","17",389,5,3,1,2,1,-16,-3,0,-2,-7,0,0,2,-3,3,-9,-3,0
"3968","17",279,7,4,0,3,127,-25,3,2,133,80,2,2,2,-5,-6,-105,1,0
"3969","17",78,2,4,1,0,-174,-3,-3,-3,-188,-4,-3,-3,2,0,14,1,0,0
"3970","17",210,4,4,1,2,140,119,3,-1,137,-78,1,-4,2,-2,3,197,2,3
"3971","17",433,1,1,1,0,-229,-230,-4,-4,214,178,2,2,2,1,-443,-408,-6,-6
"3972","17",43,1,3,0,0,-173,182,-4,-4,108,-5,-1,-4,2,1,-281,187,-3,0
"3973","17",329,7,4,1,3,73,-85,2,2,-127,-77,-2,-2,2,-5,200,-8,4,4
"3974","17",18,2,3,1,1,-47,-57,0,-3,119,37,1,-2,2,0,-166,-94,-1,-1
"3975","17",95,1,4,0,2,-243,3,-4,-4,-120,11,-2,-2,2,1,-123,-8,-2,-2
"3976","17",298,2,1,0,0,-237,16,-1,-3,18,-164,-1,1,2,0,-255,180,0,-4
"3977","17",238,1,3,1,1,-62,-25,0,-4,-29,-60,-3,-3,2,1,-33,35,3,-1
"3978","17",460,2,1,0,0,-220,143,-4,-3,229,89,-3,2,2,0,-449,54,-1,-5
"3979","17",415,3,2,0,2,-12,2,0,-2,158,145,0,1,2,-1,-170,-143,0,-3
"3980","17",262,6,4,1,3,55,51,1,1,72,104,1,1,2,-4,-17,-53,0,0
"3981","17",56,5,3,0,1,109,-137,-1,0,29,-113,-2,0,2,-3,80,-24,1,0
"3982","17",112,6,4,1,3,58,-2,2,1,5,245,4,4,2,-4,53,-247,-2,-3
"3983","17",202,4,1,0,1,39,19,-2,-1,25,26,-2,-1,2,-2,14,-7,0,0
"3984","17",2,7,4,1,1,83,31,2,2,-71,-30,1,0,2,-5,154,61,1,2
"3985","17",28,4,4,1,1,-59,-50,-1,-1,23,-57,-1,-1,2,-2,-82,7,0,0
"3986","17",276,7,4,1,3,192,1,2,2,194,-1,2,2,2,-5,-2,2,0,0
"3987","17",240,9,2,0,1,-246,6,3,4,130,37,1,-1,2,-7,-376,-31,2,5
"3988","17",317,3,4,1,2,-69,61,-2,-2,-35,42,-1,-1,2,-1,-34,19,-1,-1
"3989","17",8,6,3,1,1,-190,160,0,1,-100,214,1,1,2,-4,-90,-54,-1,0
"3990","17",313,3,3,1,0,-201,-176,-2,-2,240,242,4,4,2,-1,-441,-418,-6,-6
"3991","17",31,4,1,0,0,-70,-52,-1,-1,-172,166,-4,-4,2,-2,102,-218,3,3
"3992","17",111,6,1,1,0,-45,-47,-2,1,77,62,1,-2,2,-4,-122,-109,-3,3
"3993","17",201,9,3,0,1,93,-5,2,4,28,0,-2,-3,2,-7,65,-5,4,7
"3994","17",199,2,4,0,2,-188,43,-2,-3,21,12,0,0,2,0,-209,31,-2,-3
"3995","17",97,2,1,0,1,-231,12,3,-3,-22,9,3,-1,2,0,-209,3,0,-2
"3996","17",3,1,3,0,0,-149,-1,2,-4,-53,-1,-2,-2,2,1,-96,0,4,-2
"3997","17",24,1,2,1,2,-244,239,-4,-4,242,0,4,4,2,1,-486,239,-8,-8
"3998","17",316,3,3,0,0,-160,-109,-2,-2,-180,-107,-2,-2,2,-1,20,-2,0,0
"3999","17",417,1,2,0,2,-219,-201,-4,-4,-105,-79,-3,-3,2,1,-114,-122,-1,-1
"4000","17",211,7,3,1,1,-139,-85,-2,2,242,241,-4,2,2,-5,-381,-326,2,0
"4001","17",434,7,4,1,3,191,-11,2,2,191,-11,2,2,2,-5,0,0,0,0
"4002","17",430,5,2,0,1,34,-23,0,0,180,-96,2,2,2,-3,-146,73,-2,-2
"4003","17",33,5,3,0,1,-5,-16,0,0,-229,35,0,0,2,-3,224,-51,0,0
"4004","17",180,1,2,0,2,-82,0,-3,-4,-248,2,-3,-2,2,1,166,-2,0,-2
"4005","17",96,2,1,0,0,-206,7,-3,-3,-184,3,-3,-3,2,0,-22,4,0,0
"4006","17",299,5,4,1,1,-217,-51,-1,0,139,-128,-1,-1,2,-3,-356,77,0,1
"4007","17",239,2,1,0,1,-236,-208,-3,-3,152,-52,2,1,2,0,-388,-156,-5,-4
"4008","17",461,6,4,1,2,123,35,1,1,65,48,1,1,2,-4,58,-13,0,0
"4009","17",416,7,4,0,0,-234,227,-4,2,-80,53,-4,-4,2,-5,-154,174,0,6
"4010","17",263,9,4,1,0,-140,-8,4,4,-1,3,-2,-2,2,-7,-139,-11,6,6
"4011","17",57,1,4,0,1,-2,-93,-2,-4,-3,-216,-4,-4,2,1,1,123,2,0
"4012","17",113,5,2,1,2,72,14,1,0,66,64,1,1,2,-3,6,-50,0,-1
"4013","17",203,9,4,1,3,230,21,4,4,-12,-230,-4,4,2,-7,242,251,8,0
"4014","17",20,5,3,1,0,-145,-151,-2,0,212,219,4,4,2,-3,-357,-370,-6,-4
"4015","17",280,5,2,0,1,230,20,-1,0,56,-40,-1,-2,2,-3,174,60,0,2
"4016","17",277,1,4,0,1,-40,99,4,-4,48,-93,3,-3,2,1,-88,192,1,-1
"4017","17",88,3,4,1,2,-191,-29,-2,-2,205,-209,4,4,2,-1,-396,180,-6,-6
"4018","17",1,4,1,0,1,-100,-97,-1,-1,24,20,1,2,2,-2,-124,-117,-2,-3
"4019","17",80,7,4,1,3,181,0,2,2,195,-1,2,-2,2,-5,-14,1,0,4
"4020","17",314,1,4,1,1,-242,10,4,-4,-241,9,4,-4,2,1,-1,1,0,0
"4021","17",310,3,4,1,2,-18,-1,-2,-2,55,0,2,2,2,-1,-73,-1,-4,-4
"4022","17",230,5,1,0,0,-220,77,-3,0,-197,22,-3,1,2,-3,-23,55,0,-1
"4023","17",331,2,1,0,0,-16,-206,-4,-3,13,-203,-4,-3,2,0,-29,-3,0,0
"4024","17",182,7,4,1,3,128,-57,2,2,2,-164,1,1,2,-5,126,107,1,1
"4025","17",303,1,3,0,2,-188,-172,-4,-4,-128,-95,-1,-1,2,1,-60,-77,-3,-3
"4026","17",30,5,2,0,2,-36,-10,-2,0,-172,1,-2,3,2,-3,136,-11,0,-3
"4027","17",87,7,4,1,3,210,-23,2,2,85,-76,0,2,2,-5,125,53,2,0
"4028","17",83,6,1,0,3,116,-140,2,1,148,-111,2,1,2,-4,-32,-29,0,0
"4029","17",418,6,2,1,2,94,-8,1,1,59,-17,0,1,2,-4,35,9,1,0
"4030","17",212,3,1,0,1,-27,26,4,-2,-210,33,4,-2,2,-1,183,-7,0,0
"4031","17",435,6,4,1,1,68,-88,1,1,-191,-57,1,1,2,-4,259,-31,0,0
"4032","17",286,6,1,0,3,82,-1,1,1,69,-1,1,1,2,-4,13,0,0,0
"4033","17",330,5,2,0,2,-244,-1,1,0,180,178,2,1,2,-3,-424,-179,-1,-1
"4034","17",181,5,4,0,3,-132,-89,0,0,115,61,-4,-4,2,-3,-247,-150,4,4
"4035","17",282,9,3,0,3,-35,-23,1,4,110,35,1,4,2,-7,-145,-58,0,0
"4036","17",359,9,4,1,3,233,14,4,4,227,16,4,4,2,-7,6,-2,0,0
"4037","17",9,4,4,1,2,6,5,1,-1,35,20,1,-1,2,-2,-29,-15,0,0
"4038","17",86,6,4,1,3,94,-19,2,1,160,-5,2,1,2,-4,-66,-14,0,0
"4039","17",82,8,4,1,2,153,-106,4,3,26,-226,4,4,2,-6,127,120,0,-1
"4040","17",264,1,4,1,2,-114,-26,-2,-4,4,7,-2,-4,2,1,-118,-33,0,0
"4041","17",58,8,4,1,1,-246,5,-4,3,-2,241,4,3,2,-6,-244,-236,-8,0
"4042","17",114,2,4,1,1,-24,-40,1,-3,98,80,0,-3,2,0,-122,-120,1,0
"4043","17",204,4,3,0,1,89,-38,0,-1,122,-111,0,0,2,-2,-33,73,0,-1
"4044","17",200,1,3,0,0,-197,-47,-4,-4,62,-20,-3,-4,2,1,-259,-27,-1,0
"4045","17",281,1,4,0,2,-237,2,-4,-4,-242,-1,-4,-4,2,1,5,3,0,0
"4046","17",278,1,4,0,1,-221,-224,4,-4,0,-224,4,-4,2,1,-221,0,0,0
"4047","17",89,1,3,1,0,-98,0,-3,-4,-144,4,-4,-1,2,1,46,-4,1,-3
"4048","17",10,6,3,1,1,59,-16,0,1,1,7,0,-1,2,-4,58,-23,0,2
"4049","17",81,7,1,0,0,-232,161,-3,2,-206,144,-2,1,2,-5,-26,17,-1,1
"4050","17",315,8,3,1,3,238,22,3,3,233,25,3,3,2,-6,5,-3,0,0
"4051","17",311,1,2,0,2,-245,7,-4,-4,213,2,4,-4,2,1,-458,5,-8,0
"4052","17",231,8,4,1,0,-183,-164,-4,3,-7,5,1,1,2,-6,-176,-169,-5,2
"4053","17",332,2,1,0,0,-250,157,-4,-3,-250,129,-2,-2,2,0,0,28,-2,-1
"4054","17",183,4,4,1,1,60,92,1,-1,41,68,-2,0,2,-2,19,24,3,-1
"4055","17",304,1,2,0,2,-237,56,-4,-4,68,-25,2,2,2,1,-305,81,-6,-6
"4056","17",300,3,1,0,0,-72,57,-1,-2,10,27,1,1,2,-1,-82,30,-2,-3
"4057","17",378,5,4,1,1,-101,5,-1,0,79,-1,1,1,2,-3,-180,6,-2,-1
"4058","17",84,6,4,1,3,177,1,1,1,174,2,2,2,2,-4,3,-1,-1,-1
"4059","17",419,6,4,1,3,129,110,1,1,137,106,1,0,2,-4,-8,4,0,1
"4060","17",213,3,2,0,1,194,0,-2,-2,-226,1,-3,2,2,-1,420,-1,1,-4
"4061","17",436,6,4,1,3,93,56,0,1,17,187,2,0,2,-4,76,-131,-2,1
"4062","17",287,1,4,1,3,84,-1,-2,-4,62,7,1,1,2,1,22,-8,-3,-5
"4063","17",206,1,4,1,0,-103,-53,-3,-4,-230,-192,-4,-4,2,1,127,139,1,0
"4064","17",133,4,2,0,1,-96,-238,0,-1,209,35,4,-3,2,-2,-305,-273,-4,2
"4065","17",283,6,1,1,1,-62,-113,-2,1,-148,-117,-1,2,2,-4,86,4,-1,-1
"4066","17",36,9,3,1,3,160,93,4,4,-112,143,2,2,2,-7,272,-50,2,2
"4067","17",377,3,1,0,0,-240,10,-4,-2,238,6,0,-1,2,-1,-478,4,-4,-1
"4068","17",373,1,3,0,0,-244,-52,0,-4,-233,-163,0,-4,2,1,-11,111,0,0
"4069","17",22,6,3,1,1,96,-26,1,1,77,-5,1,1,2,-4,19,-21,0,0
"4070","17",265,6,1,0,3,46,-3,0,1,4,2,0,0,2,-4,42,-5,0,1
"4071","17",59,2,1,0,0,-128,0,-3,-3,-21,2,-1,-1,2,0,-107,-2,-2,-2
"4072","17",115,5,3,0,3,75,-2,0,0,82,1,0,0,2,-3,-7,-3,0,0
"4073","17",205,6,1,0,2,233,-2,0,1,1,-196,3,3,2,-4,232,194,-3,-2
"4074","17",132,7,4,1,1,144,-12,1,2,23,181,1,0,2,-5,121,-193,0,2
"4075","17",306,5,3,0,3,117,105,1,0,123,138,1,0,2,-3,-6,-33,0,0
"4076","17",302,3,1,1,0,-43,-20,-3,-2,229,55,-2,-2,2,-1,-272,-75,-1,0
"4077","17",355,1,2,0,2,-197,135,-4,-4,-111,45,-3,-3,2,1,-86,90,-1,-1
"4078","17",424,3,2,0,2,-144,-8,-2,-2,85,29,1,-1,2,-1,-229,-37,-3,-1
"4079","17",420,8,4,1,3,104,1,2,3,-71,1,0,-1,2,-6,175,0,2,4
"4080","17",215,2,1,1,0,-167,20,-2,-3,164,30,-2,-3,2,0,-331,-10,0,0
"4081","17",438,5,4,0,3,3,3,4,0,4,3,4,0,2,-3,-1,0,0,0
"4082","17",289,6,1,1,3,-149,-17,1,1,152,38,2,2,2,-4,-301,-55,-1,-1
"4083","17",333,6,4,1,1,47,7,1,1,-85,100,1,1,2,-4,132,-93,0,0
"4084","17",184,7,3,1,3,160,-5,2,2,127,-4,1,2,2,-5,33,-1,1,0
"4085","17",305,8,4,1,3,227,14,3,3,234,59,3,3,2,-6,-7,-45,0,0
"4086","17",301,2,4,0,1,-166,4,-2,-3,-71,3,-1,-2,2,0,-95,1,-1,-1
"4087","17",379,4,3,1,1,0,-162,-1,-1,24,-81,1,0,2,-2,-24,-81,-2,-1
"4088","17",85,1,2,0,2,-129,105,-3,-4,-93,121,-2,-1,2,1,-36,-16,-1,-3
"4089","17",42,2,3,0,1,-63,53,2,-3,5,9,2,-2,2,0,-68,44,0,-1
"4090","17",214,9,1,0,3,130,-136,4,4,161,-135,4,4,2,-7,-31,-1,0,0
"4091","17",437,2,1,1,0,-144,2,-3,-3,-181,6,-2,-2,2,0,37,-4,-1,-1
"4092","17",288,7,2,0,2,21,48,1,2,-85,62,0,1,2,-5,106,-14,1,1
"4093","17",207,5,1,0,0,1,0,0,0,242,0,4,4,2,-3,-241,0,-4,-4
"4094","17",134,6,2,0,2,-37,-3,1,1,9,-9,1,-1,2,-4,-46,6,0,2
"4095","17",284,1,3,1,1,-147,-90,-2,-4,184,131,0,-3,2,1,-331,-221,-2,-1
"4096","17",360,1,3,1,0,-132,-72,-2,-4,58,74,1,-4,2,1,-190,-146,-3,0
"4097","17",357,6,4,1,2,53,-13,1,1,61,1,1,-2,2,-4,-8,-14,0,3
"4098","17",374,5,4,1,2,13,9,0,0,143,11,1,1,2,-3,-130,-2,-1,-1
"4099","17",220,1,4,0,2,-236,185,-4,-4,121,106,-2,-2,2,1,-357,79,-2,-2
"4100","17",266,4,1,1,1,-97,-3,-1,-1,-97,9,-2,-2,2,-2,0,-12,1,1
"4101","17",6,9,4,0,2,25,-1,4,4,-188,0,4,4,2,-7,213,-1,0,0
"4102","17",116,7,2,0,3,141,-18,2,2,118,-23,1,1,2,-5,23,5,1,1
"4103","17",335,3,2,0,1,-154,-25,-1,-2,-96,25,-2,-2,2,-1,-58,-50,1,0
"4104","17",186,6,2,0,2,0,8,0,1,38,23,0,0,2,-4,-38,-15,0,1
"4105","17",307,1,4,0,2,-240,244,-4,-4,-107,-64,-4,-4,2,1,-133,308,0,0
"4106","17",222,1,1,0,0,-245,2,-4,-4,-229,-5,-2,-3,2,1,-16,7,-2,-1
"4107","17",356,3,4,1,1,-190,1,-2,-2,122,1,2,1,2,-1,-312,0,-4,-3
"4108","17",425,4,4,1,2,-49,-48,-1,-1,4,71,2,2,2,-2,-53,-119,-3,-3
"4109","17",421,6,3,1,1,-71,-96,-1,1,81,64,0,3,2,-4,-152,-160,-1,-2
"4110","17",216,6,3,1,1,22,-7,1,1,-3,4,-2,0,2,-4,25,-11,3,1
"4111","17",439,4,2,0,1,-144,6,-1,-1,0,0,-1,-1,2,-2,-144,6,0,0
"4112","17",29,1,4,1,0,-248,199,-4,-4,17,176,-4,-4,2,1,-265,23,0,0
"4113","17",334,1,4,1,0,-244,-155,-4,-4,-239,-92,-4,-4,2,1,-5,-63,0,0
"4114","17",185,4,4,1,2,9,-17,-3,-1,214,-18,-1,3,2,-2,-205,1,-2,-4
"4115","17",375,5,3,0,1,0,1,0,0,5,0,0,0,2,-3,-5,1,0,0
"4116","17",221,4,4,1,1,5,6,-1,-1,-63,8,-2,1,2,-2,68,-2,1,-2
"4117","17",38,6,4,0,3,102,-8,1,1,11,-21,1,0,2,-4,91,13,0,1
"4118","17",376,3,4,1,1,44,-61,-2,-2,115,-12,-1,-1,2,-1,-71,-49,-1,-1
"4119","17",117,1,4,0,2,-249,-1,-4,-4,-82,-3,-1,-1,2,1,-167,2,-3,-3
"4120","17",268,7,4,1,3,95,-82,2,2,104,-96,3,3,2,-5,-9,14,-1,-1
"4121","17",61,1,1,0,3,249,-90,3,-4,-61,-11,3,-3,2,1,310,-79,0,-1
"4122","17",118,4,3,0,1,-39,-51,-1,-1,17,-38,1,2,2,-2,-56,-13,-2,-3
"4123","17",208,4,4,0,2,-192,-122,-1,-1,213,181,3,3,2,-2,-405,-303,-4,-4
"4124","17",135,7,1,0,1,-150,-72,2,2,-49,-48,0,2,2,-5,-101,-24,2,0
"4125","17",285,5,2,0,1,-4,2,0,0,-77,4,-2,0,2,-3,73,-2,2,0
"4126","17",361,2,1,1,0,-249,8,-2,-3,1,-244,3,-1,2,0,-250,252,-5,-2
"4127","17",358,1,4,1,2,-178,94,-4,-4,-100,74,-4,-4,2,1,-78,20,0,0
"4128","17",44,1,2,0,2,-247,4,-4,-4,200,-1,0,-4,2,1,-447,5,-4,0
"4129","17",290,2,1,0,1,-135,35,0,-3,67,20,1,-1,2,0,-202,15,-1,-2
"4130","17",267,5,3,0,1,-4,-2,0,0,66,-8,1,1,2,-3,-70,6,-1,-1
"4131","17",60,7,1,0,3,141,1,1,2,-1,-120,4,1,2,-5,142,121,-3,1
"4132","17",23,9,1,0,3,-203,-224,-4,4,183,166,4,4,2,-7,-386,-390,-8,0
"4133","17",336,3,4,1,3,184,167,2,-2,128,184,3,-2,2,-1,56,-17,-1,0
"4134","17",187,4,4,0,2,104,20,1,-1,42,31,1,2,2,-2,62,-11,0,-3
"4135","17",308,1,4,1,0,-247,-243,-4,-4,246,246,4,4,2,1,-493,-489,-8,-8
"4136","17",223,5,1,0,1,-1,-1,0,0,2,-1,0,0,2,-3,-3,0,0,0
"4137","17",381,2,2,0,2,-231,-3,-3,-3,-1,4,0,0,2,0,-230,-7,-3,-3
"4138","17",426,7,4,0,3,0,-248,2,2,191,-1,4,4,2,-5,-191,-247,-2,-2
"4139","17",422,1,3,0,1,-75,-150,4,-4,-65,-163,2,-4,2,1,-10,13,2,0
"4140","17",217,2,4,0,2,-106,27,-1,-3,-24,22,-1,-3,2,0,-82,5,0,0
"4141","17",136,2,1,0,0,-191,-1,-3,-3,197,-135,-3,-2,2,0,-388,134,0,-1
"4142","17",427,1,4,1,1,-228,-62,4,-4,-213,-60,4,-4,2,1,-15,-2,0,0
"4143","17",140,4,1,0,1,-3,-46,0,-1,6,-29,2,-1,2,-2,-9,-17,-2,0
"4144","17",384,2,1,0,0,-224,1,-3,-3,1,67,-2,-2,2,0,-225,-66,-1,-1
"4145","17",440,3,3,1,0,-143,-41,-2,-2,-1,0,0,0,2,-1,-142,-41,-2,-2
"4146","17",351,1,1,0,0,-246,-246,-4,-4,245,245,-4,-4,2,1,-491,-491,0,0
"4147","17",380,1,4,1,1,-169,-36,3,-4,-128,-45,3,-4,2,1,-41,9,0,0
"4148","17",227,3,3,1,3,61,21,1,-2,71,35,1,-1,2,-1,-10,-14,0,-1
"4149","17",292,6,3,1,1,-6,64,1,1,-90,-1,-2,-2,2,-4,84,65,3,3
"4150","17",269,3,4,1,2,0,0,-2,-2,-249,112,-3,-3,2,-1,249,-112,1,1
"4151","17",62,9,2,0,3,229,248,4,4,217,216,4,4,2,-7,12,32,0,0
"4152","17",119,7,3,0,3,136,-18,1,2,135,115,2,2,2,-5,1,-133,-1,0
"4153","17",14,3,3,1,1,-158,5,-2,-2,192,-115,2,2,2,-1,-350,120,-4,-4
"4154","17",382,6,4,1,2,2,2,0,1,25,5,1,0,2,-4,-23,-3,-1,1
"4155","17",63,4,4,1,1,-1,1,0,-1,-1,-12,0,1,2,-2,0,13,0,-2
"4156","17",423,5,1,0,3,-165,-132,3,0,160,-4,0,2,2,-3,-325,-128,3,-2
"4157","17",383,5,4,1,1,-1,6,0,0,-4,2,0,0,2,-3,3,4,0,0
"4158","17",137,2,1,1,1,-120,229,-3,-3,186,208,-4,-2,2,0,-306,21,1,-1
"4159","17",291,1,4,1,2,19,-40,-3,-4,244,244,4,4,2,1,-225,-284,-7,-8
"4160","17",219,5,4,1,3,249,-1,4,0,-1,-248,4,0,2,-3,250,247,0,0
"4161","17",441,7,4,1,2,29,-178,3,2,31,-98,3,2,2,-5,-2,-80,0,0
"4162","17",457,1,3,1,1,-78,33,-3,-4,2,-2,1,2,2,1,-80,35,-4,-6
"4163","17",337,9,2,0,3,12,-15,4,4,233,-19,4,4,2,-7,-221,4,0,0
"4164","17",188,9,2,1,3,241,-1,4,4,241,-1,4,4,2,-7,0,0,0,0
"4165","17",228,1,4,1,2,-194,-209,-4,-4,53,135,3,2,2,1,-247,-344,-7,-6
"4166","17",224,2,2,0,2,-79,-27,-3,-3,165,66,2,1,2,0,-244,-93,-5,-4
"4167","17",27,5,2,0,2,-70,-20,0,0,-24,-15,0,0,2,-3,-46,-5,0,0
"4168","17",189,3,1,0,1,-220,48,2,-2,-231,46,3,-3,2,-1,11,2,-1,1
"4169","17",12,9,4,1,3,1,1,4,4,0,2,4,4,2,-7,1,-1,0,0
"4170","17",218,8,4,1,3,-213,-63,4,3,-163,-57,4,3,2,-6,-50,-6,0,0
"4171","17",270,3,3,0,1,81,3,1,-2,158,3,3,2,2,-1,-77,0,-2,-4
"4172","17",46,2,1,0,0,-48,-247,-4,-3,-24,-246,-4,-4,2,0,-24,-1,0,1
"4173","17",141,1,1,0,0,-14,-75,-3,-4,182,190,4,4,2,1,-196,-265,-7,-8
"4174","17",385,4,4,1,1,-14,-171,-1,-1,103,120,2,2,2,-2,-117,-291,-3,-3
"4175","17",125,3,4,1,0,-212,-22,-4,-2,-46,-31,-3,-1,2,-1,-166,9,-1,-1
"4176","17",352,4,2,0,1,12,-78,0,-1,13,-83,0,-1,2,-2,-1,5,0,0
"4177","17",446,5,4,0,1,-249,-7,-4,0,102,87,-1,0,2,-3,-351,-94,-3,0
"4178","17",442,6,4,1,1,-61,28,-1,1,28,27,1,1,2,-4,-89,1,-2,0
"4179","17",293,1,4,1,0,-117,14,-4,-4,-229,-5,-4,-4,2,1,112,19,0,0
"4180","17",338,1,3,1,2,243,245,4,-4,248,250,-4,-4,2,1,-5,-5,8,0
"4181","17",447,3,4,0,2,-117,-6,1,-2,81,85,2,1,2,-1,-198,-91,-1,-3
"4182","17",229,7,1,0,1,95,-37,1,2,77,-48,-1,0,2,-5,18,11,2,2
"4183","17",339,6,3,1,1,33,14,1,1,91,61,1,1,2,-4,-58,-47,0,0
"4184","17",144,1,3,0,0,-237,1,-3,-4,248,-3,2,1,2,1,-485,4,-5,-5
"4185","17",64,1,1,1,1,-237,229,-4,-4,221,-221,-3,-3,2,1,-458,450,-1,-1
"4186","17",226,1,1,1,0,108,1,-2,-4,225,3,3,-4,2,1,-117,-2,-5,0
"4187","17",271,4,3,0,1,-56,2,-1,-1,198,4,4,4,2,-2,-254,-2,-5,-5
"4188","17",138,5,3,1,1,-6,-11,0,0,101,-58,1,1,2,-3,-107,47,-1,-1
"4189","17",121,1,1,0,0,-192,-31,-4,-4,229,-143,-1,-4,2,1,-421,112,-3,0
"4190","17",142,4,2,0,2,-79,24,-4,-1,-1,1,0,0,2,-2,-78,23,-4,-1
"4191","17",139,1,4,1,2,0,0,-4,-4,-236,13,-4,-4,2,1,236,-13,0,0
"4192","17",458,2,1,0,1,-93,-89,0,-3,68,77,-1,-2,2,0,-161,-166,1,-1
"4193","17",353,6,2,0,2,-226,70,-4,1,229,185,3,-2,2,-4,-455,-115,-7,3
"4194","17",143,6,1,0,3,139,-10,-4,1,-10,57,2,2,2,-4,149,-67,-6,-1
"4195","17",443,2,1,0,0,-170,-67,-2,-3,44,38,1,0,2,0,-214,-105,-3,-3
"4196","17",225,6,2,1,2,-44,204,1,1,135,-126,0,0,2,-4,-179,330,1,1
"4197","17",354,5,1,0,0,-114,84,-1,0,143,154,2,3,2,-3,-257,-70,-3,-3
"4198","17",19,3,2,0,2,-95,-23,-1,-2,118,-85,1,-1,2,-1,-213,62,-2,-1
"4199","17",120,1,3,1,1,-42,171,-4,-4,140,109,1,1,2,1,-182,62,-5,-5
"4200","17",34,6,4,1,2,14,-12,1,1,119,-79,1,2,2,-4,-105,67,0,-1
"4201","17",449,7,4,1,3,3,98,1,2,39,90,0,0,2,-5,-36,8,1,2
"4202","17",445,6,4,1,3,96,-23,1,1,109,-74,1,1,2,-4,-13,51,0,0
"4203","17",453,3,4,0,2,-157,5,-2,-2,1,-176,1,1,2,-1,-158,181,-3,-3
"4204","17",272,5,4,1,2,53,26,0,0,35,14,0,1,2,-3,18,12,0,-1
"4205","17",126,2,2,1,2,25,38,-3,-3,22,25,-4,-4,2,0,3,13,1,1
"4206","17",122,3,1,0,0,-175,-161,-4,-2,226,211,4,4,2,-1,-401,-372,-8,-6
"4207","17",454,6,4,1,3,94,3,1,1,0,59,0,1,2,-4,94,-56,1,0
"4208","17",362,2,4,0,3,-142,62,4,-3,94,-82,2,-1,2,0,-236,144,2,-2
"4209","17",294,7,1,0,3,158,2,2,2,-1,-1,0,0,2,-5,159,3,2,2
"4210","17",123,3,4,1,2,-87,29,-2,-2,-180,42,-2,-2,2,-1,93,-13,0,0
"4211","17",448,9,2,0,2,171,-3,4,4,65,2,2,1,2,-7,106,-5,2,3
"4212","17",444,1,2,0,2,-228,67,-4,-4,-213,69,-4,-4,2,1,-15,-2,0,0
"4213","17",456,1,1,0,0,-56,-64,-1,-4,-16,0,-1,-3,2,1,-40,-64,0,-1
"4214","17",145,1,1,0,1,-247,4,-4,-4,-194,-111,-3,-3,2,1,-53,115,-1,-1
"4215","17",190,7,4,1,3,222,209,2,2,160,202,2,2,2,-5,62,7,0,0
"4216","17",296,6,1,0,3,89,1,1,1,185,-5,1,1,2,-4,-96,6,0,0
"4217","17",340,4,1,0,1,-97,-31,0,-1,40,21,0,0,2,-2,-137,-52,0,-1
"4218","17",191,3,1,0,0,-186,-78,-2,-2,-209,-54,-2,-2,2,-1,23,-24,0,0
"4219","17",154,6,4,1,3,63,59,1,1,45,111,0,0,2,-4,18,-52,1,1
"4220","17",150,5,3,0,1,-1,3,0,0,-6,12,0,0,2,-3,5,-9,0,0
"4221","17",273,4,1,0,0,-231,3,-2,-1,-37,55,0,0,2,-2,-194,-52,-2,-1
"4222","17",459,2,3,1,1,-152,137,3,-3,-128,-40,3,-3,2,0,-24,177,0,0
"4223","17",155,5,2,0,1,-19,-11,0,0,-14,-128,0,0,2,-3,-5,117,0,0
"4224","17",342,1,3,0,1,-37,-34,-2,-4,46,-64,-1,-3,2,1,-83,30,-1,-1
"4225","17",363,3,3,0,3,-249,2,2,-2,3,249,3,3,2,-1,-252,-247,-1,-5
"4226","17",295,5,1,0,1,-1,-7,0,0,5,0,0,0,2,-3,-6,-7,0,0
"4227","17",124,7,1,0,3,0,0,3,2,249,-1,3,4,2,-5,-249,1,0,-2
"4228","17",452,2,3,1,1,-204,5,-3,-3,-4,-42,0,0,2,0,-200,47,-3,-3
"4229","17",129,7,4,1,1,163,-5,2,2,-211,1,-2,-2,2,-5,374,-6,4,4
"4230","17",348,6,3,1,1,37,31,-4,1,130,111,-1,0,2,-4,-93,-80,-3,1
"4231","17",45,2,3,1,0,-101,-64,-2,-3,-25,-43,1,-1,2,0,-76,-21,-3,-2
"4232","17",365,1,3,1,1,-226,9,4,-4,-235,6,4,-4,2,1,9,3,0,0
"4233","17",13,2,4,1,1,2,-114,-1,-3,103,-46,1,-1,2,0,-101,-68,-2,-2
"4234","17",341,9,1,1,3,0,0,4,4,246,-24,4,4,2,-7,-246,24,0,0
"4235","17",127,1,1,0,0,-224,-42,2,-4,85,64,2,-3,2,1,-309,-106,0,-1
"4236","17",366,7,4,1,3,148,-64,4,2,45,46,3,2,2,-5,103,-110,1,0
"4237","17",455,9,2,0,2,-247,1,-4,4,-8,239,2,4,2,-7,-239,-238,-6,0
"4238","17",274,5,4,0,2,-13,-217,0,0,-21,-145,1,1,2,-3,8,-72,-1,-1
"4239","17",128,7,1,0,3,202,-35,2,2,179,-117,0,2,2,-5,23,82,2,0
"4240","17",156,4,2,0,1,-41,0,-1,-1,1,9,0,0,2,-2,-42,-9,-1,-1
"4241","17",343,4,2,0,2,-33,1,-1,-1,41,2,1,1,2,-2,-74,-1,-2,-2
"4242","17",364,5,3,0,1,-9,-10,0,0,-56,-3,-1,-2,2,-3,47,-7,1,2
"4243","17",157,1,3,1,2,-207,-2,-4,-4,151,139,-4,0,2,1,-358,-141,0,-4
"4244","17",146,2,2,0,0,-151,-175,-3,-3,-182,-157,-3,-3,2,0,31,-18,0,0
"4245","17",161,1,2,0,2,-243,223,-4,-4,83,56,1,-4,2,1,-326,167,-5,0
"4246","17",195,1,1,1,1,-218,208,4,-4,-191,183,3,-3,2,1,-27,25,1,-1
"4247","17",349,3,4,0,1,-101,-44,-3,-2,-78,109,2,1,2,-1,-23,-153,-5,-3
"4248","17",192,6,4,1,1,-1,81,1,1,-3,41,1,1,2,-4,2,40,0,0
"4249","17",162,9,3,0,3,25,77,0,4,113,131,3,4,2,-7,-88,-54,-3,0
"4250","17",151,1,2,0,1,-243,9,0,-4,-243,13,0,-4,2,1,0,-4,0,0
"4251","17",148,2,1,0,1,-109,-3,2,-3,-195,-2,2,-1,2,0,86,-1,0,-2
"4252","17",193,1,1,0,0,-214,-190,-4,-4,158,-51,1,1,2,1,-372,-139,-5,-5
"4253","17",367,5,3,1,1,7,7,1,0,17,17,2,0,2,-3,-10,-10,-1,0
"4254","17",152,3,1,0,0,-17,-2,0,-2,176,-3,0,1,2,-1,-193,1,0,-3
"4255","17",164,7,2,0,2,90,8,1,2,101,-90,2,2,2,-5,-11,98,-1,0
"4256","17",194,8,1,0,0,-221,10,-4,3,-192,9,-4,3,2,-6,-29,1,0,0
"4257","17",153,7,1,0,3,103,-48,2,2,-124,-81,1,1,2,-5,227,33,1,1
"4258","17",344,7,4,1,3,177,-59,1,2,162,-81,2,1,2,-5,15,22,-1,1
"4259","17",15,8,4,1,3,201,52,2,3,63,54,3,3,2,-6,138,-2,-1,0
"4260","17",158,4,3,1,0,-63,-33,-2,-1,-36,-24,-1,-1,2,-2,-27,-9,-1,0
"4261","17",450,7,4,1,3,-85,2,-1,2,-4,162,1,1,2,-5,-81,-160,-2,1
"4262","17",345,7,1,0,0,-201,208,-4,2,9,-114,-3,-4,2,-5,-210,322,-1,6
"4263","17",130,9,1,0,3,223,55,4,4,115,51,4,4,2,-7,108,4,0,0
"4264","17",35,2,1,0,3,24,147,0,-3,130,139,3,-1,2,0,-106,8,-3,-2
"4265","17",451,1,1,0,0,-210,-216,-4,-4,-216,-213,-4,-4,2,1,6,-3,0,0
"4266","17",163,4,3,0,1,-103,-4,0,-1,64,2,1,1,2,-2,-167,-6,-1,-2
"4267","17",131,8,4,1,3,70,-17,0,3,59,-22,0,3,2,-6,11,5,0,0
"4268","17",149,5,3,0,1,-176,-16,-4,0,246,4,-3,1,2,-3,-422,-20,-1,-1
"4269","17",347,6,1,1,3,137,117,3,1,-79,-93,1,1,2,-4,216,210,2,0
"4270","17",160,6,2,0,0,-201,169,-4,1,-215,37,-4,2,2,-4,14,132,0,-1
"4271","17",198,4,1,0,1,-9,107,0,-1,-59,34,1,-1,2,-2,50,73,-1,0
"4272","17",371,2,3,1,0,-166,-142,-4,-3,204,31,-2,1,2,0,-370,-173,-2,-4
"4273","17",369,2,4,1,0,-210,2,-3,-3,52,-1,1,1,2,0,-262,3,-4,-4
"4274","17",147,7,2,0,3,-12,102,2,2,107,63,1,2,2,-5,-119,39,1,0
"4275","17",368,9,3,1,3,-112,159,4,4,-152,126,4,4,2,-7,40,33,0,0
"4276","17",196,2,3,0,0,-174,2,-2,-3,195,194,3,3,2,0,-369,-192,-5,-6
"4277","17",159,4,3,1,2,238,9,-3,-1,217,-3,4,3,2,-2,21,12,-7,-4
"4278","17",346,7,3,1,0,-236,-158,-4,2,230,-2,3,3,2,-5,-466,-156,-7,-1
"4279","17",372,1,3,1,0,-237,-241,-4,-4,-228,-218,-4,-4,2,1,-9,-23,0,0
"4280","17",197,4,4,1,3,-224,-55,2,-1,-247,-12,3,-1,2,-2,23,-43,-1,0
"4281","17",350,5,4,1,1,-238,-8,1,0,245,6,3,1,2,-3,-483,-14,-2,-1
"4282","17",37,1,1,0,0,-147,14,-3,-4,-135,18,-3,-4,2,1,-12,-4,0,0
"4283","17",370,9,1,0,3,214,-161,4,4,221,-111,-3,-4,2,-7,-7,-50,7,8
"4284","17",16,1,1,0,0,-232,27,-2,-4,242,13,3,1,2,1,-474,14,-5,-5
"4285","18",243,2,2,0,2,-249,59,-4,-3,219,242,-2,-2,2,0,-468,-183,-2,-1
"4286","18",32,5,1,0,1,2,1,0,0,170,-192,3,-4,2,-3,-168,193,-3,4
"4287","18",320,1,2,0,2,-247,126,-4,-4,-248,137,-4,-4,2,1,1,-11,0,0
"4288","18",244,4,4,1,2,-89,-131,-1,-1,225,212,3,3,2,-2,-314,-343,-4,-4
"4289","18",324,1,2,0,0,-239,4,-3,-4,-186,2,-3,-3,2,1,-53,2,0,-1
"4290","18",246,7,4,1,3,128,1,3,2,194,-1,3,2,2,-5,-66,2,0,0
"4291","18",321,3,1,0,0,-226,-230,-1,-2,-184,-219,-2,-2,2,-1,-42,-11,1,0
"4292","18",245,1,1,0,0,-237,59,-4,-4,-134,-22,-4,-4,2,1,-103,81,0,0
"4293","18",325,9,1,1,1,20,16,-1,4,-14,-13,0,4,2,-7,34,29,-1,0
"4294","18",323,1,4,1,1,-45,3,-4,-4,144,-1,0,-4,2,1,-189,4,-4,0
"4295","18",175,3,4,1,1,-152,-56,-2,-2,-122,-93,-2,-1,2,-1,-30,37,0,-1
"4296","18",322,5,4,1,3,14,-18,0,0,243,-223,2,2,2,-3,-229,205,-2,-2
"4297","18",326,7,4,1,2,172,72,2,2,175,59,2,2,2,-5,-3,13,0,0
"4298","18",247,5,3,0,0,195,-5,0,0,210,-9,2,2,2,-3,-15,4,-2,-2
"4299","18",176,8,1,0,1,-193,51,-4,3,186,72,-4,3,2,-6,-379,-21,0,0
"4300","18",327,6,4,0,3,31,-163,2,1,20,76,1,-1,2,-4,11,-239,1,2
"4301","18",174,6,4,1,3,155,109,0,1,139,71,1,0,2,-4,16,38,-1,1
"4302","18",248,1,4,1,3,-184,12,-3,-4,148,17,1,3,2,1,-332,-5,-4,-7
"4303","18",250,6,1,0,3,82,29,1,1,104,20,1,1,2,-4,-22,9,0,0
"4304","18",331,2,1,0,0,-17,-218,-4,-3,0,-211,-4,-3,2,0,-17,-7,0,0
"4305","18",179,5,1,0,1,0,1,0,0,-8,2,0,4,2,-3,8,-1,0,-4
"4306","18",249,1,3,1,0,-227,-110,-4,-4,-221,-168,-4,-4,2,1,-6,58,0,0
"4307","18",328,4,3,1,1,-31,15,-1,-1,-21,12,-1,-1,2,-2,-10,3,0,0
"4308","18",332,1,1,0,0,-250,84,-4,-4,-248,142,-3,-3,2,1,-2,-58,-1,-1
"4309","18",25,2,4,1,2,-106,-82,-2,-3,-20,-33,-1,-1,2,0,-86,-49,-1,-2
"4310","18",253,6,3,0,3,-22,-1,1,1,1,-1,0,0,2,-4,-23,0,1,1
"4311","18",242,2,4,1,2,33,-4,2,-3,12,-1,1,-3,2,0,21,-3,1,0
"4312","18",177,6,4,1,1,86,116,4,1,100,153,4,1,2,-4,-14,-37,0,0
"4313","18",254,6,2,0,3,74,-19,3,1,182,-104,-3,-1,2,-4,-108,85,6,2
"4314","18",330,6,2,0,2,-247,-4,1,1,195,174,1,1,2,-4,-442,-178,0,0
"4315","18",178,5,1,0,1,-1,1,0,0,-2,5,0,0,2,-3,1,-4,0,0
"4316","18",251,3,3,1,1,-231,140,3,-2,-117,-120,-3,-2,2,-1,-114,260,6,0
"4317","18",255,5,3,0,1,-106,-108,0,0,-152,-144,0,0,2,-3,46,36,0,0
"4318","18",230,5,1,0,0,-214,106,-3,0,-220,108,-3,0,2,-3,6,-2,0,0
"4319","18",171,6,1,0,1,33,18,1,1,77,37,0,0,2,-4,-44,-19,1,1
"4320","18",241,3,4,1,2,99,31,1,-2,188,173,2,0,2,-1,-89,-142,-1,-2
"4321","18",168,6,1,1,3,139,-131,1,1,202,-113,2,2,2,-4,-63,-18,-1,-1
"4322","18",18,3,3,1,1,-67,-64,-2,-2,45,23,1,0,2,-1,-112,-87,-3,-2
"4323","18",172,8,2,0,3,103,155,3,3,-165,166,1,3,2,-6,268,-11,2,0
"4324","18",33,6,3,0,1,59,-30,-1,1,37,-33,1,1,2,-4,22,3,-2,0
"4325","18",333,6,4,1,1,40,-9,1,1,-41,45,1,0,2,-4,81,-54,0,1
"4326","18",180,3,2,0,2,-119,-7,-2,-2,-187,0,-1,0,2,-1,68,-7,-1,-2
"4327","18",209,6,4,1,3,86,2,1,1,-14,239,1,1,2,-4,100,-237,0,0
"4328","18",205,3,1,0,2,235,3,-2,-2,-2,-195,3,3,2,-1,237,198,-5,-5
"4329","18",170,1,2,0,0,-235,-236,-4,-4,6,17,0,0,2,1,-241,-253,-4,-4
"4330","18",473,3,3,1,0,17,-191,-1,-2,-13,10,-1,-1,2,-1,30,-201,0,-1
"4331","18",167,7,1,0,3,101,-141,2,2,159,-98,2,2,2,-5,-58,-43,0,0
"4332","18",182,7,4,1,3,-3,-76,2,2,-1,-192,2,2,2,-5,-2,116,0,0
"4333","18",329,5,4,1,3,-93,157,0,0,-157,-101,-2,-2,2,-3,64,258,2,2
"4334","18",256,6,3,1,1,75,1,1,1,87,23,1,1,2,-4,-12,-22,0,0
"4335","18",231,7,4,1,0,-172,-174,-4,2,-5,80,-4,-2,2,-5,-167,-254,0,4
"4336","18",183,4,4,1,1,13,14,0,-1,51,72,1,-3,2,-2,-38,-58,-1,2
"4337","18",257,1,1,0,0,30,237,1,-4,-116,13,-1,-4,2,1,146,224,2,0
"4338","18",169,1,3,0,0,-226,207,-4,-4,-213,176,-4,-4,2,1,-13,31,0,0
"4339","18",386,1,1,0,0,-247,197,-4,-4,-2,9,-1,-2,2,1,-245,188,-3,-2
"4340","18",173,6,4,1,3,168,6,1,1,148,6,0,0,2,-4,20,0,1,1
"4341","18",258,1,3,1,0,2,7,-4,-4,21,4,-1,-4,2,1,-19,3,-3,0
"4342","18",181,3,4,1,3,-201,-12,-2,-2,240,42,-2,-2,2,-1,-441,-54,0,0
"4343","18",201,9,3,0,1,59,-1,3,4,54,-3,2,-4,2,-7,5,2,1,8
"4344","18",21,2,4,1,2,-9,-9,-1,-3,20,13,-1,-3,2,0,-29,-22,0,0
"4345","18",206,1,4,1,0,0,0,-3,-4,139,121,3,4,2,1,-139,-121,-6,-8
"4346","18",252,4,4,1,1,-83,-111,0,-1,135,66,1,1,2,-2,-218,-177,-1,-2
"4347","18",49,3,4,1,1,-192,-14,-1,-2,6,-161,-3,-3,2,-1,-198,147,2,1
"4348","18",398,4,4,0,2,-51,-43,-1,-1,36,21,1,1,2,-2,-87,-64,-2,-2
"4349","18",207,5,1,0,0,-2,2,0,0,229,0,4,4,2,-3,-231,2,-4,-4
"4350","18",475,7,3,1,3,59,-197,2,2,84,78,1,1,2,-5,-25,-275,1,1
"4351","18",39,3,3,0,1,-202,-14,-3,-2,206,198,3,4,2,-1,-408,-212,-6,-6
"4352","18",399,6,4,1,3,84,79,1,1,141,-32,1,1,2,-4,-57,111,0,0
"4353","18",184,7,3,1,3,109,-2,2,2,88,-2,1,1,2,-5,21,0,1,1
"4354","18",476,5,3,1,0,72,81,0,0,98,-106,1,1,2,-3,-26,187,-1,-1
"4355","18",334,1,4,1,0,-239,-169,-4,-4,-236,-143,-4,-4,2,1,-3,-26,0,0
"4356","18",387,1,3,0,1,-141,-155,-3,-4,192,185,2,1,2,1,-333,-340,-5,-5
"4357","18",48,1,3,1,0,6,-10,-4,-4,87,-95,-4,-4,2,1,-81,85,0,0
"4358","18",397,6,4,1,3,101,167,0,1,-110,61,-1,-1,2,-4,211,106,1,2
"4359","18",474,1,1,0,0,3,-65,0,-4,5,-74,0,-4,2,1,-2,9,0,0
"4360","18",186,5,2,0,2,-1,5,0,0,-48,27,0,0,2,-3,47,-22,0,0
"4361","18",210,3,4,1,2,-40,20,2,-2,40,45,1,-1,2,-1,-80,-25,1,-1
"4362","18",400,2,4,1,2,-199,77,-3,-3,79,-40,2,0,2,0,-278,117,-5,-3
"4363","18",203,9,4,1,3,-24,10,4,4,-8,-240,4,4,2,-7,-16,250,0,0
"4364","18",5,2,2,0,2,-238,216,-2,-3,-240,234,-3,-4,2,0,2,-18,1,1
"4365","18",233,3,2,0,2,-210,23,-3,-2,-49,25,-1,-1,2,-1,-161,-2,-2,-1
"4366","18",208,5,4,1,2,-184,-212,0,0,75,-230,0,0,2,-3,-259,18,0,0
"4367","18",204,3,3,0,1,-55,115,-4,-2,121,-124,-2,-2,2,-1,-176,239,-2,0
"4368","18",17,1,3,1,0,26,5,0,-4,147,144,-1,-4,2,1,-121,-139,1,0
"4369","18",4,3,3,0,1,-3,5,-2,-2,217,200,1,4,2,-1,-220,-195,-3,-6
"4370","18",185,4,4,1,2,-21,-6,-3,-1,229,-23,-1,3,2,-2,-250,17,-2,-4
"4371","18",259,1,3,1,1,-117,34,4,-4,-44,33,4,-4,2,1,-73,1,0,0
"4372","18",202,6,1,0,1,-92,19,-2,1,20,35,-2,1,2,-4,-112,-16,0,0
"4373","18",24,1,2,1,2,-246,245,-4,-4,239,-1,4,4,2,1,-485,246,-8,-8
"4374","18",2,5,4,1,1,-15,-29,0,0,98,67,1,2,2,-3,-113,-96,-1,-2
"4375","18",232,1,1,0,0,-246,-244,-4,-4,-248,-237,-4,-4,2,1,2,-7,0,0
"4376","18",240,8,2,0,1,134,-55,-1,3,142,-32,1,-1,2,-6,-8,-23,-2,4
"4377","18",187,5,4,1,2,6,0,0,0,18,0,1,1,2,-3,-12,0,-1,-1
"4378","18",211,5,3,1,1,-64,-95,-3,0,117,199,-3,-1,2,-3,-181,-294,0,1
"4379","18",401,4,2,0,1,-17,1,3,-1,91,13,2,0,2,-2,-108,-12,1,-1
"4380","18",318,1,2,0,2,-187,-197,-4,-4,186,188,-4,0,2,1,-373,-385,0,-4
"4381","18",390,6,2,1,2,-43,-236,2,1,122,49,4,4,2,-4,-165,-285,-2,-3
"4382","18",234,4,3,1,3,133,28,0,-1,121,38,0,-1,2,-2,12,-10,0,0
"4383","18",310,2,4,1,2,-61,-3,-2,-3,95,0,1,1,2,0,-156,-3,-3,-4
"4384","18",199,2,4,1,2,-232,34,-1,-3,-105,15,-1,-1,2,0,-127,19,0,-2
"4385","18",335,2,2,0,1,-154,1,-2,-3,-100,-30,-1,-2,2,0,-54,31,-1,-1
"4386","18",388,4,4,1,0,-239,4,1,-1,-241,4,1,-1,2,-2,2,0,0,0
"4387","18",307,1,4,0,2,-148,55,-4,-4,-134,198,-4,-4,2,1,-14,-143,0,0
"4388","18",26,1,1,0,0,-226,1,-4,-4,-25,-86,-1,-4,2,1,-201,87,-3,0
"4389","18",336,3,4,1,3,-176,124,3,-2,222,112,2,-2,2,-1,-398,12,1,0
"4390","18",101,1,3,1,0,-240,236,-4,-4,234,236,-3,-3,2,1,-474,0,-1,-1
"4391","18",20,5,3,1,0,-195,-196,-2,0,105,94,2,2,2,-3,-300,-290,-4,-2
"4392","18",317,3,4,1,2,-95,106,-2,-2,-65,71,-2,-2,2,-1,-30,35,0,0
"4393","18",313,4,3,1,0,-176,-204,-2,-1,-35,-25,-1,-1,2,-2,-141,-179,-1,0
"4394","18",50,3,2,0,1,-2,-1,0,-2,153,0,2,-2,2,-1,-155,-1,-2,0
"4395","18",212,2,1,0,1,-213,-34,4,-3,-220,30,4,-2,2,0,7,-64,0,-1
"4396","18",362,6,4,1,3,101,-148,4,1,130,-117,2,-1,2,-4,-29,-31,2,2
"4397","18",286,6,1,0,3,79,-7,1,1,56,-4,-1,1,2,-4,23,-3,2,0
"4398","18",40,7,1,0,2,-204,-57,-3,2,159,130,2,1,2,-5,-363,-187,-5,1
"4399","18",403,1,1,0,0,-249,-4,-2,-4,-230,-18,-2,-4,2,1,-19,14,0,0
"4400","18",100,7,4,1,3,196,4,3,2,-101,0,-1,-1,2,-5,297,4,4,3
"4401","18",52,1,3,1,0,-237,6,-3,-4,182,2,3,-2,2,1,-419,4,-6,-2
"4402","18",404,5,1,0,1,48,-40,1,0,42,-56,1,-1,2,-3,6,16,0,1
"4403","18",312,5,4,1,1,92,50,0,0,-98,108,0,0,2,-3,190,-58,0,0
"4404","18",237,5,2,0,2,-239,1,-2,0,102,2,-1,1,2,-3,-341,-1,-1,-1
"4405","18",260,5,3,1,0,-1,1,0,0,-2,1,0,0,2,-3,1,0,0,0
"4406","18",337,8,2,0,3,-25,17,3,3,235,-25,4,4,2,-6,-260,42,-1,-1
"4407","18",188,9,2,1,3,211,-1,4,4,229,1,4,4,2,-7,-18,-2,0,0
"4408","18",200,1,3,1,0,-232,-155,-4,-4,-218,-20,-4,-4,2,1,-14,-135,0,0
"4409","18",402,1,3,1,0,-249,0,-4,-4,238,3,4,3,2,1,-487,-3,-8,-7
"4410","18",319,2,1,1,1,-232,-141,1,-3,43,61,2,1,2,0,-275,-202,-1,-4
"4411","18",464,3,1,0,1,-241,-1,0,-2,-188,18,-1,-1,2,-1,-53,-19,1,-1
"4412","18",235,4,3,1,0,-76,-4,-1,-1,3,4,0,0,2,-2,-79,-8,-1,-1
"4413","18",311,1,2,0,2,-202,4,-4,-4,177,9,4,-4,2,1,-379,-5,-8,0
"4414","18",236,5,1,0,1,-3,1,0,0,-3,1,0,0,2,-3,0,0,0,0
"4415","18",316,4,3,1,0,-136,-67,-1,-1,-129,-100,-1,-1,2,-2,-7,33,0,0
"4416","18",389,2,3,1,2,-4,5,-3,-3,7,16,0,0,2,0,-11,-11,-3,-3
"4417","18",308,1,4,1,0,-246,-242,-4,-4,124,103,2,4,2,1,-370,-345,-6,-8
"4418","18",53,7,4,1,3,225,1,2,2,192,1,2,2,2,-5,33,0,0,0
"4419","18",405,5,4,1,1,68,81,0,0,116,94,2,0,2,-3,-48,-13,-2,0
"4420","18",102,9,4,1,3,-140,97,0,4,66,-85,2,1,2,-7,-206,182,-2,3
"4421","18",238,3,3,0,1,-162,72,2,-2,44,-46,-2,-2,2,-1,-206,118,4,0
"4422","18",1,4,1,0,1,-48,-43,-1,-1,-69,-64,-1,0,2,-2,21,21,0,-1
"4423","18",314,1,4,1,1,-244,14,4,-4,-235,11,4,-4,2,1,-9,3,0,0
"4424","18",51,6,4,1,1,67,84,1,1,50,110,0,-1,2,-4,17,-26,1,2
"4425","18",213,5,2,1,1,31,2,0,0,0,35,-1,0,2,-3,31,-33,1,0
"4426","18",363,8,3,1,3,248,1,3,3,249,1,1,1,2,-6,-1,0,2,2
"4427","18",287,1,4,0,3,151,7,-4,-4,-187,-5,-3,-4,2,1,338,12,-1,0
"4428","18",465,6,4,1,3,249,-170,4,1,4,-231,4,4,2,-4,245,61,0,-3
"4429","18",28,4,4,1,1,-61,-60,-2,-1,-31,-84,-1,-1,2,-2,-30,24,-1,0
"4430","18",105,6,1,1,0,-43,1,1,1,-46,2,-1,1,2,-4,3,-1,2,0
"4431","18",356,3,4,1,1,-235,-2,-2,-2,129,-76,1,2,2,-1,-364,74,-3,-4
"4432","18",297,1,3,1,2,-218,32,-1,-4,221,222,4,4,2,1,-439,-190,-5,-8
"4433","18",470,4,1,1,1,-55,25,-1,-1,-74,10,-1,-1,2,-2,19,15,0,0
"4434","18",31,3,1,0,0,-134,-66,-2,-2,-186,95,-2,-2,2,-1,52,-161,0,0
"4435","18",261,9,1,0,3,210,191,4,4,210,214,4,4,2,-7,0,-23,0,0
"4436","18",338,2,3,1,2,45,-33,-1,-3,221,-234,4,1,2,0,-176,201,-5,-4
"4437","18",189,2,1,0,1,-193,45,3,-3,-216,40,3,-3,2,0,23,5,0,0
"4438","18",282,9,3,0,3,-26,-97,1,4,189,22,1,4,2,-7,-215,-119,0,0
"4439","18",279,6,4,1,3,100,-45,2,1,144,-31,2,2,2,-4,-44,-14,0,-1
"4440","18",104,2,1,0,0,-216,0,-3,-3,95,-1,-2,-2,2,0,-311,1,-1,-1
"4441","18",283,6,1,0,1,-95,-115,-2,1,122,-129,1,1,2,-4,-217,14,-3,0
"4442","18",351,1,1,0,0,-246,-246,-4,-4,244,244,-4,-4,2,1,-490,-490,0,0
"4443","18",47,7,4,1,3,210,-3,1,2,180,2,2,2,2,-5,30,-5,-1,0
"4444","18",309,8,4,1,2,25,-51,2,3,124,9,2,3,2,-6,-99,-60,0,0
"4445","18",466,3,3,1,0,-131,-37,-2,-2,-129,-124,-2,-2,2,-1,-2,87,0,0
"4446","18",462,9,3,1,3,234,182,4,4,176,171,4,4,2,-7,58,11,0,0
"4447","18",289,6,1,1,3,-144,-30,1,1,-194,-26,1,1,2,-4,50,-4,0,0
"4448","18",54,8,4,0,1,-213,20,1,3,59,18,-2,2,2,-6,-272,2,3,1
"4449","18",406,8,2,0,2,-89,-71,1,3,-48,-51,3,1,2,-6,-41,-20,-2,2
"4450","18",103,5,2,0,3,10,4,2,0,25,-117,-3,-4,2,-3,-15,121,5,4
"4451","18",239,6,1,0,1,71,97,2,1,99,107,-3,1,2,-4,-28,-10,5,0
"4452","18",10,3,3,1,1,-11,-2,-1,-2,2,1,0,0,2,-1,-13,-3,-1,-2
"4453","18",315,9,3,1,3,249,-13,3,4,240,13,3,3,2,-7,9,-26,0,1
"4454","18",355,1,2,0,2,-200,146,-4,-4,-193,153,-4,-4,2,1,-7,-7,0,0
"4455","18",214,9,1,1,3,153,-141,4,4,166,-41,4,4,2,-7,-13,-100,0,0
"4456","18",364,5,3,0,1,-101,-48,0,0,-68,-4,0,0,2,-3,-33,-44,0,0
"4457","18",288,7,2,0,2,-111,65,1,2,-96,67,0,1,2,-5,-15,-2,1,1
"4458","18",284,2,3,1,1,-149,-119,-2,-3,-56,89,-2,-3,2,0,-93,-208,0,0
"4459","18",280,6,2,0,1,-28,20,-1,1,228,-22,2,0,2,-4,-256,42,-3,1
"4460","18",106,7,2,0,1,-163,-145,2,2,-123,-17,-1,-1,2,-5,-40,-128,3,3
"4461","18",357,6,4,1,2,86,-22,1,1,58,-85,2,1,2,-4,28,63,-1,0
"4462","18",298,1,1,0,0,-14,235,-4,-4,22,-226,1,2,2,1,-36,461,-5,-6
"4463","18",471,5,3,1,2,-75,114,2,0,75,-151,0,2,2,-3,-150,265,2,-2
"4464","18",391,5,2,0,3,148,109,1,0,96,79,0,0,2,-3,52,30,1,0
"4465","18",262,6,4,1,3,112,166,1,1,55,77,0,1,2,-4,57,89,1,0
"4466","18",339,6,3,1,1,98,60,1,1,49,62,1,1,2,-4,49,-2,0,0
"4467","18",19,4,2,0,2,-154,-59,-1,-1,55,-35,-1,-2,2,-2,-209,-24,0,1
"4468","18",56,4,3,1,1,21,-116,-1,-1,21,-110,-2,0,2,-2,0,-6,1,-1
"4469","18",408,1,1,0,0,-223,216,0,-4,-150,1,-1,-2,2,1,-73,215,1,-2
"4470","18",276,7,4,1,3,190,-1,2,2,177,3,2,2,2,-5,13,-4,0,0
"4471","18",98,1,3,1,0,-237,52,-4,-4,-74,-89,2,-3,2,1,-163,141,-6,-1
"4472","18",352,4,2,0,1,13,-93,0,-1,18,-111,0,-1,2,-2,-5,18,0,0
"4473","18",373,1,3,0,0,-249,-216,0,-4,132,-48,-1,-4,2,1,-381,-168,1,0
"4474","18",394,1,3,1,0,-245,238,-4,-4,-244,242,-4,-4,2,1,-1,-4,0,0
"4475","18",467,5,1,1,3,-106,-122,4,0,110,61,4,0,2,-3,-216,-183,0,0
"4476","18",463,5,4,1,3,9,-19,0,0,238,-8,-4,4,2,-3,-229,-11,4,-4
"4477","18",29,1,4,1,0,-233,54,-4,-4,9,77,-2,-2,2,1,-242,-23,-2,-2
"4478","18",55,5,4,1,1,-25,-7,0,0,-16,1,0,0,2,-3,-9,-8,0,0
"4479","18",407,1,2,0,2,-245,44,-4,-4,231,72,4,4,2,1,-476,-28,-8,-8
"4480","18",275,4,4,1,2,-244,0,1,-1,-4,-230,3,-2,2,-2,-240,230,-2,1
"4481","18",359,9,4,1,3,229,13,4,4,230,20,4,4,2,-7,-1,-7,0,0
"4482","18",3,1,3,0,0,-237,6,0,-4,-192,-1,0,-3,2,1,-45,7,0,-1
"4483","18",271,4,3,1,1,119,-3,-2,-1,-134,0,1,4,2,-2,253,-3,-3,-5
"4484","18",393,1,1,0,0,-245,-1,-3,-4,-4,2,-4,0,2,1,-241,-3,1,-4
"4485","18",215,2,1,0,0,-139,27,-2,-3,-39,28,-2,-3,2,0,-100,-1,0,0
"4486","18",365,1,3,0,1,-198,3,4,-4,-226,3,4,-4,2,1,28,0,0,0
"4487","18",191,3,1,0,0,-135,-79,-2,-2,-193,-43,-2,-3,2,-1,58,-36,0,1
"4488","18",285,8,2,0,1,-1,-86,-2,3,-4,1,-2,2,2,-6,3,-87,0,1
"4489","18",281,1,4,1,2,-234,2,-4,-4,-245,3,-4,-4,2,1,11,-1,0,0
"4490","18",107,4,2,0,3,-207,-11,1,-1,-228,-36,1,-1,2,-2,21,25,0,0
"4491","18",358,1,4,1,2,-166,85,-4,-4,-238,196,-4,-4,2,1,72,-111,0,0
"4492","18",299,7,4,0,1,237,-1,2,2,68,182,2,2,2,-5,169,-183,0,0
"4493","18",472,1,1,0,0,-232,9,-4,-4,-75,10,-4,-4,2,1,-157,-1,0,0
"4494","18",392,3,1,0,0,-146,54,-2,-2,-131,77,-2,-2,2,-1,-15,-23,0,0
"4495","18",263,5,4,1,0,-6,-3,0,0,-2,6,4,4,2,-3,-4,-9,-4,-4
"4496","18",34,5,4,0,2,87,-52,1,0,113,-52,0,-1,2,-3,-26,0,1,1
"4497","18",190,7,4,1,3,185,207,-1,2,186,159,2,2,2,-5,-1,48,-3,0
"4498","18",57,1,4,1,1,-38,-222,-3,-4,-2,-192,-4,-4,2,1,-36,-30,1,0
"4499","18",409,3,4,1,2,-97,-87,-2,-2,131,121,2,2,2,-1,-228,-208,-4,-4
"4500","18",277,1,4,1,1,-41,86,4,-4,27,-90,0,0,2,1,-68,176,4,-4
"4501","18",99,8,4,1,3,30,226,3,3,210,-14,2,2,2,-6,-180,240,1,1
"4502","18",353,4,2,1,2,-236,192,2,-1,211,224,-4,-3,2,-2,-447,-32,6,2
"4503","18",374,5,4,1,2,17,10,0,0,20,12,0,0,2,-3,-3,-2,0,0
"4504","18",395,6,3,1,1,-209,17,3,1,237,11,-1,3,2,-4,-446,6,4,-2
"4505","18",468,3,1,0,3,124,69,-1,-2,166,25,2,2,2,-1,-42,44,-3,-4
"4506","18",367,5,3,1,1,-7,-8,0,0,6,12,1,0,2,-3,-13,-20,-1,0
"4507","18",290,4,1,0,1,-53,-51,0,-1,75,-47,0,-2,2,-2,-128,-4,0,1
"4508","18",165,5,1,0,1,64,37,0,0,80,103,1,1,2,-3,-16,-66,-1,-1
"4509","18",384,2,1,0,0,-228,0,-3,-3,-2,56,-2,-2,2,0,-226,-56,-1,-1
"4510","18",109,1,1,0,1,0,-122,3,-4,-1,-11,4,-4,2,1,1,-111,-1,0
"4511","18",36,8,3,1,3,103,67,3,3,-99,-170,-2,1,2,-6,202,237,5,2
"4512","18",30,5,2,0,2,33,3,1,0,-127,1,4,1,2,-3,160,2,-3,-1
"4513","18",272,4,4,1,2,44,40,0,-1,24,21,0,-1,2,-2,20,19,0,0
"4514","18",269,3,4,1,2,-249,38,-2,-2,-248,145,-2,-2,2,-1,-1,-107,0,0
"4515","18",216,3,3,1,1,11,8,-1,-2,51,-4,0,1,2,-1,-40,12,-1,-3
"4516","18",366,8,4,1,3,205,-30,4,3,119,-76,3,2,2,-6,86,46,1,1
"4517","18",192,6,4,1,1,0,3,0,1,194,-3,2,3,2,-4,-194,6,-2,-2
"4518","18",8,3,3,0,1,38,-80,1,-2,16,32,1,-1,2,-1,22,-112,0,-1
"4519","18",76,6,4,1,3,48,1,1,1,53,2,1,1,2,-4,-5,-1,0,0
"4520","18",108,9,2,0,3,217,25,3,4,229,45,4,4,2,-7,-12,-20,-1,0
"4521","18",306,5,3,1,3,126,137,1,0,116,145,1,0,2,-3,10,-8,0,0
"4522","18",72,5,1,0,0,-17,10,0,0,143,164,1,2,2,-3,-160,-154,-1,-2
"4523","18",376,3,4,1,1,22,-56,-2,-2,102,-54,-1,-1,2,-1,-80,-2,-1,-1
"4524","18",268,8,4,1,3,104,-80,2,3,99,-114,2,2,2,-6,5,34,0,1
"4525","18",264,1,4,0,2,-62,-3,-4,-4,-69,-33,-3,-4,2,1,7,30,-1,0
"4526","18",340,4,1,0,1,-111,-54,0,-1,59,19,0,0,2,-2,-170,-73,0,-1
"4527","18",292,5,3,1,1,-3,104,0,0,59,1,0,0,2,-3,-62,103,0,0
"4528","18",58,6,4,1,1,-244,25,-4,1,242,0,4,4,2,-4,-486,25,-8,-3
"4529","18",41,6,2,0,3,10,74,3,1,14,82,3,1,2,-4,-4,-8,0,0
"4530","18",278,1,4,1,1,-221,-221,4,-4,0,-220,4,-4,2,1,-221,-1,0,0
"4531","18",305,9,4,1,3,226,69,4,4,153,107,4,4,2,-7,73,-38,0,0
"4532","18",354,2,1,0,0,-106,-77,-1,-3,158,166,2,3,2,0,-264,-243,-3,-6
"4533","18",375,4,3,1,1,-23,-1,-1,-1,-1,1,0,0,2,-2,-22,-2,-1,-1
"4534","18",396,1,1,0,1,-222,195,4,-4,-180,109,4,-4,2,1,-42,86,0,0
"4535","18",469,1,4,1,0,59,3,-3,-4,111,36,-4,-4,2,1,-52,-33,1,0
"4536","18",368,9,3,1,3,-101,141,4,4,-141,138,4,4,2,-7,40,3,0,0
"4537","18",291,4,4,1,2,6,-63,-2,-1,70,58,-2,-1,2,-2,-64,-121,0,0
"4538","18",166,1,4,1,2,-174,103,-2,-4,194,188,-1,-2,2,1,-368,-85,-1,-2
"4539","18",385,4,4,0,1,-47,-148,-1,-1,154,76,4,2,2,-2,-201,-224,-5,-3
"4540","18",11,5,4,1,1,-190,-94,-2,0,108,-176,-2,2,2,-3,-298,82,0,-2
"4541","18",360,1,3,1,0,-153,-66,-2,-4,130,120,1,-4,2,1,-283,-186,-3,0
"4542","18",300,3,1,0,0,-109,40,-1,-2,45,76,1,1,2,-1,-154,-36,-2,-3
"4543","18",273,5,1,0,0,21,5,0,0,62,1,0,0,2,-3,-41,4,0,0
"4544","18",27,3,2,0,2,-161,111,-1,-2,-57,-82,0,0,2,-1,-104,193,-1,-2
"4545","18",217,2,4,1,2,-47,22,-1,-3,28,33,1,-1,2,0,-75,-11,-2,-2
"4546","18",342,1,3,0,1,-179,-18,-2,-4,-110,-19,-1,-2,2,1,-69,1,-1,-2
"4547","18",193,1,1,0,0,-235,-26,-4,-4,174,129,1,1,2,1,-409,-155,-5,-5
"4548","18",80,3,4,1,3,50,1,1,-2,244,2,4,-4,2,-1,-194,-1,-3,2
"4549","18",77,4,3,1,1,-51,7,-1,-1,-60,4,-1,1,2,-2,9,3,0,-2
"4550","18",133,1,2,0,1,-195,-228,0,-4,224,14,4,0,2,1,-419,-242,-4,-4
"4551","18",65,7,1,0,3,72,77,2,2,17,43,2,2,2,-5,55,34,0,0
"4552","18",73,5,4,1,2,-13,-12,0,0,-74,-61,0,0,2,-3,61,49,0,0
"4553","18",377,5,1,0,0,243,3,4,0,239,5,4,0,2,-3,4,-2,0,0
"4554","18",223,5,1,0,1,2,1,0,0,2,1,0,0,2,-3,0,0,0,0
"4555","18",265,8,1,0,3,185,1,3,3,1,-7,0,0,2,-6,184,8,3,3
"4556","18",341,9,1,1,3,193,-57,4,4,224,-24,4,4,2,-7,-31,-33,0,0
"4557","18",293,1,4,1,0,-218,19,-4,-4,-227,13,-4,-4,2,1,9,6,0,0
"4558","18",59,3,1,1,0,-193,1,-1,-2,-74,3,-1,-1,2,-1,-119,-2,0,-1
"4559","18",410,1,1,0,0,-240,-10,2,-4,-23,-13,1,-3,2,1,-217,3,1,-1
"4560","18",132,6,4,1,1,-63,-5,-1,1,67,-9,1,1,2,-4,-130,4,-2,0
"4561","18",270,5,3,1,1,-7,8,0,0,-2,164,2,0,2,-3,-5,-156,-2,0
"4562","18",302,3,1,0,0,-197,-24,-3,-2,215,59,-2,-2,2,-1,-412,-83,-1,0
"4563","18",69,1,4,1,1,-35,22,-2,-4,24,-125,-3,-4,2,1,-59,147,1,0
"4564","18",194,7,1,0,0,-219,7,-4,2,-242,7,-4,2,2,-5,23,0,0,0
"4565","18",219,5,4,1,3,-1,-249,4,0,249,2,4,0,2,-3,-250,-251,0,0
"4566","18",369,2,4,1,0,-229,-1,-3,-3,73,1,0,0,2,0,-302,-2,-3,-3
"4567","18",195,1,1,0,1,-180,190,4,-4,94,-108,3,1,2,1,-274,298,1,-5
"4568","18",82,8,4,1,2,85,-86,4,3,220,-53,4,4,2,-6,-135,-33,0,-1
"4569","18",79,2,4,1,2,-221,216,-3,-3,-217,192,-4,-4,2,0,-4,24,1,1
"4570","18",110,7,1,0,1,-128,72,-4,2,47,-126,-4,1,2,-5,-175,198,0,1
"4571","18",361,1,1,0,0,-230,1,-2,-4,245,-1,4,4,2,1,-475,2,-6,-8
"4572","18",301,5,4,1,1,-6,66,0,0,-140,1,-2,-1,2,-3,134,65,2,1
"4573","18",274,6,4,1,2,-16,-237,1,1,-14,-209,1,1,2,-4,-2,-28,0,0
"4574","18",294,7,1,0,3,226,5,2,2,-1,2,0,2,2,-5,227,3,2,0
"4575","18",218,8,4,1,3,-227,-106,4,3,-216,-84,4,3,2,-6,-11,-22,0,0
"4576","18",343,3,2,0,2,-108,3,-2,-2,-8,6,-1,-1,2,-1,-100,-3,-1,-1
"4577","18",112,7,4,1,3,91,1,2,2,16,240,4,4,2,-5,75,-239,-2,-2
"4578","18",81,9,1,0,0,-229,204,0,4,-220,195,3,-3,2,-7,-9,9,-3,7
"4579","18",78,2,4,1,0,-190,-4,-3,-3,-223,0,-3,-3,2,0,33,-4,0,0
"4580","18",134,6,2,0,2,-16,-5,1,1,9,-4,1,0,2,-4,-25,-1,0,1
"4581","18",66,4,1,1,1,-55,2,-1,-1,-158,-3,-1,0,2,-2,103,5,0,-1
"4582","18",74,4,3,1,0,-193,-68,-2,-1,-167,-102,-3,-1,2,-2,-26,34,1,0
"4583","18",378,4,4,1,1,-89,-2,-1,-1,-111,-2,-3,-1,2,-2,22,0,2,0
"4584","18",224,3,2,1,2,-139,-41,-2,-2,194,72,2,1,2,-1,-333,-113,-4,-3
"4585","18",266,3,1,0,1,-103,1,-2,-2,-30,-203,-2,-2,2,-1,-73,204,0,0
"4586","18",370,9,1,0,3,239,-28,4,4,229,-25,-4,-4,2,-7,10,-3,8,8
"4587","18",111,2,1,1,0,-154,-154,-4,-3,110,98,2,-3,2,0,-264,-252,-6,0
"4588","18",6,9,4,0,2,219,0,4,4,84,0,4,4,2,-7,135,0,0,0
"4589","18",411,1,2,0,2,-226,-229,-4,-4,-240,-232,-4,-4,2,1,14,3,0,0
"4590","18",38,5,4,1,3,6,-15,0,0,6,-15,0,0,2,-3,0,0,0,0
"4591","18",226,1,1,0,0,20,3,-1,-4,159,3,1,-3,2,1,-139,0,-2,-1
"4592","18",303,1,3,1,2,-198,-196,-4,-4,-165,-150,-2,-3,2,1,-33,-46,-2,-1
"4593","18",7,4,1,0,3,1,-172,0,-1,72,24,1,1,2,-2,-71,-196,-1,-2
"4594","18",296,6,1,0,3,120,-13,1,1,0,163,1,1,2,-4,120,-176,0,0
"4595","18",22,6,3,1,1,106,0,1,1,75,9,1,1,2,-4,31,-9,0,0
"4596","18",37,1,1,0,0,-204,24,-4,-4,-154,19,-3,-4,2,1,-50,5,-1,0
"4597","18",196,2,3,0,0,-151,-93,-2,-3,156,122,2,2,2,0,-307,-215,-4,-5
"4598","18",83,6,1,0,3,113,-130,2,1,121,-125,2,1,2,-4,-8,-5,0,0
"4599","18",14,3,3,1,1,-162,4,-2,-2,146,-39,0,0,2,-1,-308,43,-2,-2
"4600","18",379,3,3,0,1,32,-63,-1,-2,85,61,1,0,2,-1,-53,-124,-2,-2
"4601","18",225,4,2,1,2,58,-75,1,-1,88,-60,1,1,2,-2,-30,-15,0,-2
"4602","18",435,5,4,0,1,30,-44,0,0,3,3,-2,0,2,-3,27,-47,2,0
"4603","18",371,2,3,0,0,-187,-119,-3,-3,216,18,-2,-2,2,0,-403,-137,-1,-1
"4604","18",295,5,1,0,1,0,0,0,0,-6,-1,0,0,2,-3,6,1,0,0
"4605","18",348,5,3,1,1,-1,7,-4,0,64,63,0,0,2,-3,-65,-56,-4,0
"4606","18",344,6,4,1,3,139,-22,3,1,-38,-35,4,-1,2,-4,177,13,-1,2
"4607","18",113,4,2,1,2,18,3,-2,-1,160,13,0,0,2,-2,-142,-10,-2,-1
"4608","18",61,2,1,0,3,230,34,3,-3,-117,-13,3,-4,2,0,347,47,0,1
"4609","18",413,6,1,0,1,131,1,1,1,174,-117,3,1,2,-4,-43,118,-2,0
"4610","18",135,5,1,0,1,-155,-145,0,0,123,-81,0,0,2,-3,-278,-64,0,0
"4611","18",67,1,1,0,0,-235,27,-4,-4,211,-198,3,3,2,1,-446,225,-7,-7
"4612","18",75,3,4,1,2,229,69,3,-2,155,39,1,-3,2,-1,74,30,2,1
"4613","18",346,7,3,0,0,0,-44,0,2,193,1,4,4,2,-5,-193,-45,-4,-2
"4614","18",197,2,4,1,3,-88,-111,1,-3,71,27,1,2,2,0,-159,-138,0,-5
"4615","18",267,4,3,0,1,43,-5,-1,-1,85,-2,2,1,2,-2,-42,-3,-3,-2
"4616","18",140,3,1,0,1,-44,42,-1,-2,-30,8,0,-1,2,-1,-14,34,-1,-1
"4617","18",460,1,1,0,0,-224,172,-4,-4,229,103,-3,1,2,1,-453,69,-1,-5
"4618","18",60,7,1,0,3,-6,82,2,2,216,3,2,2,2,-5,-222,79,0,0
"4619","18",412,9,1,0,0,-149,-8,-4,4,-134,-42,4,4,2,-7,-15,34,-8,0
"4620","18",380,1,4,1,1,-209,-40,3,-4,-120,-58,3,-3,2,1,-89,18,0,-1
"4621","18",227,6,3,0,3,-43,-8,2,1,57,30,2,-1,2,-4,-100,-38,0,2
"4622","18",304,4,2,0,2,122,-31,-2,-1,31,-34,1,1,2,-2,91,3,-3,-2
"4623","18",70,1,2,0,2,-238,-209,0,-4,-70,-24,-3,-4,2,1,-168,-185,3,0
"4624","18",90,4,4,1,0,-182,21,-1,-1,119,16,1,1,2,-2,-301,5,-2,-2
"4625","18",220,2,4,1,2,-231,71,-4,-3,128,122,-2,-2,2,0,-359,-51,-2,-1
"4626","18",414,4,1,0,0,-75,-66,-1,-1,84,89,2,2,2,-2,-159,-155,-3,-3
"4627","18",136,1,1,0,0,-205,156,-4,-4,195,-111,-3,-3,2,1,-400,267,-1,-1
"4628","18",84,8,4,1,3,191,3,3,3,170,0,2,2,2,-6,21,3,1,1
"4629","18",221,3,4,1,1,-173,-2,-2,-2,-1,9,-2,-2,2,-1,-172,-11,0,0
"4630","18",431,4,3,1,0,-24,17,-2,-1,65,57,-1,-1,2,-2,-89,-40,-1,0
"4631","18",428,2,1,0,0,-75,-74,-2,-3,137,123,0,0,2,0,-212,-197,-2,-3
"4632","18",436,5,4,1,3,1,53,2,0,41,35,-4,-2,2,-3,-40,18,6,2
"4633","18",372,1,3,1,0,-5,-241,-4,-4,-248,-245,-4,-4,2,1,243,4,0,0
"4634","18",125,4,4,1,0,-128,-34,-3,-1,-94,-21,-4,-1,2,-2,-34,-13,1,0
"4635","18",349,3,4,0,1,-34,-59,-2,-2,-83,82,1,3,2,-1,49,-141,-3,-5
"4636","18",345,8,1,0,0,-191,205,-4,3,102,-195,-2,-3,2,-6,-293,400,-2,6
"4637","18",114,2,4,1,1,-67,-80,1,-3,171,177,1,-3,2,0,-238,-257,0,0
"4638","18",62,9,2,0,3,211,212,4,4,236,234,4,4,2,-7,-25,-22,0,0
"4639","18",438,5,4,1,3,3,4,4,0,3,-11,4,0,2,-3,0,15,0,0
"4640","18",71,4,3,1,1,-44,19,-1,-1,32,19,-1,0,2,-2,-76,0,0,-1
"4641","18",68,1,4,1,0,2,2,0,-4,187,4,-1,-3,2,1,-185,-2,1,-1
"4642","18",63,5,4,0,1,-2,4,0,0,-2,4,0,0,2,-3,0,0,0,0
"4643","18",347,6,1,1,3,-63,-168,2,1,70,143,1,-1,2,-4,-133,-311,1,2
"4644","18",198,2,1,0,1,-138,46,-1,-3,44,64,1,2,2,0,-182,-18,-2,-5
"4645","18",222,2,1,0,0,0,0,-3,-3,-245,6,-4,-4,2,0,245,-6,1,1
"4646","18",141,1,1,0,0,-205,13,-2,-4,114,20,2,3,2,1,-319,-7,-4,-7
"4647","18",461,3,4,1,2,-19,27,-1,-2,76,46,1,1,2,-1,-95,-19,-2,-3
"4648","18",86,8,4,1,3,118,-4,3,3,154,-2,2,1,2,-6,-36,-2,1,2
"4649","18",142,4,2,0,2,-115,16,-4,-1,-1,2,-2,0,2,-2,-114,14,-2,-1
"4650","18",381,1,2,0,2,-225,217,-4,-4,225,213,2,2,2,1,-450,4,-6,-6
"4651","18",228,5,4,1,2,-178,69,0,0,83,131,3,3,2,-3,-261,-62,-3,-3
"4652","18",35,3,1,0,3,49,158,2,-2,121,140,2,-2,2,-1,-72,18,0,0
"4653","18",450,3,4,1,3,203,-5,1,-2,83,0,1,-2,2,-1,120,-5,0,0
"4654","18",91,7,2,1,3,77,6,2,2,60,9,1,2,2,-5,17,-3,1,0
"4655","18",229,7,1,0,1,123,-39,2,2,60,43,2,2,2,-5,63,-82,0,0
"4656","18",415,2,2,0,2,-119,-24,0,-3,131,190,0,1,2,0,-250,-214,0,-4
"4657","18",137,1,1,1,1,-79,-56,-3,-4,-245,-245,-4,-4,2,1,166,189,1,0
"4658","18",85,2,2,0,2,-128,-118,-2,-3,90,-81,1,0,2,0,-218,-37,-3,-3
"4659","18",157,1,3,1,2,-195,3,-4,-4,174,171,-3,0,2,1,-369,-168,-1,-4
"4660","18",432,4,2,0,1,43,-53,-1,-1,43,-41,0,0,2,-2,0,-12,-1,-1
"4661","18",429,1,2,0,0,-221,-222,-4,-4,-198,-189,-4,-4,2,1,-23,-33,0,0
"4662","18",437,1,1,0,0,-146,1,-4,-4,-144,-2,-1,-1,2,1,-2,3,-3,-3
"4663","18",45,1,3,0,0,-114,39,-4,-4,-69,-57,1,-2,2,1,-45,96,-5,-2
"4664","18",126,1,2,1,2,-5,-3,-4,-4,25,43,-2,-3,2,1,-30,-46,-2,-1
"4665","18",87,8,4,1,3,0,0,3,3,-53,174,3,3,2,-6,53,-174,0,0
"4666","18",143,8,1,0,3,144,-10,3,3,156,-44,3,3,2,-6,-12,34,0,0
"4667","18",115,9,3,1,3,4,2,4,4,-6,4,0,0,2,-7,10,-2,4,4
"4668","18",127,1,1,0,0,-233,-1,-3,-4,0,1,2,-3,2,1,-233,-2,-5,-1
"4669","18",350,1,4,1,1,-244,7,-4,-4,247,-4,4,2,2,1,-491,11,-8,-6
"4670","18",383,5,4,1,1,-2,-1,0,0,3,-1,0,0,2,-3,-5,0,0,0
"4671","18",23,9,1,0,3,-220,-222,-4,4,229,213,4,4,2,-7,-449,-435,-8,0
"4672","18",64,1,1,0,1,-223,218,-4,-4,222,-223,-1,-2,2,1,-445,441,-3,-2
"4673","18",129,6,4,1,1,186,-4,1,1,177,5,2,2,2,-4,9,-9,-1,-1
"4674","18",93,5,1,0,1,-172,58,-2,0,-95,14,-1,1,2,-3,-77,44,-1,-1
"4675","18",154,6,4,1,3,53,27,1,1,57,90,0,0,2,-4,-4,-63,1,1
"4676","18",417,5,2,0,2,0,-3,0,0,-15,-25,-3,-3,2,-3,15,22,3,3
"4677","18",139,1,4,1,2,-241,2,-3,-4,-243,-3,-4,-4,2,1,2,5,1,0
"4678","18",43,1,3,0,0,-149,11,-4,-4,115,2,-2,-4,2,1,-264,9,-2,0
"4679","18",155,5,2,0,1,-2,11,0,0,-3,2,0,0,2,-3,1,9,0,0
"4680","18",382,5,4,1,2,40,10,0,0,54,13,1,1,2,-3,-14,-3,-1,-1
"4681","18",439,5,2,0,1,-2,-2,0,0,3,5,0,0,2,-3,-5,-7,0,0
"4682","18",88,4,4,1,2,-87,-33,-1,-1,212,-231,4,4,2,-2,-299,198,-5,-5
"4683","18",451,1,1,0,0,-226,-182,-4,-4,-240,-129,-4,-4,2,1,14,-53,0,0
"4684","18",92,4,4,1,2,-82,-69,-1,-1,-123,-105,-1,-1,2,-2,41,36,0,0
"4685","18",164,6,2,1,2,8,-25,1,1,-148,-42,-3,-3,2,-4,156,17,4,4
"4686","18",416,1,4,1,0,-229,239,-4,-4,-196,226,-4,4,2,1,-33,13,0,-8
"4687","18",138,5,3,1,1,6,-90,0,0,-17,-2,0,0,2,-3,23,-88,0,0
"4688","18",121,1,1,0,0,-178,22,-4,-4,241,-137,-1,-4,2,1,-419,159,-3,0
"4689","18",158,1,3,0,0,-227,-26,-4,-4,-48,-41,-4,-2,2,1,-179,15,0,-2
"4690","18",433,2,1,1,0,-235,-238,-3,-3,-15,-26,-2,-2,2,0,-220,-212,-1,-1
"4691","18",94,3,4,1,1,-112,-88,-2,-2,161,161,2,2,2,-1,-273,-249,-4,-4
"4692","18",122,2,1,0,0,0,0,-4,-3,210,226,4,4,2,0,-210,-226,-8,-7
"4693","18",130,9,1,0,3,218,27,4,4,94,27,4,4,2,-7,124,0,0,0
"4694","18",434,6,4,1,3,41,-35,3,1,139,-44,-1,2,2,-4,-98,9,4,-1
"4695","18",430,5,2,1,1,30,-34,0,0,144,-64,1,1,2,-3,-114,30,-1,-1
"4696","18",144,1,3,0,0,-248,-1,-4,-4,153,3,0,-1,2,1,-401,-4,-4,-3
"4697","18",116,8,2,0,3,87,-57,1,3,122,-10,2,2,2,-6,-35,-47,-1,1
"4698","18",128,7,1,0,3,221,2,2,2,221,2,2,2,2,-5,0,0,0,0
"4699","18",160,7,2,0,0,-214,-5,-4,2,-217,13,-4,2,2,-5,3,-18,0,0
"4700","18",452,5,3,0,1,-1,-44,0,0,-76,5,-1,-1,2,-3,75,-49,1,1
"4701","18",161,1,2,0,2,-245,184,-4,-4,93,41,1,-4,2,1,-338,143,-5,0
"4702","18",9,4,4,1,2,32,14,1,-1,-42,9,1,-1,2,-2,74,5,0,0
"4703","18",13,3,4,1,1,2,-120,-1,-2,-26,-137,-2,-2,2,-1,28,17,1,0
"4704","18",118,4,3,0,1,-51,-38,-2,-1,-1,-20,-1,1,2,-2,-50,-18,-1,-2
"4705","18",162,9,3,0,3,64,84,0,4,103,123,3,4,2,-7,-39,-39,-3,0
"4706","18",418,5,2,1,2,42,-21,1,0,46,-10,1,0,2,-3,-4,-11,0,0
"4707","18",454,8,4,1,3,222,-1,3,3,208,1,2,3,2,-6,14,-2,1,0
"4708","18",95,1,4,1,2,-245,1,-4,-4,-159,-4,-3,-3,2,1,-86,5,-1,-1
"4709","18",156,5,2,0,1,63,-37,0,0,4,-1,0,0,2,-3,59,-36,0,0
"4710","18",131,9,4,1,3,65,-17,0,4,51,-18,0,3,2,-7,14,1,0,1
"4711","18",44,1,2,0,2,-244,184,-4,-4,101,4,0,-4,2,1,-345,180,-4,0
"4712","18",89,2,3,1,0,-164,2,-4,-3,-248,3,-4,-3,2,0,84,-1,0,0
"4713","18",145,5,1,0,1,-46,-98,0,0,-128,-215,0,0,2,-3,82,117,0,0
"4714","18",97,1,1,0,1,-234,9,3,-4,-231,13,3,-3,2,1,-3,-4,0,-1
"4715","18",440,3,3,1,0,-34,-1,-2,-2,-3,1,-1,-1,2,-1,-31,-2,-1,-1
"4716","18",146,2,2,0,0,-195,-157,-3,-3,-180,-200,-4,-4,2,0,-15,43,1,1
"4717","18",453,5,4,1,2,-148,-2,0,0,-6,-193,1,-2,2,-3,-142,191,-1,2
"4718","18",441,8,4,1,2,31,-234,4,3,30,-187,3,2,2,-6,1,-47,1,1
"4719","18",159,1,3,1,2,232,10,-1,-4,235,0,4,4,2,1,-3,10,-5,-8
"4720","18",147,6,2,0,3,-134,90,1,1,81,-52,3,3,2,-4,-215,142,-2,-2
"4721","18",119,7,3,1,3,85,109,1,2,-98,-96,2,2,2,-5,183,205,-1,0
"4722","18",123,3,4,1,2,-79,21,-2,-2,-73,34,-2,-2,2,-1,-6,-13,0,0
"4723","18",419,6,4,1,3,98,103,1,1,161,114,1,0,2,-4,-63,-11,0,1
"4724","18",455,2,2,0,2,-247,5,-3,-3,-4,237,4,3,2,0,-243,-232,-7,-6
"4725","18",96,3,1,0,0,-182,-4,-2,-2,-166,18,-3,-3,2,-1,-16,-22,1,1
"4726","18",124,8,1,0,3,181,20,4,3,250,38,3,3,2,-6,-69,-18,1,0
"4727","18",117,3,4,1,2,-169,-1,-2,-2,-119,-4,-3,-3,2,-1,-50,3,1,1
"4728","18",46,1,1,0,0,-36,-239,-4,-4,106,-29,4,4,2,1,-142,-210,-8,-8
"4729","18",424,3,2,0,2,-90,-13,-2,-2,38,17,1,-1,2,-1,-128,-30,-3,-1
"4730","18",420,8,4,1,3,-1,-1,2,3,-2,0,1,0,2,-6,1,-1,1,3
"4731","18",457,2,3,1,1,-80,99,-2,-3,19,-9,1,0,2,0,-99,108,-3,-3
"4732","18",150,2,3,1,1,247,2,-3,-3,-249,1,0,0,2,0,496,1,-3,-3
"4733","18",425,5,4,1,2,-68,-80,0,0,-4,-17,0,0,2,-3,-64,-63,0,0
"4734","18",458,2,1,0,1,-66,-71,0,-3,72,85,-1,-2,2,0,-138,-156,1,-1
"4735","18",163,6,3,1,1,60,-15,2,1,67,1,1,0,2,-4,-7,-16,1,1
"4736","18",16,1,1,0,0,-237,13,-3,-4,241,8,2,1,2,1,-478,5,-5,-5
"4737","18",148,2,1,0,1,-147,-8,2,-3,0,-74,2,0,2,0,-147,66,0,-3
"4738","18",12,9,4,1,3,2,-1,4,4,2,0,4,4,2,-7,0,-1,0,0
"4739","18",443,2,1,0,0,-248,-219,-3,-3,47,-2,0,0,2,0,-295,-217,-3,-3
"4740","18",456,1,1,0,0,-208,69,-2,-4,-98,-96,-1,-3,2,1,-110,165,-1,-1
"4741","18",149,5,3,0,1,-243,-9,-4,0,247,-1,-3,1,2,-3,-490,-8,-1,-1
"4742","18",120,9,3,1,1,83,-63,2,4,152,101,2,2,2,-7,-69,-164,0,2
"4743","18",153,6,1,0,3,-46,-79,0,1,-5,1,1,1,2,-4,-41,-80,-1,0
"4744","18",15,6,4,1,3,219,26,3,1,73,31,3,2,2,-4,146,-5,0,-1
"4745","18",445,6,4,1,3,98,-30,1,1,88,-61,1,1,2,-4,10,31,0,0
"4746","18",449,6,4,1,3,14,64,1,1,32,82,1,1,2,-4,-18,-18,0,0
"4747","18",421,9,3,1,1,-106,-110,-1,4,105,102,-1,1,2,-7,-211,-212,0,3
"4748","18",442,6,4,1,1,-67,31,-1,1,27,26,1,1,2,-4,-94,5,-2,0
"4749","18",151,1,2,0,1,-235,10,0,-4,-241,10,0,-4,2,1,6,0,0,0
"4750","18",426,9,4,0,3,2,-244,4,4,245,-1,4,4,2,-7,-243,-243,0,0
"4751","18",459,2,3,0,1,-118,156,4,-3,-52,37,3,-4,2,0,-66,119,1,1
"4752","18",444,1,2,0,2,-227,94,-4,-4,-225,85,-4,-4,2,1,-2,9,0,0
"4753","18",42,3,3,0,1,-72,64,2,-2,-81,37,2,-3,2,-1,9,27,0,1
"4754","18",427,1,4,0,1,-200,-37,4,-4,-202,-65,4,-4,2,1,2,28,0,0
"4755","18",423,4,1,0,3,243,-54,2,-1,-34,184,1,2,2,-2,277,-238,1,-3
"4756","18",422,1,3,0,1,-99,-167,4,-4,-90,-154,4,0,2,1,-9,-13,0,-4
"4757","18",448,9,2,0,2,1,-158,2,4,1,-212,4,4,2,-7,0,54,-2,0
"4758","18",446,5,4,1,1,-33,-21,-1,0,8,25,0,0,2,-3,-41,-46,-1,0
"4759","18",447,4,4,1,2,-92,12,-2,-1,48,41,-1,-2,2,-2,-140,-29,-1,1
"4760","18",152,3,1,0,0,-81,1,0,-2,212,-1,0,-2,2,-1,-293,2,0,0
"4761","19",53,6,4,1,3,193,0,1,1,219,-1,2,2,3,-3,-26,1,-1,-1
"4762","19",52,2,3,0,0,-197,4,2,-3,-111,6,-1,-3,3,1,-86,-2,3,0
"4763","19",474,1,1,0,0,2,-67,0,-4,4,-63,0,-4,3,2,-2,-4,0,0
"4764","19",49,2,4,0,1,-128,-45,-3,-3,-134,-56,-3,-1,3,1,6,11,0,-2
"4765","19",179,5,1,0,1,-1,-5,0,0,-4,168,2,-1,3,-2,3,-173,-2,1
"4766","19",51,5,4,1,1,69,0,1,0,78,30,2,1,3,-2,-9,-30,-1,-1
"4767","19",475,6,3,1,3,105,-116,1,1,102,-235,1,1,3,-3,3,119,0,0
"4768","19",50,3,2,1,1,-2,2,0,-2,-34,0,0,-2,3,0,32,2,0,0
"4769","19",473,4,3,1,0,14,-135,-1,-1,-30,16,-1,-1,3,-1,44,-151,0,0
"4770","19",48,1,3,1,0,5,-5,-4,-4,83,-76,-4,-4,3,2,-78,71,0,0
"4771","19",476,5,3,1,0,152,-47,0,0,-68,-78,1,2,3,-2,220,31,-1,-2
"4772","19",40,8,1,0,2,-177,-41,-3,3,153,-55,3,2,3,-5,-330,14,-6,1
"4773","19",403,1,1,0,0,-153,-39,-3,-4,-234,-18,-3,-4,3,2,81,-21,0,0
"4774","19",407,2,2,0,2,-242,-58,-3,-3,155,65,2,2,3,1,-397,-123,-5,-5
"4775","19",406,8,2,1,2,-145,-123,2,3,16,-27,2,1,3,-5,-161,-96,0,2
"4776","19",400,5,4,1,2,-115,79,-4,0,88,-107,-2,-2,3,-2,-203,186,-2,2
"4777","19",5,1,2,0,2,-235,227,-2,-4,-218,177,-3,-4,3,2,-17,50,1,0
"4778","19",408,5,1,1,0,-196,211,1,0,-161,-2,-1,-2,3,-2,-35,213,2,2
"4779","19",56,4,3,1,1,44,-122,-2,-1,40,-121,-2,-1,3,-1,4,-1,0,0
"4780","19",401,4,2,0,1,-86,16,2,-1,53,11,1,0,3,-1,-139,5,1,-1
"4781","19",405,3,4,1,1,-184,3,-3,-2,168,115,2,0,3,0,-352,-112,-5,-2
"4782","19",54,6,4,0,1,-188,28,-1,1,73,26,-2,1,3,-3,-261,2,1,0
"4783","19",402,1,3,1,0,-238,0,-3,-4,-249,4,-4,-4,3,2,11,-4,1,0
"4784","19",61,7,1,0,3,245,-28,3,2,-103,74,4,-3,3,-4,348,-102,-1,5
"4785","19",55,6,4,1,1,-16,-6,0,1,-12,-10,0,0,3,-3,-4,4,0,1
"4786","19",59,3,1,0,0,-110,-2,-2,-2,-1,45,-1,-1,3,0,-109,-47,-1,-1
"4787","19",143,8,1,0,3,83,43,3,3,55,-110,3,3,3,-5,28,153,0,0
"4788","19",178,5,1,0,1,0,4,0,0,0,-9,0,0,3,-2,0,13,0,0
"4789","19",6,9,4,0,2,248,1,4,4,237,73,4,4,3,-6,11,-72,0,0
"4790","19",404,4,1,0,1,60,-46,1,-1,39,-47,1,0,3,-1,21,1,0,-1
"4791","19",100,8,4,1,3,186,-1,3,3,-2,-49,2,2,3,-5,188,48,1,1
"4792","19",57,1,4,1,1,-47,-234,-2,-4,-25,-205,-3,-4,3,2,-22,-29,1,0
"4793","19",60,7,1,0,3,187,7,2,2,210,4,2,2,3,-4,-23,3,0,0
"4794","19",101,1,3,1,0,-233,234,-4,-4,212,225,-3,-3,3,2,-445,9,-1,-1
"4795","19",18,2,3,1,1,-26,-29,0,-3,77,163,1,0,3,1,-103,-192,-1,-3
"4796","19",58,6,4,1,1,-242,0,-3,1,-3,247,4,3,3,-3,-239,-247,-7,-2
"4797","19",399,6,4,1,3,102,11,1,1,106,19,1,1,3,-3,-4,-8,0,0
"4798","19",41,6,2,0,3,11,84,3,1,25,79,3,1,3,-3,-14,5,0,0
"4799","19",180,3,2,1,2,17,-5,0,-2,-89,-2,-2,-3,3,0,106,-3,2,1
"4800","19",169,1,3,0,0,-226,190,-4,-4,-221,212,-4,-4,3,2,-5,-22,0,0
"4801","19",410,2,1,0,0,-121,-10,1,-3,-199,-20,1,-4,3,1,78,10,0,1
"4802","19",181,2,4,1,3,-4,169,-3,-3,166,-77,2,2,3,1,-170,246,-5,-5
"4803","19",245,1,1,1,0,-192,-12,-3,-4,-174,-14,-4,-4,3,2,-18,2,1,0
"4804","19",144,1,3,1,0,-172,2,-4,-4,123,-33,2,0,3,2,-295,35,-6,-4
"4805","19",182,6,4,0,3,5,-106,2,1,-1,-169,2,2,3,-3,6,63,0,-1
"4806","19",398,6,4,1,2,46,31,1,1,27,27,1,1,3,-3,19,4,0,0
"4807","19",246,7,4,1,3,105,-5,3,2,139,-3,2,1,3,-4,-34,-2,1,1
"4808","19",409,3,4,1,2,-39,-27,-2,-2,127,100,2,2,3,0,-166,-127,-4,-4
"4809","19",168,7,1,0,3,162,-137,1,2,82,-55,1,2,3,-4,80,-82,0,0
"4810","19",171,5,1,0,1,30,4,0,0,19,6,0,0,3,-2,11,-2,0,0
"4811","19",102,5,4,1,3,153,83,4,0,-148,91,3,3,3,-2,301,-8,1,-3
"4812","19",413,3,1,0,1,-167,-10,-2,-2,195,-12,1,1,3,0,-362,2,-3,-3
"4813","19",184,7,3,1,3,169,-1,2,2,195,7,2,2,3,-4,-26,-8,0,0
"4814","19",62,9,2,0,3,229,212,4,4,234,228,4,4,3,-6,-5,-16,0,0
"4815","19",414,4,1,1,0,-54,-43,-1,-1,108,86,2,2,3,-1,-162,-129,-3,-3
"4816","19",397,5,4,1,3,38,112,0,0,35,79,1,0,3,-2,3,33,-1,0
"4817","19",104,2,1,1,0,18,0,-1,-3,25,2,-1,-4,3,1,-7,-2,0,1
"4818","19",411,1,2,0,2,-5,-245,-4,-4,-227,-223,-4,-4,3,2,222,-22,0,0
"4819","19",167,7,1,0,3,108,-107,2,2,-187,-131,-2,-2,3,-4,295,24,4,4
"4820","19",105,6,1,1,0,36,0,0,1,99,22,0,1,3,-3,-63,-22,0,0
"4821","19",331,2,1,1,0,68,-183,-4,-3,39,-213,-4,-3,3,1,29,30,0,0
"4822","19",183,5,4,1,1,41,61,1,0,32,29,0,-1,3,-2,9,32,1,1
"4823","19",187,3,4,1,2,-189,-25,-2,-2,-103,29,-1,-1,3,0,-86,-54,-1,-1
"4824","19",327,6,4,0,3,32,-143,3,1,20,-118,1,-1,3,-3,12,-25,2,2
"4825","19",332,1,1,0,0,-249,73,-4,-4,-250,103,-3,-3,3,2,1,-30,-1,-1
"4826","19",1,4,1,0,1,-156,-107,-2,-1,-91,-30,-2,-1,3,-1,-65,-77,0,0
"4827","19",4,5,3,0,1,240,229,0,0,239,230,3,3,3,-2,1,-1,-3,-3
"4828","19",103,3,2,0,3,120,13,0,-2,-19,167,-3,-4,3,0,139,-154,3,2
"4829","19",185,6,4,1,2,16,-9,-3,1,226,-22,-1,3,3,-3,-210,13,-2,-2
"4830","19",17,1,3,1,0,61,30,-1,-4,133,94,-1,-4,3,2,-72,-64,0,0
"4831","19",330,5,2,0,2,-245,-1,0,0,192,142,1,1,3,-2,-437,-143,-1,-1
"4832","19",186,5,2,0,2,2,-14,0,0,-38,27,0,0,3,-2,40,-41,0,0
"4833","19",170,1,2,0,0,-242,-245,-4,-4,10,12,0,0,3,2,-252,-257,-4,-4
"4834","19",145,5,1,0,1,1,3,0,0,-36,-70,0,0,3,-2,37,73,0,0
"4835","19",412,9,1,0,0,-129,98,-4,4,-126,-132,4,4,3,-6,-3,230,-8,0
"4836","19",175,6,4,1,1,-97,58,-1,1,-56,-13,-3,-1,3,-3,-41,71,2,2
"4837","19",106,3,2,1,1,-85,-40,-2,-2,-196,-138,-1,-1,3,0,111,98,-1,-1
"4838","19",467,5,1,0,3,-118,-189,4,0,138,160,4,0,3,-2,-256,-349,0,0
"4839","19",463,9,4,1,3,123,-11,4,4,210,-6,2,3,3,-6,-87,-5,2,1
"4840","19",172,8,2,0,3,-1,166,3,3,-140,140,3,3,3,-5,139,26,0,0
"4841","19",328,4,3,1,1,-20,11,-1,-1,19,11,1,1,3,-1,-39,0,-2,-2
"4842","19",244,4,4,1,2,-72,-126,-1,-1,228,224,4,3,3,-1,-300,-350,-5,-4
"4843","19",189,3,1,1,1,-208,61,3,-2,-202,34,3,-3,3,0,-6,27,0,1
"4844","19",63,4,4,1,1,1,1,0,-1,1,1,0,0,3,-1,0,0,0,-1
"4845","19",415,1,2,0,2,-214,-208,0,-4,114,197,0,3,3,2,-328,-405,0,-7
"4846","19",19,3,2,0,2,-192,-135,1,-2,-108,-92,1,-1,3,0,-84,-43,0,-1
"4847","19",109,1,1,0,1,-1,-22,3,-4,1,-123,3,-2,3,2,-2,101,0,-2
"4848","19",133,3,2,0,1,-241,9,1,-2,245,13,1,0,3,0,-486,-4,0,-2
"4849","19",462,9,3,1,3,220,166,4,4,196,200,4,4,3,-6,24,-34,0,0
"4850","19",255,5,3,1,1,-64,-58,0,0,-156,-57,0,0,3,-2,92,-1,0,0
"4851","19",146,2,2,0,0,-193,-188,-3,-3,-197,-227,-3,-3,3,1,4,39,0,0
"4852","19",243,3,2,1,2,-242,29,-4,-2,238,79,-1,0,3,0,-480,-50,-3,-2
"4853","19",188,9,2,1,3,230,-4,4,4,229,1,4,4,3,-6,1,-5,0,0
"4854","19",107,3,2,0,3,121,77,2,-2,-216,40,1,-1,3,0,337,37,1,-1
"4855","19",333,4,4,1,1,-80,-36,-1,-1,39,-109,0,-1,3,-1,-119,73,-1,0
"4856","19",10,5,3,1,1,-205,1,-1,0,-167,-1,0,-2,3,-2,-38,2,-1,2
"4857","19",108,8,2,0,3,234,35,3,3,236,38,4,4,3,-5,-2,-3,-1,-1
"4858","19",132,7,4,1,1,11,-20,0,2,20,111,1,2,3,-4,-9,-131,-1,0
"4859","19",174,5,4,1,3,116,75,0,0,108,26,1,1,3,-2,8,49,-1,-1
"4860","19",254,6,2,0,3,208,-21,3,1,43,-22,1,0,3,-3,165,1,2,1
"4861","19",466,3,3,1,0,-94,-75,-2,-2,-126,-50,-2,-2,3,0,32,-25,0,0
"4862","19",416,1,4,1,0,-227,233,-4,-4,-224,204,-4,4,3,2,-3,29,0,-8
"4863","19",190,5,4,1,3,169,192,0,0,202,191,2,2,3,-2,-33,1,-2,-2
"4864","19",11,7,4,1,1,-147,85,-1,2,-161,-124,-2,2,3,-4,14,209,1,0
"4865","19",134,6,2,0,2,0,-3,0,1,2,-12,1,0,3,-3,-2,9,-1,1
"4866","19",176,7,1,0,1,-52,19,-1,2,182,47,1,0,3,-4,-234,-28,-2,2
"4867","19",256,5,3,1,1,55,3,0,0,129,92,2,1,3,-2,-74,-89,-2,-1
"4868","19",468,5,1,1,3,174,-118,2,0,-106,72,-1,-1,3,-2,280,-190,3,1
"4869","19",464,3,1,1,1,-228,8,0,-2,-238,20,0,-2,3,0,10,-12,0,0
"4870","19",173,3,4,1,3,138,10,2,-2,165,22,0,0,3,0,-27,-12,2,-2
"4871","19",329,4,4,1,3,111,-78,1,-1,84,51,-1,1,3,-1,27,-129,2,-2
"4872","19",395,8,3,0,1,29,16,-1,3,209,12,-1,3,3,-5,-180,4,0,0
"4873","19",165,2,1,0,1,-112,5,-3,-3,117,13,0,1,3,1,-229,-8,-3,-4
"4874","19",64,2,1,1,1,-163,98,-3,-3,216,-233,4,4,3,1,-379,331,-7,-7
"4875","19",335,4,2,1,1,-82,-29,-2,-1,-75,25,-1,-2,3,-1,-7,-54,-1,1
"4876","19",259,1,3,1,1,-113,33,4,-4,93,32,4,-2,3,2,-206,1,0,-2
"4877","19",429,1,2,0,0,-225,-197,-4,-4,-203,-196,-4,-4,3,2,-22,-1,0,0
"4878","19",470,4,1,0,1,-55,30,-1,-1,-80,37,-1,-1,3,-1,25,-7,0,0
"4879","19",251,4,3,1,1,-2,-212,4,-1,-234,54,0,-1,3,-1,232,-266,4,0
"4880","19",248,4,4,1,3,-150,80,-1,-1,241,237,-1,4,3,-1,-391,-157,0,-5
"4881","19",147,7,2,0,3,-141,87,0,2,153,77,2,1,3,-4,-294,10,-2,1
"4882","19",442,6,4,1,1,-39,28,-1,1,28,21,1,1,3,-3,-67,7,-2,0
"4883","19",439,5,2,0,1,0,1,0,0,0,3,0,0,3,-2,0,-2,0,0
"4884","19",111,2,1,1,0,-118,104,-2,-3,115,114,2,0,3,1,-233,-10,-4,-3
"4885","19",334,1,4,1,0,-238,-202,-4,-4,-242,-162,-4,-4,3,2,4,-40,0,0
"4886","19",258,1,3,0,0,42,2,1,-4,-140,-2,-4,-4,3,2,182,4,5,0
"4887","19",112,8,4,1,3,28,-226,3,3,16,234,4,4,3,-5,12,-460,-1,-1
"4888","19",47,7,4,0,3,93,-3,1,2,184,-3,2,3,3,-4,-91,0,-1,-1
"4889","19",250,6,1,0,3,93,26,1,1,76,19,1,1,3,-3,17,7,0,0
"4890","19",247,5,3,1,0,125,-4,0,0,177,-14,1,1,3,-2,-52,10,-1,-1
"4891","19",65,7,1,0,3,69,47,2,2,34,29,2,2,3,-4,35,18,0,0
"4892","19",417,5,2,0,2,-220,-233,0,0,227,228,0,0,3,-2,-447,-461,0,0
"4893","19",191,3,1,0,0,-186,-30,-2,-2,-189,-45,-2,-3,3,0,3,15,0,1
"4894","19",110,7,1,0,1,-127,92,-4,2,133,-103,-3,2,3,-4,-260,195,-1,0
"4895","19",135,5,1,0,1,-167,-51,0,0,-220,-18,1,1,3,-2,53,-33,-1,-1
"4896","19",177,3,4,1,1,150,155,-2,-2,73,127,2,-2,3,0,77,28,-4,0
"4897","19",257,1,1,0,0,0,0,-3,-4,76,55,0,-4,3,2,-76,-55,-3,0
"4898","19",469,1,4,1,0,101,18,-3,-4,84,46,-3,-4,3,2,17,-28,0,0
"4899","19",465,8,4,0,3,7,-239,3,3,43,-228,4,2,3,-5,-36,-11,-1,1
"4900","19",428,3,1,0,0,-196,-201,-3,-2,-180,-175,-3,-4,3,0,-16,-26,0,2
"4901","19",33,6,3,1,1,-88,75,-1,1,27,-43,0,2,3,-3,-115,118,-1,-1
"4902","19",396,1,1,1,1,-199,197,4,-4,-183,111,4,-1,3,2,-16,86,0,-3
"4903","19",166,2,4,1,2,14,21,-1,-3,186,193,-2,1,3,1,-172,-172,1,-4
"4904","19",113,4,2,1,2,11,15,-1,-1,187,169,1,0,3,-1,-176,-154,-2,-1
"4905","19",336,2,4,1,3,-197,134,3,-3,189,120,3,-2,3,1,-386,14,0,-1
"4906","19",26,2,1,0,0,-136,-170,-4,-3,-211,-38,-3,-4,3,1,75,-132,-1,1
"4907","19",43,1,3,1,0,-49,23,-3,-4,138,52,-1,-3,3,2,-187,-29,-2,-1
"4908","19",471,2,3,1,2,-127,158,0,-3,-27,-133,-1,4,3,1,-100,291,1,-7
"4909","19",252,4,4,1,1,-86,-72,-1,-1,69,-131,1,0,3,-1,-155,59,-2,-1
"4910","19",249,1,3,1,0,-187,-85,-3,-4,-225,-124,-4,-4,3,2,38,39,1,0
"4911","19",148,2,1,1,1,-154,10,2,-3,-155,4,2,-3,3,1,1,6,0,0
"4912","19",443,4,1,0,0,-109,9,-1,-1,62,9,1,1,3,-1,-171,0,-2,-2
"4913","19",44,1,2,1,2,-153,9,-3,-4,218,18,0,-4,3,2,-371,-9,-3,0
"4914","19",363,8,3,1,3,0,0,3,3,249,1,3,3,3,-5,-249,-1,0,0
"4915","19",137,3,1,1,1,-48,42,-2,-2,-226,223,-4,-3,3,0,178,-181,2,1
"4916","19",262,6,4,1,3,61,79,1,1,58,62,1,1,3,-3,3,17,0,0
"4917","19",161,1,2,0,2,-242,183,-4,-4,47,23,0,-4,3,2,-289,160,-4,0
"4918","19",158,4,3,1,0,27,-16,-2,-1,-136,-23,-2,-1,3,-1,163,7,0,0
"4919","19",98,1,3,1,0,-220,-48,-3,-4,148,-214,3,4,3,2,-368,166,-6,-8
"4920","19",7,4,1,1,3,64,-123,1,-1,87,12,-1,0,3,-1,-23,-135,2,-1
"4921","19",66,1,1,0,1,-97,-2,-2,-4,-69,0,-1,1,3,2,-28,-2,-1,-5
"4922","19",418,4,2,0,2,57,12,-1,-1,231,-12,1,-1,3,-1,-174,24,-2,0
"4923","19",192,6,4,0,1,99,8,2,1,-121,0,0,1,3,-3,220,8,2,0
"4924","19",362,6,4,1,3,107,-146,4,1,104,106,2,1,3,-3,3,-252,2,0
"4925","19",136,1,1,0,0,-221,222,-4,-4,191,-159,-3,-3,3,2,-412,381,-1,-1
"4926","19",261,9,1,0,3,134,125,4,4,85,-94,4,4,3,-6,49,219,0,0
"4927","19",212,3,1,0,1,-98,-148,4,-2,-201,-148,4,-3,3,0,103,0,0,1
"4928","19",209,6,4,1,3,108,4,1,1,5,241,2,1,3,-3,103,-237,-1,0
"4929","19",76,6,4,1,3,50,-1,0,1,41,-1,1,1,3,-3,9,0,-1,0
"4930","19",69,5,4,1,1,-47,135,-1,0,-90,33,-1,-3,3,-2,43,102,0,3
"4931","19",15,8,4,1,3,137,32,2,3,73,63,2,3,3,-5,64,-31,0,0
"4932","19",445,6,4,1,3,91,-79,1,1,122,-80,1,2,3,-3,-31,1,0,-1
"4933","19",323,1,4,1,1,-2,-190,-1,-4,224,4,4,-4,3,2,-226,-194,-5,0
"4934","19",114,2,4,1,1,-67,-90,1,-3,150,163,1,-3,3,1,-217,-253,0,0
"4935","19",337,7,2,0,3,-38,22,2,2,234,-18,4,4,3,-4,-272,40,-2,-2
"4936","19",260,6,3,1,0,42,38,1,1,1,-4,0,0,3,-3,41,42,1,1
"4937","19",430,5,2,0,1,37,-20,0,0,33,-33,1,1,3,-2,4,13,-1,-1
"4938","19",472,1,1,0,0,-168,11,-4,-4,-129,15,-4,-4,3,2,-39,-4,0,0
"4939","19",253,5,3,0,3,-63,-2,0,0,31,1,1,1,3,-2,-94,-3,-1,-1
"4940","19",25,3,4,1,2,-34,-58,-1,-2,-81,-89,0,0,3,0,47,31,-1,-2
"4941","19",149,5,3,1,1,0,-1,-3,0,242,6,-3,1,3,-2,-242,-7,0,-1
"4942","19",444,1,2,0,2,-242,121,-4,-4,-231,78,-4,-4,3,2,-11,43,0,0
"4943","19",440,3,3,1,0,-37,-1,-2,-2,-33,-14,-1,-1,3,0,-4,13,-1,-1
"4944","19",364,5,3,1,1,-52,0,0,0,-4,-5,-1,-1,3,-2,-48,5,1,1
"4945","19",138,5,3,1,1,-5,-12,0,0,210,-18,2,2,3,-2,-215,6,-2,-2
"4946","19",263,5,4,1,0,3,0,0,0,2,0,0,0,3,-2,1,0,0,0
"4947","19",162,7,3,1,3,30,0,-1,2,118,132,4,4,3,-4,-88,-132,-5,-2
"4948","19",159,6,3,1,2,-114,-2,2,1,240,7,4,4,3,-3,-354,-9,-2,-3
"4949","19",99,8,4,1,3,222,-1,3,3,144,-114,3,3,3,-5,78,113,0,0
"4950","19",70,1,2,0,2,-238,-222,4,-4,-34,95,-3,-4,3,2,-204,-317,7,0
"4951","19",67,5,1,0,0,-20,24,-3,0,116,-123,1,2,3,-2,-136,147,-4,-2
"4952","19",419,4,4,1,3,97,109,0,-1,148,110,1,0,3,-1,-51,-1,-1,-1
"4953","19",193,1,1,0,0,-237,-27,-3,-4,198,137,1,1,3,2,-435,-164,-4,-5
"4954","19",116,7,2,0,3,146,3,2,2,118,10,2,0,3,-4,28,-7,0,2
"4955","19",339,6,3,1,1,129,20,1,1,108,105,1,1,3,-3,21,-85,0,0
"4956","19",432,4,2,0,1,54,-56,0,-1,45,-68,0,0,3,-1,9,12,0,-1
"4957","19",213,6,2,0,1,-4,156,1,1,2,-26,1,0,3,-3,-6,182,0,1
"4958","19",21,2,4,1,2,-47,-41,-1,-3,49,69,-4,-3,3,1,-96,-110,3,0
"4959","19",77,4,3,1,1,-77,-1,-1,-1,-77,2,-1,-1,3,-1,0,-3,0,0
"4960","19",73,5,4,1,2,-31,-27,0,0,-105,-118,0,0,3,-2,74,91,0,0
"4961","19",150,5,3,0,1,4,4,0,0,161,3,1,0,3,-2,-157,1,-1,0
"4962","19",446,4,4,1,1,-70,-32,-2,-1,38,25,0,0,3,-1,-108,-57,-2,-1
"4963","19",324,1,2,0,0,-191,-141,-4,-4,-212,-2,-4,-4,3,2,21,-139,0,0
"4964","19",115,5,3,0,3,-1,3,0,0,-1,3,0,0,3,-2,0,0,0,0
"4965","19",338,1,3,1,2,73,31,-2,-4,238,239,2,-2,3,2,-165,-208,-4,-2
"4966","19",431,3,3,1,0,-39,2,-2,-2,32,37,-1,-1,3,0,-71,-35,-1,-1
"4967","19",164,5,2,0,2,-1,1,0,0,-57,-3,-1,-1,3,-2,56,4,1,1
"4968","19",160,5,2,0,0,-198,172,-4,0,-207,-1,-4,2,3,-2,9,173,0,-2
"4969","19",157,1,3,1,2,-112,-95,-3,-4,157,122,-2,0,3,2,-269,-217,-1,-4
"4970","19",72,5,1,1,0,16,22,1,0,140,153,2,2,3,-2,-124,-131,-1,-2
"4971","19",424,3,2,0,2,-100,-68,-2,-2,35,7,1,-1,3,0,-135,-75,-3,-1
"4972","19",420,4,4,1,3,-1,1,0,-1,2,52,2,1,3,-1,-3,-51,-2,-2
"4973","19",441,8,4,1,2,35,-239,3,3,67,-234,3,3,3,-5,-32,-5,0,0
"4974","19",365,1,3,1,1,-213,0,4,-4,-231,8,4,-4,3,2,18,-8,0,0
"4975","19",139,1,4,1,2,-241,0,-4,-4,-233,0,-4,-4,3,2,-8,0,0,0
"4976","19",264,2,4,1,2,6,1,-4,-3,-246,-245,-4,-4,3,1,252,246,0,1
"4977","19",163,7,3,1,1,-7,91,2,2,39,58,2,1,3,-4,-46,33,0,1
"4978","19",16,1,1,0,0,-229,164,-2,-4,193,23,1,-1,3,2,-422,141,-3,-3
"4979","19",156,5,2,0,1,-4,0,0,0,-2,2,0,0,3,-2,-2,-2,0,0
"4980","19",71,4,3,1,1,-49,18,-1,-1,20,17,-1,0,3,-1,-69,1,0,-1
"4981","19",68,1,4,1,0,34,2,0,-4,83,3,-2,-3,3,2,-49,-1,2,-1
"4982","19",42,3,3,1,1,-60,59,2,-2,-64,41,2,-3,3,0,4,18,0,1
"4983","19",194,7,1,1,0,-156,30,-4,2,-239,6,-4,2,3,-4,83,24,0,0
"4984","19",117,1,4,1,2,-240,5,-3,-4,-99,2,-2,-3,3,2,-141,3,-1,-1
"4985","19",34,6,4,1,2,90,-74,1,1,103,-57,1,1,3,-3,-13,-17,0,0
"4986","19",433,1,1,0,0,-209,-229,-4,-4,229,230,4,4,3,2,-438,-459,-8,-8
"4987","19",214,9,1,1,3,145,-127,4,4,195,-140,4,4,3,-6,-50,13,0,0
"4988","19",210,1,4,1,2,-62,-31,1,-4,49,43,1,-1,3,2,-111,-74,0,-3
"4989","19",78,3,4,1,0,-173,-4,-2,-2,-200,-12,-2,-2,3,0,27,8,0,0
"4990","19",74,5,3,1,0,-127,-45,-1,0,-86,-43,-1,0,3,-2,-41,-2,0,0
"4991","19",151,1,2,0,1,-240,10,0,-4,-243,12,0,-4,3,2,3,-2,0,0
"4992","19",447,3,4,1,2,-84,6,-2,-2,112,2,1,-1,3,0,-196,4,-3,-1
"4993","19",325,9,1,1,1,81,73,2,4,-33,-34,2,4,3,-6,114,107,0,0
"4994","19",321,1,1,0,0,-222,-208,-4,-4,-220,-208,-3,-3,3,2,-2,0,-1,-1
"4995","19",460,4,1,0,0,-164,12,-2,-1,147,36,-2,1,3,-1,-311,-24,0,-2
"4996","19",266,3,1,0,1,-109,8,-2,-2,-101,-3,-2,-2,3,0,-8,11,0,0
"4997","19",391,5,2,1,3,134,137,0,0,151,-160,-3,0,3,-2,-17,297,3,0
"4998","19",388,5,4,1,0,-9,239,0,0,-234,4,1,0,3,-2,225,235,-1,0
"4999","19",384,1,1,0,0,-234,1,-4,-4,2,33,-2,-3,3,2,-236,-32,-2,-1
"5000","19",230,5,1,0,0,-222,-18,-3,0,-212,71,-3,0,3,-2,-10,-89,0,0
"5001","19",425,4,4,1,2,-79,-62,-1,-1,-37,-139,0,0,3,-1,-42,77,-1,-1
"5002","19",421,9,3,1,1,18,17,0,4,47,42,0,3,3,-6,-29,-25,0,1
"5003","19",37,1,1,0,0,-224,105,-4,-4,-218,29,-4,-4,3,2,-6,76,0,0
"5004","19",366,7,4,1,3,200,-33,3,2,159,-69,2,2,3,-4,41,36,1,0
"5005","19",14,2,3,1,1,-183,-14,-3,-3,221,-42,1,2,3,1,-404,28,-4,-5
"5006","19",265,9,1,0,3,162,2,3,4,-6,-7,0,0,3,-6,168,9,3,4
"5007","19",216,5,3,1,1,40,6,1,0,-72,-17,0,1,3,-2,112,23,1,-1
"5008","19",83,6,1,1,3,126,-128,2,1,140,-122,2,1,3,-3,-14,-6,0,0
"5009","19",8,7,3,1,1,-229,230,0,2,-112,-112,-1,-3,3,-4,-117,342,1,5
"5010","19",359,9,4,1,3,232,16,4,4,228,15,3,2,3,-6,4,1,1,2
"5011","19",153,8,1,0,3,-105,-16,0,3,-76,-21,1,1,3,-5,-29,5,-1,2
"5012","19",449,6,4,1,3,13,80,1,1,1,81,1,1,3,-3,12,-1,0,0
"5013","19",195,1,1,0,1,-226,234,4,-4,19,-27,2,0,3,2,-245,261,2,-4
"5014","19",118,5,3,1,1,-49,19,-2,0,-29,-17,-2,1,3,-2,-20,36,0,-1
"5015","19",340,4,1,0,1,-103,-10,0,-1,26,20,0,0,3,-1,-129,-30,0,-1
"5016","19",434,6,4,1,3,112,2,1,1,-176,-118,-2,-1,3,-3,288,120,3,2
"5017","19",215,2,1,1,0,-139,28,-2,-3,148,35,-2,-3,3,1,-287,-7,0,0
"5018","19",211,6,3,1,1,-74,-62,-2,1,153,169,-2,-1,3,-3,-227,-231,0,2
"5019","19",79,1,4,1,2,-234,-20,-2,-4,-236,-11,-4,-4,3,2,2,-9,2,0
"5020","19",75,3,4,1,2,205,66,2,-2,190,36,1,-2,3,0,15,30,1,0
"5021","19",152,3,1,1,0,-39,-2,-1,-2,-3,4,0,-2,3,0,-36,-6,-1,0
"5022","19",448,9,2,0,2,241,-6,4,4,198,1,2,4,3,-6,43,-7,2,0
"5023","19",326,7,4,1,2,149,37,2,2,132,132,1,2,3,-4,17,-95,1,0
"5024","19",322,8,4,1,3,18,-16,3,3,230,-220,3,3,3,-5,-212,204,0,0
"5025","19",461,4,4,1,2,67,10,0,-1,77,100,1,1,3,-1,-10,-90,-1,-2
"5026","19",267,5,3,1,1,52,0,0,0,52,0,1,1,3,-2,0,0,-1,-1
"5027","19",392,3,1,0,0,-161,127,-2,-2,-162,100,-2,-3,3,0,1,27,0,1
"5028","19",389,1,3,1,2,156,0,-4,-4,4,0,0,0,3,2,152,0,-4,-4
"5029","19",385,5,4,1,1,-32,12,0,0,67,19,3,3,3,-2,-99,-7,-3,-3
"5030","19",231,4,4,1,0,-150,-135,-4,-1,5,12,-4,3,3,-1,-155,-147,0,-4
"5031","19",426,2,4,1,3,-249,5,-2,-3,-4,-239,4,1,3,1,-245,244,-6,-4
"5032","19",422,5,3,1,1,-59,-180,4,0,-76,-184,4,-3,3,-2,17,4,0,3
"5033","19",370,9,1,0,3,242,-18,4,4,-224,-47,-4,-4,3,-6,466,29,8,8
"5034","19",367,5,3,1,1,21,20,0,0,-15,-17,1,-1,3,-2,36,37,-1,1
"5035","19",140,4,1,1,1,11,81,-1,-1,-13,80,0,-1,3,-1,24,1,-1,0
"5036","19",436,5,4,1,3,123,-3,4,0,124,-58,3,3,3,-2,-1,55,1,-3
"5037","19",217,2,4,1,2,-30,20,-1,-3,-40,25,-1,-3,3,1,10,-5,0,0
"5038","19",84,7,4,1,3,192,2,2,2,183,5,3,3,3,-4,9,-3,-1,-1
"5039","19",80,3,4,1,3,237,-1,4,-2,236,1,4,-4,3,0,1,-2,0,2
"5040","19",36,3,3,1,3,177,-112,3,-2,-64,-180,2,2,3,0,241,68,1,-4
"5041","19",154,5,4,1,3,94,2,1,0,97,89,1,1,3,-2,-3,-87,0,-1
"5042","19",45,6,3,1,0,22,38,1,1,22,-53,2,-1,3,-3,0,91,-1,2
"5043","19",196,2,3,0,0,-227,-40,-3,-3,235,238,4,4,3,1,-462,-278,-7,-7
"5044","19",119,7,3,1,3,72,-25,1,2,76,106,1,2,3,-4,-4,-131,0,0
"5045","19",341,9,1,0,3,248,-42,4,4,240,-22,3,4,3,-6,8,-20,1,0
"5046","19",435,6,4,1,1,122,-57,1,1,-189,33,-2,-2,3,-3,311,-90,3,3
"5047","19",394,5,3,1,0,-145,82,4,0,-234,243,-4,-4,3,-2,89,-161,8,4
"5048","19",390,1,2,0,2,-196,124,-4,-4,51,22,1,3,3,2,-247,102,-5,-7
"5049","19",387,2,3,1,1,-171,-184,-2,-3,142,131,1,0,3,1,-313,-315,-3,-3
"5050","19",233,5,2,0,2,-235,24,0,0,-66,12,0,0,3,-2,-169,12,0,0
"5051","19",355,3,2,1,2,-132,53,-4,-2,-191,150,-4,-4,3,0,59,-97,0,2
"5052","19",351,1,1,0,0,-247,-247,-4,-4,246,245,-4,-4,3,2,-493,-492,0,0
"5053","19",372,3,3,1,0,-244,-82,-4,-2,-243,-236,-3,-2,3,0,-1,154,-1,0
"5054","19",369,2,4,1,0,-221,0,-3,-3,10,2,1,1,3,1,-231,-2,-4,-4
"5055","19",32,5,1,0,1,-2,-8,0,0,153,-182,2,-4,3,-2,-155,174,-2,4
"5056","19",268,8,4,1,3,44,-47,4,3,140,-111,4,3,3,-5,-96,64,0,0
"5057","19",393,1,1,0,0,1,2,-4,-4,-241,1,-4,-4,3,2,242,1,0,0
"5058","19",39,4,3,1,1,-50,-29,-1,-1,158,121,2,2,3,-1,-208,-150,-3,-3
"5059","19",386,1,1,0,0,-238,206,-4,-4,-13,-14,0,0,3,2,-225,220,-4,-4
"5060","19",232,1,1,0,0,-246,-245,-4,-4,-244,-244,-4,-4,3,2,-2,-1,0,0
"5061","19",427,3,4,1,1,-218,-29,2,-2,-192,-69,4,-4,3,0,-26,40,-2,2
"5062","19",423,5,1,1,3,-221,-22,3,0,4,39,4,2,3,-2,-225,-61,-1,-2
"5063","19",371,3,3,1,0,-93,-104,-2,-2,196,132,-3,2,3,0,-289,-236,1,-4
"5064","19",368,9,3,1,3,-124,127,4,4,-135,141,4,4,3,-6,11,-14,0,0
"5065","19",141,3,1,1,0,49,-36,-1,-2,2,3,0,0,3,0,47,-39,-1,-2
"5066","19",437,3,1,0,0,-210,0,-2,-2,-155,-2,-2,-2,3,0,-55,2,0,0
"5067","19",218,8,4,1,3,-134,-51,4,3,-221,-96,4,3,3,-5,87,45,0,0
"5068","19",85,2,2,0,2,-135,-102,-2,-3,124,-100,1,0,3,1,-259,-2,-3,-3
"5069","19",81,8,1,0,0,-209,75,4,3,-174,210,4,1,3,-5,-35,-135,0,2
"5070","19",360,1,3,1,0,-194,-62,-2,-4,86,145,0,-4,3,2,-280,-207,-2,0
"5071","19",155,5,2,0,1,-85,0,0,0,0,-4,0,0,3,-2,-85,4,0,0
"5072","19",450,7,4,1,3,213,-1,0,2,1,179,1,2,3,-4,212,-180,-1,0
"5073","19",197,3,4,1,3,-93,8,3,-2,-212,8,1,-1,3,0,119,0,2,-1
"5074","19",12,9,4,1,3,-1,0,4,4,-1,3,4,4,3,-6,0,-3,0,0
"5075","19",342,3,3,1,1,-112,-234,0,-2,-83,-211,-1,-2,3,0,-29,-23,1,0
"5076","19",27,3,2,0,2,-157,47,-2,-2,-98,45,-1,-2,3,0,-59,2,-1,0
"5077","19",293,1,4,1,0,-217,25,-4,-4,-239,11,-4,-4,3,2,22,14,0,0
"5078","19",318,1,2,0,2,-178,-184,-4,-4,195,99,-4,0,3,2,-373,-283,0,-4
"5079","19",238,1,3,1,1,-132,1,3,-4,124,77,3,2,3,2,-256,-76,0,-6
"5080","19",234,4,3,1,3,139,42,1,-1,143,20,0,-1,3,-1,-4,22,1,0
"5081","19",356,3,4,1,1,30,2,0,-2,143,3,2,2,3,0,-113,-1,-2,-4
"5082","19",352,4,2,0,1,13,-114,0,-1,6,-53,0,-1,3,-1,7,-61,0,0
"5083","19",373,1,3,1,0,-232,-232,-2,-4,-190,-236,0,-4,3,2,-42,4,-2,0
"5084","19",297,2,3,1,2,-114,30,-3,-3,16,21,1,-1,3,1,-130,9,-4,-2
"5085","19",320,1,2,0,2,-248,124,-4,-4,-248,127,-4,-4,3,2,0,-3,0,0
"5086","19",269,1,4,1,2,-249,108,-2,-4,248,128,-3,-4,3,2,-497,-20,1,0
"5087","19",361,9,1,1,0,249,2,4,4,-248,1,2,-2,3,-6,497,1,2,6
"5088","19",455,2,2,1,2,233,4,-3,-3,-249,8,-3,-3,3,1,482,-4,0,0
"5089","19",240,9,2,0,1,-230,-236,4,4,244,-81,2,-4,3,-6,-474,-155,2,8
"5090","19",198,3,1,0,1,-51,-95,-1,-2,-36,-93,0,-1,3,0,-15,-2,-1,-1
"5091","19",456,2,1,1,0,-114,67,0,-3,-60,-64,0,-3,3,1,-54,131,0,0
"5092","19",452,4,3,1,1,-66,8,-1,-1,-8,-48,-1,0,3,-1,-58,56,0,-1
"5093","19",199,3,4,1,2,-221,27,-2,-2,-142,32,-2,-2,3,0,-79,-5,0,0
"5094","19",121,1,1,0,0,-208,44,-4,-4,223,7,-2,-4,3,2,-431,37,-2,0
"5095","19",142,4,2,1,2,-3,6,-2,-1,1,0,0,0,3,-1,-4,6,-2,-1
"5096","19",438,5,4,1,3,8,-11,4,0,23,-1,4,0,3,-2,-15,-10,0,0
"5097","19",219,5,4,1,3,249,1,4,0,249,-1,4,0,3,-2,0,2,0,0
"5098","19",86,6,4,1,3,179,-4,2,1,158,-7,2,3,3,-3,21,3,0,-2
"5099","19",82,9,4,1,2,219,-43,4,4,73,97,3,3,3,-6,146,-140,1,1
"5100","19",374,6,4,1,2,55,11,1,1,54,13,1,1,3,-3,1,-2,0,0
"5101","19",298,1,1,0,0,-248,-3,-1,-4,4,-247,1,1,3,2,-252,244,-2,-5
"5102","19",451,1,1,0,0,-218,-216,-4,-4,-226,-217,-4,-4,3,2,8,1,0,0
"5103","19",241,5,4,1,2,129,39,1,0,199,175,2,0,3,-2,-70,-136,-1,0
"5104","19",120,4,3,1,1,46,48,1,-1,-106,96,0,0,3,-1,152,-48,1,-1
"5105","19",343,4,2,0,2,-72,-1,1,-1,-67,3,-4,-1,3,-1,-5,-4,5,0
"5106","19",270,5,3,1,1,3,-3,0,0,-4,0,1,0,3,-2,7,-3,-1,0
"5107","19",294,5,1,0,3,-1,1,0,0,-1,1,0,0,3,-2,0,0,0,0
"5108","19",319,6,1,0,1,51,27,2,1,63,57,-2,-1,3,-3,-12,-30,4,2
"5109","19",239,6,1,0,1,91,63,2,1,-55,-61,2,1,3,-3,146,124,0,0
"5110","19",235,6,3,1,0,3,-1,1,1,-2,-2,2,0,3,-3,5,1,-1,1
"5111","19",357,4,4,1,2,-69,-14,-1,-1,-69,-2,-1,-1,3,-1,0,-12,0,0
"5112","19",353,9,2,1,2,130,12,4,4,230,238,3,0,3,-6,-100,-226,1,4
"5113","19",87,8,4,1,3,61,-1,2,3,133,84,4,4,3,-5,-72,-85,-2,-1
"5114","19",236,5,1,0,1,-16,-17,0,0,-17,-7,0,0,3,-2,1,-10,0,0
"5115","19",220,1,4,1,2,-225,122,-4,-4,99,120,-2,-2,3,2,-324,2,-2,-2
"5116","19",354,2,1,0,0,-179,132,-2,-3,201,210,2,2,3,1,-380,-78,-4,-5
"5117","19",237,4,2,0,2,-248,1,-2,-1,83,1,-2,0,3,-1,-331,0,0,-1
"5118","19",29,1,4,1,0,-231,111,-4,-4,238,222,-1,-1,3,2,-469,-111,-3,-3
"5119","19",205,7,1,0,2,178,4,2,2,198,1,2,2,3,-4,-20,3,0,0
"5120","19",376,4,4,1,1,17,-90,-1,-1,109,-69,-2,-2,3,-1,-92,-21,1,1
"5121","19",457,1,3,1,1,-116,47,-4,-4,30,-212,1,0,3,2,-146,259,-5,-4
"5122","19",453,3,4,1,2,1,0,1,-2,-6,-164,1,1,3,0,7,164,0,-3
"5123","19",2,4,4,1,1,11,-94,-2,-1,123,-114,4,1,3,-1,-112,20,-6,-2
"5124","19",122,1,1,1,0,-247,-248,-4,-4,221,216,4,4,3,2,-468,-464,-8,-8
"5125","19",22,7,3,1,1,163,21,2,2,99,8,2,2,3,-4,64,13,0,0
"5126","19",24,1,2,1,2,232,-1,-4,-4,247,-244,4,4,3,2,-15,243,-8,-8
"5127","19",20,4,3,1,0,-90,-71,-2,-1,217,218,4,4,3,-1,-307,-289,-6,-5
"5128","19",358,1,4,1,2,-126,59,-4,-4,-225,92,-4,-4,3,2,99,-33,0,0
"5129","19",346,8,3,1,0,-247,0,-4,3,150,1,1,2,3,-5,-397,-1,-5,1
"5130","19",375,4,3,1,1,-12,11,-1,-1,-1,1,0,0,3,-1,-11,10,-1,-1
"5131","19",299,2,4,1,1,-214,26,-2,-3,14,234,4,4,3,1,-228,-208,-6,-7
"5132","19",221,4,4,1,1,-105,13,-1,-1,78,19,0,0,3,-1,-183,-6,-1,-1
"5133","19",242,3,4,1,2,22,0,1,-2,71,-1,1,-3,3,0,-49,1,0,1
"5134","19",3,2,3,1,0,-1,-2,0,-3,-2,-3,0,-3,3,1,1,1,0,0
"5135","19",344,6,4,0,3,181,-28,2,1,-140,-64,1,1,3,-3,321,36,1,0
"5136","19",271,5,3,1,1,128,0,-3,0,169,0,1,3,3,-2,-41,0,-4,-3
"5137","19",295,5,1,0,1,1,1,0,0,1,2,0,0,3,-2,0,-1,0,0
"5138","19",458,2,1,0,1,-63,-69,0,-3,75,80,-1,-2,3,1,-138,-149,1,-1
"5139","19",454,8,4,1,3,218,2,2,3,209,1,2,2,3,-5,9,1,0,1
"5140","19",272,4,4,1,2,37,31,0,-1,33,21,0,-1,3,-1,4,10,0,0
"5141","19",123,3,4,1,2,-72,20,-2,-2,-87,59,-2,-2,3,0,15,-39,0,0
"5142","19",459,1,3,1,1,-190,173,3,-4,-99,98,3,-4,3,2,-91,75,0,0
"5143","19",88,3,4,1,2,-102,-23,-2,-2,221,-211,4,4,3,0,-323,188,-6,-6
"5144","19",200,1,3,1,0,-238,-155,-4,-4,-229,-39,-4,-4,3,2,-9,-116,0,0
"5145","19",46,1,1,0,0,-28,-209,2,-4,-1,-241,-1,-2,3,2,-27,32,3,-2
"5146","19",383,5,4,1,1,-1,4,0,0,-1,9,0,0,3,-2,0,-5,0,0
"5147","19",201,1,3,1,1,71,-1,2,-4,31,-1,2,-2,3,2,40,0,0,-2
"5148","19",290,4,1,1,1,-187,-33,0,-1,8,-14,0,-3,3,-1,-195,-19,0,2
"5149","19",206,4,4,1,0,-42,25,-2,-1,-35,14,-2,-2,3,-1,-7,11,0,1
"5150","19",377,2,1,0,0,245,6,-2,-3,245,10,4,0,3,1,0,-4,-6,-3
"5151","19",30,1,2,1,2,0,0,4,-4,-130,-12,-4,-4,3,2,130,12,8,0
"5152","19",345,2,1,1,0,-34,31,-4,-3,-4,-226,-3,-3,3,1,-30,257,-1,0
"5153","19",207,5,1,0,0,-2,3,0,0,0,0,0,0,3,-2,-2,3,0,0
"5154","19",296,6,1,0,3,146,31,1,1,185,-2,2,2,3,-3,-39,33,-1,-1
"5155","19",300,4,1,1,0,-72,35,-1,-1,-56,62,-1,-1,3,-1,-16,-27,0,0
"5156","19",382,5,4,1,2,16,-5,0,0,69,4,1,2,3,-2,-53,-9,-1,-2
"5157","19",273,3,1,0,0,238,7,-1,-2,1,1,1,1,3,0,237,6,-2,-3
"5158","19",124,9,1,1,3,223,-41,3,4,241,-4,2,4,3,-6,-18,-37,1,0
"5159","19",347,4,1,1,3,150,75,2,-1,-103,-136,2,1,3,-1,253,211,0,-2
"5160","19",89,6,3,1,0,-210,1,-1,1,-143,1,-4,-4,3,-3,-67,0,3,5
"5161","19",125,5,4,1,0,-175,-31,-1,0,-178,-31,-3,-1,3,-2,3,0,2,1
"5162","19",222,1,1,0,0,-246,2,-4,-4,-239,-11,-4,-4,3,2,-7,13,0,0
"5163","19",9,4,4,1,2,59,21,1,-1,7,9,1,-1,3,-1,52,12,0,0
"5164","19",202,5,1,0,1,-120,20,-1,0,-71,20,-3,-1,3,-2,-49,0,2,1
"5165","19",291,5,4,1,2,42,17,-1,0,20,122,2,3,3,-2,22,-105,-3,-3
"5166","19",223,5,1,0,1,0,-1,0,0,-1,1,0,0,3,-2,1,-2,0,0
"5167","19",378,4,4,1,1,-122,0,-1,-1,-106,8,-3,-1,3,-1,-16,-8,2,0
"5168","19",203,9,4,1,3,-10,-16,4,4,-8,7,4,4,3,-6,-2,-23,0,0
"5169","19",224,2,2,0,2,-82,-35,-3,-3,177,56,2,1,3,1,-259,-91,-5,-4
"5170","19",208,4,4,1,2,-124,-118,-1,-1,94,92,-2,1,3,-1,-218,-210,1,-2
"5171","19",379,1,3,0,1,-69,-116,2,-4,-60,-117,0,0,3,2,-9,1,2,-4
"5172","19",317,3,4,1,2,-108,103,-2,-2,-102,111,-2,-2,3,0,-6,-8,0,0
"5173","19",313,7,3,1,0,39,48,2,2,-51,-45,-1,-1,3,-4,90,93,3,3
"5174","19",38,5,4,1,3,4,-18,0,0,-5,-92,0,0,3,-2,9,74,0,0
"5175","19",314,1,4,1,1,-243,8,4,-4,-243,7,4,-4,3,2,0,1,0,0
"5176","19",310,8,4,1,2,19,2,1,3,-23,-1,-2,-2,3,-5,42,3,3,5
"5177","19",275,4,4,1,2,-8,-238,2,-1,229,1,3,-1,3,-1,-237,-239,-1,0
"5178","19",126,1,2,0,2,-194,-125,-4,-4,-33,-29,-4,-4,3,2,-161,-96,0,0
"5179","19",315,8,3,1,3,240,9,3,3,238,7,4,3,3,-5,2,2,-1,0
"5180","19",90,1,4,1,0,-222,12,-4,-4,229,22,4,4,3,2,-451,-10,-8,-8
"5181","19",276,7,4,1,3,208,2,2,2,168,-1,2,2,3,-4,40,3,0,0
"5182","19",292,4,3,1,1,-125,9,-1,-1,2,196,0,3,3,-1,-127,-187,-1,-4
"5183","19",35,2,1,1,3,68,169,3,-3,132,130,2,-1,3,1,-64,39,1,-2
"5184","19",91,2,2,0,3,-63,-8,-3,-3,152,-3,1,2,3,1,-215,-5,-4,-5
"5185","19",301,4,4,1,1,1,35,0,-1,-51,1,-1,0,3,-1,52,34,1,-1
"5186","19",225,7,2,0,2,-38,-63,-1,2,-116,-138,-1,-1,3,-4,78,75,0,3
"5187","19",274,6,4,1,2,-108,-224,-1,1,-51,-217,0,0,3,-3,-57,-7,-1,1
"5188","19",302,3,1,0,0,-129,-30,2,-2,196,59,-1,-2,3,0,-325,-89,3,0
"5189","19",348,5,3,1,1,31,49,-3,0,61,40,0,0,3,-2,-30,9,-3,0
"5190","19",226,1,1,0,0,74,0,-1,-4,123,2,2,-3,3,2,-49,-2,-3,-1
"5191","19",380,2,4,1,1,32,-22,3,-3,-215,-45,3,-4,3,1,247,23,0,1
"5192","19",303,1,3,1,2,-187,-208,-4,-4,-179,-181,-3,-3,3,2,-8,-27,-1,-1
"5193","19",311,1,2,0,2,205,9,-4,-4,144,17,4,-4,3,2,61,-8,-8,0
"5194","19",227,5,3,1,3,43,-30,2,0,35,20,1,2,3,-2,8,-50,1,-2
"5195","19",127,1,1,1,0,-215,3,-4,-4,-2,-1,2,-3,3,2,-213,4,-6,-1
"5196","19",316,2,3,1,0,-189,-145,-3,-3,-170,-108,-3,-3,3,1,-19,-37,0,0
"5197","19",312,5,4,1,1,98,74,0,0,97,-122,0,0,3,-2,1,196,0,0
"5198","19",204,6,3,1,1,57,-68,1,1,141,-163,0,0,3,-3,-84,95,1,1
"5199","19",128,6,1,0,3,142,1,1,1,142,1,1,1,3,-3,0,0,0,0
"5200","19",350,5,4,1,1,-245,6,-1,0,-4,-245,1,0,3,-2,-241,251,-2,0
"5201","19",286,6,1,0,3,81,-1,0,1,51,4,0,1,3,-3,30,-5,0,0
"5202","19",129,7,4,1,1,191,1,2,2,166,-2,2,2,3,-4,25,3,0,0
"5203","19",306,5,3,1,3,146,108,1,0,125,150,1,0,3,-2,21,-42,0,0
"5204","19",93,6,1,0,1,-78,21,-2,1,-88,18,-2,0,3,-3,10,3,0,1
"5205","19",287,4,4,1,3,-234,6,-2,-1,-174,-19,-4,-4,3,-1,-60,25,2,3
"5206","19",349,7,4,1,1,29,-51,1,2,52,-94,1,0,3,-4,-23,43,0,2
"5207","19",307,6,4,1,2,54,37,1,1,-230,223,-4,-4,3,-3,284,-186,5,5
"5208","19",381,1,2,0,2,-194,247,-4,-4,1,-2,0,0,3,2,-195,249,-4,-4
"5209","19",304,3,2,0,2,1,-8,2,-2,54,-84,0,0,3,0,-53,76,2,-2
"5210","19",228,7,4,1,2,45,95,2,2,23,105,1,2,3,-4,22,-10,1,0
"5211","19",277,1,4,1,1,-29,-2,4,-4,18,-90,3,-4,3,2,-47,88,1,0
"5212","19",309,5,4,1,2,111,59,2,0,100,-51,2,3,3,-2,11,110,0,-3
"5213","19",305,9,4,1,3,213,116,4,4,178,198,4,4,3,-6,35,-82,0,0
"5214","19",92,4,4,1,2,-109,-85,-1,-1,-114,-145,-1,-1,3,-1,5,60,0,0
"5215","19",31,1,1,0,0,-167,-66,-4,-4,-109,-61,-4,-4,3,2,-58,-5,0,0
"5216","19",96,2,1,0,0,-213,-27,-3,-3,-148,-34,-2,-2,3,1,-65,7,-1,-1
"5217","19",282,9,3,1,3,-82,-33,1,4,220,17,1,4,3,-6,-302,-50,0,0
"5218","19",279,6,4,1,3,112,-23,2,1,91,-29,2,1,3,-3,21,6,0,0
"5219","19",13,3,4,1,1,46,-75,1,-2,29,-99,-1,-2,3,0,17,24,2,0
"5220","19",284,3,3,1,1,-43,19,-1,-2,-166,-93,-2,-3,3,0,123,112,1,1
"5221","19",94,3,4,1,1,54,-37,4,-2,130,-113,2,2,3,0,-76,76,2,-4
"5222","19",288,2,2,1,2,-108,-1,-2,-3,21,2,-1,0,3,1,-129,-3,-1,-3
"5223","19",130,9,1,0,3,205,30,4,4,90,23,4,4,3,-6,115,7,0,0
"5224","19",278,1,4,1,1,-242,-242,4,-4,-1,-229,4,-4,3,2,-241,-13,0,0
"5225","19",95,1,4,1,2,-246,4,-4,-4,-245,0,-4,-4,3,2,-1,4,0,0
"5226","19",289,6,1,1,3,-173,-51,1,1,-188,-22,1,1,3,-3,15,-29,0,0
"5227","19",229,6,1,0,1,-43,-100,-1,1,-128,141,-2,-2,3,-3,85,-241,1,3
"5228","19",97,2,1,0,1,-226,28,3,-3,80,17,3,-3,3,1,-306,11,0,0
"5229","19",308,2,4,1,0,-171,-172,-4,-3,165,137,3,4,3,1,-336,-309,-7,-7
"5230","19",281,1,4,1,2,-249,-6,-4,-4,-244,4,-4,-4,3,2,-5,-10,0,0
"5231","19",23,9,1,0,3,-231,-213,-4,4,202,198,4,4,3,-6,-433,-411,-8,0
"5232","19",131,8,4,1,3,77,14,-1,3,62,-18,0,3,3,-5,15,32,-1,0
"5233","19",285,7,2,1,1,-3,-63,-2,2,-3,-126,-2,3,3,-4,0,63,0,-1
"5234","19",283,6,1,0,1,-105,-116,-2,1,84,-120,1,1,3,-3,-189,4,-3,0
"5235","19",28,4,4,1,1,4,-7,-1,-1,18,-66,-1,-1,3,-1,-14,59,0,0
"5236","19",280,3,2,1,1,-77,41,-1,-2,49,-26,1,-1,3,0,-126,67,-2,-1
"5237","2",49,5,4,1,1,9,16,0,0,30,12,0,0,0,-5,-21,4,0,0
"5238","2",476,2,3,0,0,-208,-187,-3,-3,169,85,1,1,0,-2,-377,-272,-4,-4
"5239","2",53,7,4,1,3,205,2,2,2,219,1,2,2,0,-7,-14,1,0,0
"5240","2",179,5,1,0,1,1,4,0,0,-12,3,0,4,0,-5,13,1,0,-4
"5241","2",178,5,1,0,1,-2,3,0,0,-6,5,0,0,0,-5,4,-2,0,0
"5242","2",54,1,4,1,1,-235,-9,-4,-4,231,-24,-1,-2,0,-1,-466,15,-3,-2
"5243","2",48,1,3,0,0,-3,-4,-4,-4,81,-78,-4,-4,0,-1,-84,74,0,0
"5244","2",473,3,3,0,0,-236,-16,-2,-2,-226,-16,-1,-1,0,-3,-10,0,-1,-1
"5245","2",330,2,2,1,2,-248,1,0,-3,201,146,1,1,0,-2,-449,-145,-1,-4
"5246","2",334,1,4,1,0,-238,205,-4,-4,-218,34,-4,-4,0,-1,-20,171,0,0
"5247","2",52,2,3,0,0,-233,4,-2,-3,112,4,2,1,0,-2,-345,0,-4,-4
"5248","2",474,1,1,0,0,2,-108,-4,-4,1,-113,-4,-4,0,-1,1,5,0,0
"5249","2",331,3,1,0,0,-188,163,-3,-2,141,-55,-1,1,0,-3,-329,218,-2,-3
"5250","2",5,1,2,0,2,-243,120,-3,-4,-234,8,-2,-4,0,-1,-9,112,-1,0
"5251","2",470,4,1,1,1,-89,34,-1,-1,-45,73,-1,-1,0,-4,-44,-39,0,0
"5252","2",475,5,3,0,3,72,-85,0,0,54,-46,0,0,0,-5,18,-39,0,0
"5253","2",18,3,3,0,1,-162,-54,0,-2,85,25,1,0,0,-3,-247,-79,-1,-2
"5254","2",50,5,2,0,1,0,-2,0,0,56,-104,1,0,0,-5,-56,102,-1,0
"5255","2",471,4,3,0,2,-36,-96,0,-1,76,69,-2,0,0,-4,-112,-165,2,-1
"5256","2",333,5,4,1,1,-62,56,2,0,112,-132,1,1,0,-5,-174,188,1,-1
"5257","2",51,3,4,1,1,-209,-94,-2,-2,99,94,1,-3,0,-3,-308,-188,-3,1
"5258","2",55,5,4,0,1,20,3,0,0,221,-1,3,3,0,-5,-201,4,-3,-3
"5259","2",59,2,1,0,0,-160,200,-3,-3,110,-186,2,2,0,-2,-270,386,-5,-5
"5260","2",181,1,4,1,3,-119,-78,-4,-4,111,98,0,0,0,-1,-230,-176,-4,-4
"5261","2",56,6,3,0,1,113,-115,-3,1,70,-111,-2,-1,0,-6,43,-4,-1,2
"5262","2",6,1,4,1,2,-208,0,-2,-4,-1,1,0,0,0,-1,-207,-1,-2,-4
"5263","2",182,6,4,1,3,-1,-83,3,1,1,-161,2,1,0,-6,-2,78,1,0
"5264","2",186,1,2,0,2,-1,-2,0,-4,113,55,0,-2,0,-1,-114,-57,0,-2
"5265","2",57,1,4,0,1,4,-156,0,-4,116,-226,-2,0,0,-1,-112,70,2,-4
"5266","2",332,4,1,0,0,-234,80,-3,-1,-221,55,-1,0,0,-4,-13,25,-2,-1
"5267","2",183,3,4,1,1,-60,-208,-2,-2,100,201,1,-4,0,-3,-160,-409,-3,2
"5268","2",187,2,4,1,2,-184,2,-3,-3,-72,-30,-2,-1,0,-2,-112,32,-1,-2
"5269","2",58,1,4,1,1,-229,-2,-4,-4,-3,245,4,4,0,-1,-226,-247,-8,-8
"5270","2",180,4,2,0,2,-1,7,0,-1,0,1,0,1,0,-4,-1,6,0,-2
"5271","2",184,7,3,0,3,119,-2,1,2,132,7,2,2,0,-7,-13,-9,-1,0
"5272","2",472,1,1,0,0,-244,190,-4,-4,-233,123,-4,-4,0,-1,-11,67,0,0
"5273","2",338,1,3,0,2,-225,-221,1,-4,229,236,-4,-4,0,-1,-454,-457,5,0
"5274","2",47,4,4,1,3,201,2,2,-1,40,-2,2,2,0,-4,161,4,0,-3
"5275","2",40,3,1,0,2,-53,21,4,-2,226,49,4,0,0,-3,-279,-28,0,-2
"5276","2",335,4,2,0,1,-184,3,-2,-1,98,68,2,2,0,-4,-282,-65,-4,-3
"5277","2",339,3,3,0,1,-156,-38,-2,-2,-48,-16,-1,-1,0,-3,-108,-22,-1,-1
"5278","2",400,2,4,0,2,-72,70,-3,-3,13,-16,3,2,0,-2,-85,86,-6,-5
"5279","2",60,3,1,0,3,213,-1,3,-2,214,9,3,3,0,-3,-1,-10,0,-5
"5280","2",336,2,4,0,3,178,148,2,-3,207,109,3,-3,0,-2,-29,39,-1,0
"5281","2",467,3,1,0,3,179,190,3,-2,140,125,4,0,0,-3,39,65,-1,-2
"5282","2",401,2,2,0,1,-119,-106,-1,-3,119,15,0,0,0,-2,-238,-121,-1,-3
"5283","2",337,9,2,0,3,12,-9,4,4,246,-10,4,4,0,-9,-234,1,0,0
"5284","2",340,4,1,0,1,-89,-39,0,-1,80,10,0,0,0,-4,-169,-49,0,-1
"5285","2",188,8,2,1,3,218,3,3,3,152,-2,3,4,0,-8,66,5,0,-1
"5286","2",442,7,4,0,1,30,46,1,2,104,61,3,3,0,-7,-74,-15,-2,-1
"5287","2",185,1,4,0,2,-238,-12,-4,-4,137,-35,1,0,0,-1,-375,23,-5,-4
"5288","2",189,3,1,0,1,-152,142,2,-2,-81,100,2,-3,0,-3,-71,42,0,1
"5289","2",245,1,1,0,0,-83,-77,-4,-4,-105,0,-2,-3,0,-1,22,-77,-2,-1
"5290","2",397,1,4,0,3,120,26,-4,-4,159,72,4,4,0,-1,-39,-46,-8,-8
"5291","2",19,2,2,0,2,-164,-170,-3,-3,121,41,1,-1,0,-2,-285,-211,-4,-2
"5292","2",404,5,1,1,1,60,-56,-1,0,58,-49,1,0,0,-5,2,-7,-2,0
"5293","2",398,1,4,1,2,-239,-236,-3,-4,126,98,3,3,0,-1,-365,-334,-6,-7
"5294","2",34,2,4,1,2,-40,57,-2,-3,-41,47,-1,-1,0,-2,1,10,-1,-2
"5295","2",190,7,4,1,3,204,-5,2,2,203,-132,3,4,0,-7,1,127,-1,-2
"5296","2",61,1,1,0,3,-243,-149,4,-4,164,-6,4,-4,0,-1,-407,-143,0,0
"5297","2",399,5,4,0,3,124,4,-1,0,127,12,1,1,0,-5,-3,-8,-2,-1
"5298","2",468,6,1,0,3,47,-14,1,1,51,101,1,1,0,-6,-4,-115,0,0
"5299","2",402,1,3,0,0,-242,0,-4,-4,245,-4,4,1,0,-1,-487,4,-8,-5
"5300","2",439,5,2,0,1,-2,4,0,0,0,1,0,0,0,-5,-2,3,0,0
"5301","2",341,9,1,0,3,246,-27,4,4,236,-30,4,4,0,-9,10,3,0,0
"5302","2",403,3,1,0,0,-175,-12,0,-2,36,-9,1,1,0,-3,-211,-3,-1,-3
"5303","2",443,3,1,0,0,116,46,-2,-2,67,52,2,1,0,-3,49,-6,-4,-3
"5304","2",466,4,3,0,0,84,-52,-1,-1,81,-86,3,3,0,-4,3,34,-4,-4
"5305","2",436,3,4,1,3,72,-250,1,-2,95,-222,3,0,0,-3,-23,-28,-2,-2
"5306","2",246,8,4,1,3,180,-3,2,3,124,0,2,3,0,-8,56,-3,0,0
"5307","2",259,1,3,0,1,-184,1,4,-4,63,57,4,2,0,-1,-247,-56,0,-6
"5308","2",255,1,3,0,1,118,-117,-4,-4,117,-138,1,1,0,-1,1,21,-5,-5
"5309","2",405,6,4,0,1,-142,-113,-3,1,57,63,1,1,0,-6,-199,-176,-4,0
"5310","2",247,3,3,0,0,-207,-10,-2,-2,174,-19,1,1,0,-3,-381,9,-3,-3
"5311","2",243,5,2,0,2,-247,-40,-3,0,246,-118,1,3,0,-5,-493,78,-4,-3
"5312","2",191,2,1,0,0,-214,-48,-2,-3,-202,20,-2,-2,0,-2,-12,-68,0,-1
"5313","2",62,9,2,0,3,171,3,0,4,217,239,2,4,0,-9,-46,-236,-2,0
"5314","2",4,6,3,0,1,244,-10,1,1,242,94,2,2,0,-6,2,-104,-1,-1
"5315","2",435,5,4,0,1,-4,6,0,0,57,-10,1,0,0,-5,-61,16,-1,0
"5316","2",407,1,2,1,2,212,70,-4,-4,156,52,2,2,0,-1,56,18,-6,-6
"5317","2",44,1,2,0,2,-197,195,-2,-4,224,-224,0,-1,0,-1,-421,419,-2,-3
"5318","2",254,5,2,0,3,-10,-9,-1,0,157,-133,-3,-1,0,-5,-167,124,2,1
"5319","2",408,2,1,0,0,-242,2,-3,-3,-24,1,1,0,0,-2,-218,1,-4,-3
"5320","2",444,4,2,0,2,-109,1,-2,-1,-1,0,2,-1,0,-4,-108,1,-4,0
"5321","2",440,2,3,0,0,-148,-8,-3,-3,1,2,0,0,0,-2,-149,-10,-3,-3
"5322","2",437,4,1,0,0,-128,0,-1,-1,-135,1,-1,-1,0,-4,7,-1,0,0
"5323","2",409,3,4,0,2,-161,-166,3,-2,52,69,0,1,0,-3,-213,-235,3,-3
"5324","2",26,1,1,0,0,-223,218,-4,-4,16,-69,-2,-3,0,-1,-239,287,-2,-1
"5325","2",256,5,3,0,1,-3,4,0,0,-3,-1,0,0,0,-5,0,5,0,0
"5326","2",406,2,2,0,2,-172,-150,-2,-3,4,-6,2,1,0,-2,-176,-144,-4,-4
"5327","2",248,5,4,0,3,32,42,1,0,51,95,1,1,0,-5,-19,-53,0,-1
"5328","2",469,1,4,0,0,-137,3,-3,-4,121,75,-1,-2,0,-1,-258,-72,-2,-2
"5329","2",192,6,4,1,1,-69,1,1,1,1,50,0,0,0,-6,-70,-49,1,1
"5330","2",258,1,3,0,0,-19,-4,-4,-4,-33,-1,-1,-3,0,-1,14,-3,-3,-1
"5331","2",342,4,3,0,1,-213,33,-2,-1,-83,-137,-1,-2,0,-4,-130,170,-1,1
"5332","2",193,1,1,0,0,-148,-163,-4,-4,205,119,2,4,0,-1,-353,-282,-6,-8
"5333","2",411,9,2,0,2,233,238,4,4,241,243,4,4,0,-9,-8,-5,0,0
"5334","2",262,6,4,1,3,121,-1,1,1,93,5,1,2,0,-6,28,-6,0,-1
"5335","2",109,1,1,0,1,-2,-204,2,-4,-7,-177,1,-3,0,-1,5,-27,1,-1
"5336","2",175,6,4,0,1,175,-18,2,1,0,-51,1,2,0,-6,175,33,1,-1
"5337","2",445,6,4,1,3,102,-34,1,1,109,-48,1,1,0,-6,-7,14,0,0
"5338","2",441,3,4,0,2,-39,-2,-3,-2,-115,-33,2,-2,0,-3,76,31,-5,0
"5339","2",438,7,4,0,3,6,3,4,2,72,0,4,4,0,-7,-66,3,0,-2
"5340","2",41,6,2,0,3,33,68,2,1,96,41,2,1,0,-6,-63,27,0,0
"5341","2",244,1,4,1,2,-186,-185,-4,-4,90,97,2,-1,0,-1,-276,-282,-6,-3
"5342","2",257,1,1,0,0,-199,-172,-4,-4,42,34,-2,-4,0,-1,-241,-206,-2,0
"5343","2",63,1,4,1,1,-243,1,-4,-4,245,4,0,0,0,-1,-488,-3,-4,-4
"5344","2",261,9,1,0,3,202,169,4,4,206,194,4,4,0,-9,-4,-25,0,0
"5345","2",108,9,2,0,3,243,12,4,4,204,33,4,4,0,-9,39,-21,0,0
"5346","2",174,6,4,0,3,74,29,1,1,93,43,1,1,0,-6,-19,-14,0,0
"5347","2",462,9,3,0,3,-2,194,4,4,213,218,-4,-4,0,-9,-215,-24,8,8
"5348","2",343,5,2,1,2,-55,1,0,0,-40,0,-1,-1,0,-5,-15,1,1,1
"5349","2",194,9,1,0,0,-184,44,-3,4,-128,19,-4,4,0,-9,-56,25,1,0
"5350","2",412,9,1,0,0,-243,-245,-4,4,-247,-244,4,4,0,-9,4,-1,-8,0
"5351","2",263,2,4,1,0,-206,-7,-1,-3,-55,2,-1,-3,0,-2,-151,-9,0,0
"5352","2",11,5,4,1,1,2,-8,0,0,78,20,1,1,0,-5,-76,-28,-1,-1
"5353","2",176,9,1,0,1,-238,53,-4,4,187,50,1,2,0,-9,-425,3,-5,2
"5354","2",260,2,3,0,0,-210,-218,-3,-3,-195,-187,-2,-2,0,-2,-15,-31,-1,-1
"5355","2",169,1,3,1,0,0,0,-4,-4,-243,87,-4,-4,0,-1,243,-87,0,0
"5356","2",410,1,1,0,0,-240,-30,-3,-4,-51,-16,-1,-3,0,-1,-189,-14,-2,-1
"5357","2",249,1,3,0,0,-204,-126,-3,-4,72,-199,3,-3,0,-1,-276,73,-6,-1
"5358","2",1,6,1,0,1,-91,40,-3,1,-31,198,-1,1,0,-6,-60,-158,-2,0
"5359","2",241,1,4,0,2,-242,-57,-4,-4,169,126,2,0,0,-1,-411,-183,-6,-4
"5360","2",64,9,1,0,1,-235,239,-4,4,208,-222,4,3,0,-9,-443,461,-8,1
"5361","2",266,5,1,0,1,-1,1,0,0,-1,1,0,0,0,-5,0,0,0,0
"5362","2",112,2,4,0,3,-241,3,-4,-3,-2,248,3,3,0,-2,-239,-245,-7,-6
"5363","2",105,2,1,0,0,-203,9,-4,-3,-56,-19,-1,1,0,-2,-147,28,-3,-4
"5364","2",463,8,4,1,3,-240,-12,-3,3,-7,-228,2,1,0,-8,-233,216,-5,2
"5365","2",171,4,1,1,1,-220,145,-1,-1,11,14,0,0,0,-4,-231,131,-1,-1
"5366","2",168,3,1,1,3,122,-52,-1,-2,107,-98,2,2,0,-3,15,46,-3,-4
"5367","2",446,4,4,1,1,-69,-11,-1,-1,27,85,0,1,0,-4,-96,-96,-1,-2
"5368","2",37,1,1,0,0,-171,-12,-3,-4,-159,-17,-3,-4,0,-1,-12,5,0,0
"5369","2",366,7,4,0,3,81,48,0,2,184,-56,3,4,0,-7,-103,104,-3,-2
"5370","2",362,1,4,0,3,-129,199,1,-4,70,154,1,-3,0,-1,-199,45,0,-1
"5371","2",265,8,1,0,3,22,1,0,3,-2,4,0,0,0,-8,24,-3,0,3
"5372","2",111,2,1,0,0,-209,-220,-4,-3,125,-93,-1,1,0,-2,-334,-127,-3,-4
"5373","2",460,2,1,0,0,-210,-70,-4,-3,200,28,-3,1,0,-2,-410,-98,-1,-4
"5374","2",100,8,4,0,3,195,-7,3,3,-175,6,-2,-2,0,-8,370,-13,5,5
"5375","2",170,1,2,0,0,-232,-234,-4,-4,14,20,0,0,0,-1,-246,-254,-4,-4
"5376","2",167,7,1,0,3,-124,-160,2,2,178,-166,3,3,0,-7,-302,6,-1,-1
"5377","2",65,7,1,0,3,-132,-20,0,2,21,-18,1,1,0,-7,-153,-2,-1,1
"5378","2",344,7,4,1,3,226,-31,4,2,-170,-35,-1,-1,0,-7,396,4,5,3
"5379","2",195,1,1,0,1,-246,245,4,-4,19,-17,2,0,0,-1,-265,262,2,-4
"5380","2",413,1,1,1,1,-240,-1,-4,-4,133,2,1,1,0,-1,-373,-3,-5,-5
"5381","2",264,1,4,0,2,1,12,0,-4,241,242,0,-2,0,-1,-240,-230,0,-2
"5382","2",110,6,1,0,1,-106,150,-4,1,146,93,3,1,0,-6,-252,57,-7,0
"5383","2",177,2,4,1,1,90,186,2,-3,47,200,2,-4,0,-2,43,-14,0,1
"5384","2",465,9,4,0,3,150,20,3,4,227,11,3,3,0,-9,-77,9,0,1
"5385","2",17,1,3,0,0,-137,43,-3,-4,138,86,-2,-4,0,-1,-275,-43,-1,0
"5386","2",104,1,1,1,0,-241,1,-3,-4,237,0,1,-3,0,-1,-478,1,-4,-1
"5387","2",25,4,4,0,2,-14,-37,-1,-1,11,-11,0,-1,0,-4,-25,-26,-1,0
"5388","2",10,4,3,0,1,-25,-1,-1,-1,203,0,2,2,0,-4,-228,-1,-3,-3
"5389","2",242,1,4,1,2,-225,2,-3,-4,101,1,2,2,0,-1,-326,1,-5,-6
"5390","2",461,1,4,1,2,-56,25,-4,-4,99,29,-3,-3,0,-1,-155,-4,-1,-1
"5391","2",267,5,3,1,1,55,-12,0,0,52,-11,1,1,0,-5,3,-1,-1,-1
"5392","2",113,2,2,1,2,-25,-16,0,-3,-25,196,0,-1,0,-2,0,-212,0,-2
"5393","2",106,7,2,0,1,90,21,3,2,-43,40,2,2,0,-7,133,-19,1,0
"5394","2",464,6,1,0,1,21,122,0,1,150,0,1,1,0,-6,-129,122,-1,0
"5395","2",172,9,2,0,3,-100,158,4,4,141,137,0,0,0,-9,-241,21,4,4
"5396","2",395,3,3,0,1,221,32,-2,-2,198,24,3,3,0,-3,23,8,-5,-5
"5397","2",447,4,4,0,2,-105,5,1,-1,80,66,2,2,0,-4,-185,-61,-1,-3
"5398","2",370,1,1,1,3,-238,-8,-4,-4,242,-11,0,-4,0,-1,-480,3,-4,0
"5399","2",367,3,3,0,1,-199,-91,2,-2,-122,-59,2,-1,0,-3,-77,-32,0,-1
"5400","2",363,2,3,0,3,-249,-1,-3,-3,-244,1,-3,-3,0,-2,-5,-2,0,0
"5401","2",432,5,2,0,1,38,-4,0,0,35,-33,-1,1,0,-5,3,29,1,-1
"5402","2",429,1,2,0,0,-16,-3,-4,-4,0,2,0,-4,0,-1,-16,-5,-4,0
"5403","2",234,7,3,0,3,162,48,1,2,142,34,1,2,0,-7,20,14,0,0
"5404","2",101,1,3,0,0,-236,239,-4,-4,206,202,-3,-3,0,-1,-442,37,-1,-1
"5405","2",307,1,4,0,2,-246,224,-4,-4,-227,121,-4,-3,0,-1,-19,103,0,-1
"5406","2",251,5,3,0,1,-201,-24,-4,0,96,34,-3,-2,0,-5,-297,-58,-1,2
"5407","2",66,1,1,1,1,-239,0,-2,-4,166,1,0,1,0,-1,-405,-1,-2,-5
"5408","2",345,7,1,0,0,-243,245,-4,2,-192,45,-4,-4,0,-7,-51,200,0,6
"5409","2",196,1,3,0,0,-217,0,-4,-4,167,190,3,3,0,-1,-384,-190,-7,-7
"5410","2",414,3,1,0,0,-126,-139,-2,-2,7,9,0,0,0,-3,-133,-148,-2,-2
"5411","2",431,4,3,0,0,-218,53,-1,-1,1,4,0,0,0,-4,-219,49,-1,-1
"5412","2",428,1,1,0,0,-239,-227,-4,-4,-235,217,-4,-4,0,-1,-4,-444,0,0
"5413","2",8,6,3,1,1,-112,-98,-2,1,126,50,1,1,0,-6,-238,-148,-3,0
"5414","2",76,5,4,1,3,-1,-7,-1,0,9,5,1,0,0,-5,-10,-12,-2,0
"5415","2",132,6,4,1,1,11,100,1,1,6,103,1,1,0,-6,5,-3,0,0
"5416","2",250,6,1,1,3,97,38,1,1,80,21,1,1,0,-6,17,17,0,0
"5417","2",449,3,4,1,3,-151,37,-2,-2,-116,60,2,0,0,-3,-35,-23,-4,-2
"5418","2",327,6,4,1,3,165,0,2,1,101,-33,1,0,0,-6,64,33,1,1
"5419","2",323,5,4,0,1,-2,-126,0,0,175,-3,0,0,0,-5,-177,-123,0,0
"5420","2",32,5,1,0,1,-8,3,0,0,115,-97,-1,-4,0,-5,-123,100,1,4
"5421","2",268,7,4,1,3,116,150,2,2,131,-117,3,2,0,-7,-15,267,-1,0
"5422","2",114,2,4,1,1,-52,-54,0,-3,137,135,1,-3,0,-2,-189,-189,-1,0
"5423","2",107,6,2,1,3,-228,-39,-2,1,-17,228,1,-1,0,-6,-211,-267,-3,2
"5424","2",103,5,2,1,3,2,0,-3,0,62,1,1,1,0,-5,-60,-1,-4,-1
"5425","2",173,3,4,1,3,249,8,-2,-2,246,5,0,0,0,-3,3,3,-2,-2
"5426","2",396,1,1,0,1,-245,242,4,-4,43,-68,-2,1,0,-1,-288,310,6,-5
"5427","2",448,1,2,0,2,-181,2,-4,-4,-1,111,-2,-4,0,-1,-180,-109,-2,0
"5428","2",371,1,3,0,0,-218,-182,-4,-4,153,-69,-4,2,0,-1,-371,-113,0,-6
"5429","2",368,1,3,1,3,129,-141,-4,-4,-103,106,4,4,0,-1,232,-247,-8,-8
"5430","2",364,6,3,0,1,91,7,1,1,-36,1,0,1,0,-6,127,6,1,0
"5431","2",433,1,1,0,0,-223,-151,-3,-4,180,162,3,-3,0,-1,-403,-313,-6,-1
"5432","2",43,4,3,0,0,-74,0,-1,-1,138,-7,0,0,0,-4,-212,7,-1,-1
"5433","2",235,1,3,0,0,-238,-1,-4,-4,81,2,2,2,0,-1,-319,-3,-6,-6
"5434","2",102,9,4,0,3,192,-25,2,4,87,22,3,3,0,-9,105,-47,-1,1
"5435","2",308,1,4,0,0,-247,-245,-4,-4,176,132,0,1,0,-1,-423,-377,-4,-5
"5436","2",252,4,4,1,1,-190,-160,-1,-1,69,-99,1,1,0,-4,-259,-61,-2,-2
"5437","2",67,2,1,0,0,-28,30,-3,-3,141,-145,1,1,0,-2,-169,175,-4,-4
"5438","2",346,8,3,0,0,-249,0,0,3,240,42,0,3,0,-8,-489,-42,0,0
"5439","2",197,9,4,1,3,140,-129,-2,4,128,-117,0,4,0,-9,12,-12,-2,0
"5440","2",415,3,2,0,2,-25,0,0,-2,101,140,0,1,0,-3,-126,-140,0,-3
"5441","2",27,5,2,0,2,-99,-136,0,0,-50,-9,0,0,0,-5,-49,-127,0,0
"5442","2",116,1,2,1,3,-193,-19,4,-4,85,-16,1,1,0,-1,-278,-3,3,-5
"5443","2",80,6,4,1,3,139,2,3,1,242,1,2,2,0,-6,-103,1,1,-1
"5444","2",77,4,3,1,1,-243,4,1,-1,-63,-1,-1,-1,0,-4,-180,5,2,0
"5445","2",133,1,2,0,1,-238,-21,0,-4,209,29,4,0,0,-1,-447,-50,-4,-4
"5446","2",230,5,1,0,0,-214,48,-3,0,-26,9,-3,1,0,-5,-188,39,0,-1
"5447","2",45,1,3,0,0,-250,143,-4,-4,-127,44,-3,-3,0,-1,-123,99,-1,-1
"5448","2",328,4,3,0,1,-27,11,-1,-1,-37,24,-1,-1,0,-4,10,-13,0,0
"5449","2",324,1,2,0,0,-232,5,-4,-4,3,1,-1,-1,0,-1,-235,4,-3,-3
"5450","2",320,4,2,0,2,-176,146,-2,-1,-130,123,-2,-1,0,-4,-46,23,0,0
"5451","2",269,2,4,0,2,-250,135,2,-3,250,125,0,0,0,-2,-500,10,2,-3
"5452","2",115,5,3,0,3,58,2,0,0,106,0,0,1,0,-5,-48,2,0,-1
"5453","2",237,2,2,0,2,-250,110,-2,-3,88,2,1,0,0,-2,-338,108,-3,-3
"5454","2",233,5,2,0,2,-239,-20,0,0,-53,22,0,0,0,-5,-186,-42,0,0
"5455","2",31,1,1,1,0,-118,73,-4,-4,-71,-105,-1,-1,0,-1,-47,178,-3,-3
"5456","2",72,2,1,0,0,-192,-117,-2,-3,142,163,2,2,0,-2,-334,-280,-4,-5
"5457","2",69,5,4,0,1,18,88,1,0,-52,29,-1,-1,0,-5,70,59,2,1
"5458","2",372,1,3,0,0,-211,-230,-4,-4,223,239,3,2,0,-1,-434,-469,-7,-6
"5459","2",369,5,4,0,0,59,-1,0,0,114,1,1,0,0,-5,-55,-2,-1,0
"5460","2",365,5,3,0,1,3,-121,0,0,4,9,0,0,0,-5,-1,-130,0,0
"5461","2",434,8,4,1,3,-246,-18,2,3,9,223,2,3,0,-8,-255,-241,0,0
"5462","2",430,5,2,0,1,41,-41,0,0,185,-63,0,0,0,-5,-144,22,0,0
"5463","2",236,5,1,1,1,24,-32,0,0,22,-38,0,0,0,-5,2,6,0,0
"5464","2",232,1,1,0,0,-237,-59,-2,-4,-182,-30,-2,-4,0,-1,-55,-29,0,0
"5465","2",309,3,4,0,2,-201,77,-2,-2,184,124,2,-1,0,-3,-385,-47,-4,-1
"5466","2",253,9,3,0,3,-22,0,4,4,229,234,4,4,0,-9,-251,-234,0,0
"5467","2",68,1,4,0,0,-245,60,-4,-4,213,7,0,-3,0,-1,-458,53,-4,-1
"5468","2",347,5,1,1,3,-171,190,4,0,149,195,2,2,0,-5,-320,-5,2,-2
"5469","2",198,4,1,0,1,-163,113,-1,-1,75,68,1,1,0,-4,-238,45,-2,-2
"5470","2",416,1,4,0,0,-229,245,-4,-4,-234,225,-4,-4,0,-1,5,20,0,0
"5471","2",270,5,3,0,1,2,-1,0,0,199,-2,2,2,0,-5,-197,1,-2,-2
"5472","2",117,1,4,0,2,-208,-3,-4,-4,-162,1,-3,-3,0,-1,-46,-4,-1,-1
"5473","2",81,1,1,0,0,-239,93,-4,-4,-213,132,4,1,0,-1,-26,-39,-8,-5
"5474","2",78,1,4,0,0,53,15,-1,-4,174,3,2,2,0,-1,-121,12,-3,-6
"5475","2",134,1,2,0,2,-225,-2,-2,-4,-131,-9,-1,-4,0,-1,-94,7,-1,0
"5476","2",231,7,4,0,0,-111,10,-4,2,12,74,0,1,0,-7,-123,-64,-4,1
"5477","2",450,4,4,1,3,238,0,1,-1,227,1,2,-2,0,-4,11,-1,-1,1
"5478","2",329,7,4,1,3,-160,28,-2,2,168,40,-1,1,0,-7,-328,-12,-1,1
"5479","2",325,7,1,0,1,-66,-59,-1,2,1,2,0,4,0,-7,-67,-61,-1,-2
"5480","2",321,5,1,0,0,1,-2,0,0,36,32,4,4,0,-5,-35,-34,-4,-4
"5481","2",318,1,2,0,2,-194,-172,-4,-4,197,-78,0,3,0,-1,-391,-94,-4,-7
"5482","2",238,1,3,0,1,-206,79,0,-4,100,-1,1,1,0,-1,-306,80,-1,-5
"5483","2",165,3,1,0,1,63,64,-2,-2,47,36,0,0,0,-3,16,28,-2,-2
"5484","2",314,1,4,1,1,-242,10,4,-4,-241,21,4,-4,0,-1,-1,-11,0,0
"5485","2",310,1,4,0,2,-235,-1,-4,-4,211,103,1,-1,0,-1,-446,-104,-5,-3
"5486","2",73,2,4,0,2,-136,111,-4,-3,141,126,4,3,0,-2,-277,-15,-8,-6
"5487","2",7,5,1,0,3,94,16,1,0,120,49,2,2,0,-5,-26,-33,-1,-2
"5488","2",373,1,3,0,0,-246,-28,0,-4,-225,-34,0,-4,0,-1,-21,6,0,0
"5489","2",297,9,3,0,2,220,78,4,4,229,226,4,3,0,-9,-9,-148,0,1
"5490","2",90,1,4,1,0,-234,22,-4,-4,245,-1,4,4,0,-1,-479,23,-8,-8
"5491","2",87,9,4,1,3,-3,-249,4,4,-2,-249,3,3,0,-9,-1,0,1,1
"5492","2",83,5,1,0,3,81,-118,1,0,146,-124,2,1,0,-5,-65,6,-1,-1
"5493","2",143,7,1,1,3,237,-23,3,2,26,-73,2,2,0,-7,211,50,1,0
"5494","2",14,7,3,0,1,134,-30,2,2,179,-24,1,1,0,-7,-45,-6,1,1
"5495","2",136,1,1,0,0,0,0,-4,-4,-238,30,-3,-3,0,-1,238,-30,-1,-1
"5496","2",456,1,1,0,0,-221,-201,-2,-4,158,176,2,-1,0,-1,-379,-377,-4,-3
"5497","2",452,5,3,0,1,-4,7,0,0,-4,4,0,0,0,-5,0,3,0,0
"5498","2",348,2,3,0,1,-96,1,0,-3,71,63,0,-3,0,-2,-167,-62,0,0
"5499","2",199,2,4,0,2,-197,181,-3,-3,161,72,1,1,0,-2,-358,109,-4,-4
"5500","2",417,3,2,0,2,-109,-76,-2,-2,-11,-17,-2,-2,0,-3,-98,-59,0,0
"5501","2",271,2,3,0,1,-226,0,-3,-3,240,3,2,4,0,-2,-466,-3,-5,-7
"5502","2",118,4,3,0,1,-61,25,-1,-1,81,27,-2,1,0,-4,-142,-2,1,-2
"5503","2",82,1,4,0,2,-241,-11,-4,-4,-242,-10,-4,-4,0,-1,1,-1,0,0
"5504","2",79,3,4,1,2,-204,185,-2,-2,-202,202,-3,-3,0,-3,-2,-17,1,1
"5505","2",135,2,1,0,1,-179,101,-3,-3,-27,6,-1,-1,0,-2,-152,95,-2,-2
"5506","2",455,2,2,0,2,-229,-4,-3,-3,-249,-1,-3,-3,0,-2,20,-3,0,0
"5507","2",451,3,1,0,0,-196,-140,-2,-2,144,165,-2,-2,0,-3,-340,-305,0,0
"5508","2",33,7,3,0,1,29,-40,0,2,40,-55,0,0,0,-7,-11,15,0,2
"5509","2",326,2,4,1,2,-220,-225,-3,-3,143,102,2,0,0,-2,-363,-327,-5,-3
"5510","2",322,5,4,0,3,1,0,0,0,119,-106,1,1,0,-5,-118,106,-1,-1
"5511","2",319,8,1,0,1,-153,-46,3,3,21,-39,1,2,0,-8,-174,-7,2,1
"5512","2",239,7,1,0,1,-59,5,3,2,37,-1,-1,1,0,-7,-96,6,4,1
"5513","2",166,1,4,1,2,-205,153,-3,-4,191,213,0,0,0,-1,-396,-60,-3,-4
"5514","2",315,9,3,0,3,249,11,4,4,-10,243,4,4,0,-9,259,-232,0,0
"5515","2",311,1,2,0,2,-233,48,-4,-4,182,35,4,-4,0,-1,-415,13,-8,0
"5516","2",74,1,3,0,0,-244,0,-4,-4,-88,-1,-3,-3,0,-1,-156,1,-1,-1
"5517","2",70,1,2,0,2,-236,-229,4,-4,115,64,1,-4,0,-1,-351,-293,3,0
"5518","2",374,5,4,0,2,-11,9,0,0,11,18,0,0,0,-5,-22,-9,0,0
"5519","2",298,1,1,0,0,-240,12,-2,-4,10,-174,1,1,0,-1,-250,186,-3,-5
"5520","2",91,6,2,0,3,65,-1,2,1,44,5,2,1,0,-6,21,-6,0,0
"5521","2",88,1,4,1,2,-240,-9,-4,-4,230,29,4,4,0,-1,-470,-38,-8,-8
"5522","2",84,5,4,1,3,123,1,1,0,110,2,1,1,0,-5,13,-1,0,-1
"5523","2",144,3,3,1,0,-242,-4,2,-2,0,6,1,0,0,-3,-242,-10,1,-2
"5524","2",140,3,1,1,1,-35,101,0,-2,-32,47,0,-1,0,-3,-3,54,0,-1
"5525","2",137,6,1,0,1,-231,-230,-3,1,184,200,-1,2,0,-6,-415,-430,-2,-1
"5526","2",457,1,3,0,1,-125,46,-4,-4,-122,-2,-1,-2,0,-1,-3,48,-3,-2
"5527","2",453,3,4,0,2,171,5,0,-2,-141,5,0,1,0,-3,312,0,0,-3
"5528","2",349,7,4,1,1,164,-67,1,2,120,20,2,3,0,-7,44,-87,-1,-1
"5529","2",2,4,4,1,1,-47,-65,-1,-1,-98,-86,-2,2,0,-4,51,21,1,-3
"5530","2",418,2,2,1,2,-189,36,-3,-3,86,-1,-1,-3,0,-2,-275,37,-2,0
"5531","2",272,3,4,0,2,1,0,-1,-2,45,26,-1,-1,0,-3,-44,-26,0,-1
"5532","2",119,7,3,0,3,150,-67,2,2,118,-55,1,1,0,-7,32,-12,1,1
"5533","2",227,7,3,0,3,-90,-25,2,2,45,13,2,-1,0,-7,-135,-38,0,3
"5534","2",317,4,4,0,2,-76,3,-1,-1,74,-64,2,2,0,-4,-150,67,-3,-3
"5535","2",313,1,3,0,0,-236,-229,-4,-4,223,230,3,3,0,-1,-459,-459,-7,-7
"5536","2",359,7,4,1,3,-77,-64,2,2,-54,-72,2,-1,0,-7,-23,8,0,3
"5537","2",355,1,2,0,2,-212,205,-4,-4,-140,99,-2,-2,0,-1,-72,106,-2,-2
"5538","2",376,3,4,1,1,-48,-123,-2,-2,5,-101,-2,-2,0,-3,-53,-22,0,0
"5539","2",3,1,3,0,0,-248,246,-4,-4,-153,142,-4,-4,0,-1,-95,104,0,0
"5540","2",93,5,1,0,1,-159,84,-2,0,-72,18,-1,0,0,-5,-87,66,-1,0
"5541","2",9,3,4,0,2,-219,90,-2,-2,225,76,1,1,0,-3,-444,14,-3,-3
"5542","2",24,4,2,0,2,-245,2,-2,-1,220,-1,2,4,0,-4,-465,3,-4,-5
"5543","2",146,2,2,1,0,-163,-153,-3,-3,-140,-111,-3,-3,0,-2,-23,-42,0,0
"5544","2",316,4,3,0,0,-106,-7,-1,-1,-95,-36,-1,-1,0,-4,-11,29,0,0
"5545","2",312,5,4,1,1,105,76,0,0,98,103,0,0,0,-5,7,-27,0,0
"5546","2",75,1,4,1,2,-240,17,-4,-4,223,221,3,-2,0,-1,-463,-204,-7,-2
"5547","2",71,4,3,0,1,-74,21,1,-1,40,22,-1,0,0,-4,-114,-1,2,-1
"5548","2",375,4,3,1,1,-103,25,-1,-1,0,1,0,0,0,-4,-103,24,-1,-1
"5549","2",299,2,4,1,1,40,209,-2,-3,39,219,3,4,0,-2,1,-10,-5,-7
"5550","2",92,4,4,0,2,106,74,1,-1,6,-2,1,1,0,-4,100,76,0,-2
"5551","2",89,5,3,0,0,-239,5,-4,0,-244,3,-4,0,0,-5,5,2,0,0
"5552","2",85,1,2,0,2,-110,-111,-1,-4,124,139,2,1,0,-1,-234,-250,-3,-5
"5553","2",145,6,1,0,1,93,-2,1,1,95,43,1,0,0,-6,-2,-45,0,1
"5554","2",141,1,1,0,0,-233,68,-4,-4,134,9,4,4,0,-1,-367,59,-8,-8
"5555","2",138,6,3,0,1,98,-93,1,1,163,-35,1,1,0,-6,-65,-58,0,0
"5556","2",458,2,1,0,1,-59,-52,0,-3,66,66,-1,-2,0,-2,-125,-118,1,-1
"5557","2",454,9,4,1,3,246,3,4,4,250,1,4,4,0,-9,-4,2,0,0
"5558","2",35,6,1,0,3,61,156,0,1,166,206,4,-1,0,-6,-105,-50,-4,2
"5559","2",20,9,3,0,0,-238,-236,-4,4,-238,-243,-4,1,0,-9,0,7,0,3
"5560","2",419,4,4,0,3,-90,-122,-1,-1,101,83,1,2,0,-4,-191,-205,-2,-3
"5561","2",273,2,1,0,0,-224,-178,-4,-3,-29,10,4,4,0,-2,-195,-188,-8,-7
"5562","2",12,9,4,0,3,-1,0,4,4,1,-1,4,4,0,-9,-2,1,0,0
"5563","2",228,1,4,0,2,-101,-115,-3,-4,33,49,4,3,0,-1,-134,-164,-7,-7
"5564","2",224,2,2,1,2,-188,-27,-3,-3,169,97,2,1,0,-2,-357,-124,-5,-4
"5565","2",391,5,2,0,3,181,238,0,0,164,153,1,0,0,-5,17,85,-1,0
"5566","2",36,8,3,0,3,182,-81,3,3,105,38,2,2,0,-8,77,-119,1,1
"5567","2",356,1,4,0,1,-224,5,-4,-4,78,0,2,1,0,-1,-302,5,-6,-5
"5568","2",377,1,1,0,0,-244,10,-4,-4,-240,8,4,-4,0,-1,-4,2,-8,0
"5569","2",30,4,2,0,2,-161,-2,-2,-1,172,5,3,3,0,-4,-333,-7,-5,-4
"5570","2",94,1,4,0,1,-120,-6,0,-4,129,-109,0,-2,0,-1,-249,103,0,-2
"5571","2",150,5,3,0,1,3,1,0,0,21,5,0,0,0,-5,-18,-4,0,0
"5572","2",240,5,2,1,1,208,9,0,0,-45,14,0,0,0,-5,253,-5,0,0
"5573","2",459,2,3,0,1,-13,-166,3,-3,-19,-65,3,-4,0,-2,6,-101,0,1
"5574","2",223,5,1,0,1,-136,1,-1,0,77,-1,-1,0,0,-5,-213,2,0,0
"5575","2",22,6,3,0,1,220,14,1,1,240,-17,1,1,0,-6,-20,31,0,0
"5576","2",46,5,1,0,0,-27,-234,-4,0,-1,-239,-4,4,0,-5,-26,5,0,-4
"5577","2",383,7,4,1,1,-3,250,2,2,1,-249,1,1,0,-7,-4,499,1,1
"5578","2",351,1,1,0,0,-245,-244,-4,-4,119,123,-4,-4,0,-1,-364,-367,0,0
"5579","2",201,1,3,1,1,-230,3,-4,-4,113,-1,2,-2,0,-1,-343,4,-6,-2
"5580","2",420,8,4,1,3,0,-65,2,3,-62,1,0,1,0,-8,62,-66,2,2
"5581","2",275,2,4,0,2,-228,-1,-3,-3,-231,6,2,-4,0,-2,3,-7,-5,1
"5582","2",86,3,4,0,3,160,15,-1,-2,177,-2,2,3,0,-3,-17,17,-3,-5
"5583","2",23,9,1,0,3,216,213,4,4,217,207,3,-4,0,-9,-1,6,1,8
"5584","2",142,4,2,0,2,-30,20,0,-1,23,25,1,0,0,-4,-53,-5,-1,-1
"5585","2",139,1,4,1,2,-190,2,-4,-4,0,236,4,4,0,-1,-190,-234,-8,-8
"5586","2",300,2,1,0,0,-204,21,-2,-3,-24,31,-1,-1,0,-2,-180,-10,-1,-2
"5587","2",382,3,4,0,2,-159,1,-2,-2,85,7,1,1,0,-3,-244,-6,-3,-3
"5588","2",350,9,4,1,1,5,247,4,4,247,7,4,1,0,-9,-242,240,0,3
"5589","2",200,1,3,0,0,-230,-170,-4,-4,-167,-14,-4,-3,0,-1,-63,-156,0,-1
"5590","2",42,3,3,0,1,-13,1,1,-2,2,10,0,0,0,-3,-15,-9,1,-2
"5591","2",274,3,4,0,2,77,77,-2,-2,80,92,-2,-1,0,-3,-3,-15,0,-1
"5592","2",120,4,3,1,1,-76,-80,-1,-1,-109,-98,-1,-1,0,-4,33,18,0,0
"5593","2",229,2,1,0,1,-240,161,-3,-3,-191,42,-2,-2,0,-2,-49,119,-1,-1
"5594","2",225,3,2,1,2,-205,-96,-2,-2,119,-152,2,2,0,-3,-324,56,-4,-4
"5595","2",392,4,1,0,0,-98,-96,-1,-1,-78,-46,-1,-2,0,-4,-20,-50,0,1
"5596","2",360,1,3,0,0,-95,-125,0,-4,164,161,2,-4,0,-1,-259,-286,-2,0
"5597","2",357,3,4,0,2,-231,-25,-4,-2,71,33,0,-2,0,-3,-302,-58,-4,0
"5598","2",378,3,4,1,1,-199,1,-1,-2,97,2,1,1,0,-3,-296,-1,-2,-3
"5599","2",147,7,2,1,3,-187,-147,2,2,117,27,2,-1,0,-7,-304,-174,0,3
"5600","2",95,1,4,1,2,-226,3,-4,-4,-59,2,0,0,0,-1,-167,1,-4,-4
"5601","2",151,1,2,0,1,-244,13,4,-4,-240,3,4,-4,0,-1,-4,10,0,0
"5602","2",148,1,1,0,1,-246,1,3,-4,-201,-46,1,-3,0,-1,-45,47,2,-1
"5603","2",216,7,3,0,1,17,-7,-1,2,-22,19,0,1,0,-7,39,-26,-1,1
"5604","2",212,5,1,0,1,-64,17,0,0,-101,-48,2,-3,0,-5,37,65,-2,3
"5605","2",220,1,4,0,2,-237,198,-4,-4,137,109,-2,-2,0,-1,-374,89,-2,-2
"5606","2",388,1,4,1,0,-241,10,-4,-4,-242,2,-1,1,0,-1,1,8,-3,-5
"5607","2",384,1,1,0,0,-187,0,0,-4,-90,73,2,-3,0,-1,-97,-73,-2,-1
"5608","2",352,5,2,1,1,7,-7,0,0,14,-8,0,0,0,-5,-7,1,0,0
"5609","2",202,4,1,1,1,38,-31,1,-1,-21,102,1,-1,0,-4,59,-133,0,0
"5610","2",421,2,3,0,1,-141,125,-3,-3,78,82,1,2,0,-2,-219,43,-4,-5
"5611","2",276,3,4,0,3,3,-6,0,-2,-3,-2,0,1,0,-3,6,-4,0,-3
"5612","2",393,1,1,1,0,-225,-10,-4,-4,136,-122,3,-2,0,-1,-361,112,-7,-2
"5613","2",361,1,1,0,0,-249,-2,0,-4,-1,242,4,2,0,-1,-248,-244,-4,-6
"5614","2",358,1,4,0,2,-249,145,-4,-4,-234,62,-4,-4,0,-1,-15,83,0,0
"5615","2",394,1,3,0,0,-27,-4,-4,-4,51,-2,-4,-4,0,-1,-78,-2,0,0
"5616","2",301,2,4,1,1,-215,-1,-2,-3,38,-1,2,3,0,-2,-253,0,-4,-6
"5617","2",96,4,1,0,0,-243,0,-3,-1,-21,4,-1,-1,0,-4,-222,-4,-2,0
"5618","2",38,5,4,0,3,0,-3,0,0,38,-109,0,0,0,-5,-38,106,0,0
"5619","2",302,3,1,0,0,-192,-43,-3,-2,208,55,-2,-2,0,-3,-400,-98,-1,0
"5620","2",97,2,1,0,1,-239,75,2,-3,177,124,3,-2,0,-2,-416,-49,-1,-1
"5621","2",153,5,1,1,3,-83,90,1,0,-60,-97,-1,1,0,-5,-23,187,2,-1
"5622","2",121,1,1,0,0,-243,239,-4,-4,234,-240,4,-4,0,-1,-477,479,-8,0
"5623","2",389,3,3,0,2,20,2,-2,-2,1,-2,0,0,0,-3,19,4,-2,-2
"5624","2",226,1,1,0,0,-103,1,-2,-4,191,0,2,-2,0,-1,-294,1,-4,-2
"5625","2",353,4,2,0,2,-247,113,-4,-1,225,-115,2,0,0,-4,-472,228,-6,-1
"5626","2",203,9,4,1,3,-9,-236,4,4,-241,25,4,1,0,-9,232,-261,0,3
"5627","2",422,5,3,0,1,-109,-241,3,0,-54,-235,4,-2,0,-5,-55,-6,-1,2
"5628","2",379,1,3,0,1,6,15,1,-4,-15,-39,1,0,0,-1,21,54,0,-4
"5629","2",123,2,4,1,2,-200,-1,-2,-3,-42,12,-2,-3,0,-2,-158,-13,0,0
"5630","2",390,1,2,0,2,-230,3,-4,-4,110,35,1,3,0,-1,-340,-32,-5,-7
"5631","2",152,2,1,0,0,-113,-1,-2,-3,126,-1,0,-3,0,-2,-239,0,-2,0
"5632","2",149,6,3,0,1,-246,42,-3,1,222,7,-2,2,0,-6,-468,35,-1,-1
"5633","2",217,2,4,1,2,-85,27,-1,-3,-36,22,-1,-3,0,-2,-49,5,0,0
"5634","2",213,4,2,0,1,-1,108,1,-1,-40,4,1,-1,0,-4,39,104,0,0
"5635","2",221,2,4,1,1,-249,38,-3,-3,-3,11,1,1,0,-2,-246,27,-4,-4
"5636","2",303,2,3,0,2,-223,-94,-3,-3,-185,-121,-2,-2,0,-2,-38,27,-1,-1
"5637","2",385,3,4,1,1,-117,-213,-2,-2,158,33,2,-1,0,-3,-275,-246,-4,-1
"5638","2",154,5,4,0,3,-15,-236,0,0,-60,49,0,0,0,-5,45,-285,0,0
"5639","2",122,5,1,0,0,-204,-203,0,0,-14,-22,0,0,0,-5,-190,-181,0,0
"5640","2",39,2,3,1,1,-215,-1,-3,-3,180,190,4,4,0,-2,-395,-191,-7,-7
"5641","2",277,1,4,0,1,-95,64,4,-4,55,-87,2,-1,0,-1,-150,151,2,-3
"5642","2",354,1,1,0,0,-219,-232,-2,-4,144,147,2,3,0,-1,-363,-379,-4,-7
"5643","2",204,5,3,0,1,-115,-123,0,0,39,-104,1,-1,0,-5,-154,-19,-1,1
"5644","2",387,8,3,0,1,174,148,2,3,65,35,1,0,0,-8,109,113,1,3
"5645","2",209,2,4,0,3,-218,4,-3,-3,222,2,3,3,0,-2,-440,2,-6,-6
"5646","2",205,1,1,0,2,-249,-10,-4,-4,224,4,3,3,0,-1,-473,-14,-7,-7
"5647","2",424,3,2,0,2,-31,-8,-3,-2,140,94,1,-1,0,-3,-171,-102,-4,-1
"5648","2",380,1,4,1,1,-216,-199,3,-4,107,-20,3,1,0,-1,-323,-179,0,-5
"5649","2",15,7,4,1,3,140,20,2,2,29,54,2,1,0,-7,111,-34,0,1
"5650","2",98,1,3,0,0,-212,38,-4,-4,111,-159,1,1,0,-1,-323,197,-5,-5
"5651","2",214,9,1,0,3,198,1,2,4,187,4,2,4,0,-9,11,-3,0,0
"5652","2",222,2,1,0,0,-249,-4,-3,-3,-238,-2,-3,-3,0,-2,-11,-2,0,0
"5653","2",304,2,2,0,2,-229,-23,-3,-3,107,-13,2,2,0,-2,-336,-10,-5,-5
"5654","2",386,1,1,0,0,-242,-247,-4,-4,-7,7,-1,-2,0,-1,-235,-254,-3,-2
"5655","2",155,5,2,0,1,-16,-46,0,0,9,-4,0,0,0,-5,-25,-42,0,0
"5656","2",127,1,1,0,0,-236,-2,-4,-4,-110,0,-4,-4,0,-1,-126,-2,0,0
"5657","2",423,4,1,0,3,80,-85,2,-1,-120,10,2,-2,0,-4,200,-95,0,1
"5658","2",278,9,4,0,1,110,111,4,4,1,1,4,-4,0,-9,109,110,0,8
"5659","2",124,3,1,1,3,237,0,-4,-2,247,1,3,2,0,-3,-10,-1,-7,-4
"5660","2",306,5,3,0,3,145,91,1,0,100,86,1,0,0,-5,45,5,0,0
"5661","2",279,7,4,1,3,25,-61,2,2,51,-12,2,2,0,-7,-26,-49,0,0
"5662","2",21,2,4,1,2,-85,-72,-3,-3,109,72,1,-2,0,-2,-194,-144,-4,-1
"5663","2",218,8,4,1,3,-173,-27,4,3,-36,-25,4,3,0,-8,-137,-2,0,0
"5664","2",425,6,4,1,2,71,89,0,1,79,26,1,1,0,-6,-8,63,-1,0
"5665","2",381,1,2,0,2,-237,10,-4,-4,152,107,-4,-4,0,-1,-389,-97,0,0
"5666","2",126,2,2,0,2,-88,-84,-3,-3,2,35,-2,-2,0,-2,-90,-119,-1,-1
"5667","2",99,5,4,1,3,4,9,0,0,-3,3,0,0,0,-5,7,6,0,0
"5668","2",215,2,1,0,0,-68,35,-2,-3,87,23,-2,-3,0,-2,-155,12,0,0
"5669","2",163,1,3,0,1,-238,3,-3,-4,73,-15,1,2,0,-1,-311,18,-4,-6
"5670","2",305,9,4,1,3,-245,-246,4,4,-247,-2,4,4,0,-9,2,-244,0,0
"5671","2",156,5,2,0,1,-38,2,0,0,81,23,1,1,0,-5,-119,-21,-1,-1
"5672","2",164,2,2,0,2,-229,-1,-2,-3,-38,-1,-1,-1,0,-2,-191,0,-1,-2
"5673","2",128,6,1,0,3,154,-55,1,1,-34,-110,4,0,0,-6,188,55,-3,1
"5674","2",157,8,3,0,2,159,122,3,3,132,87,-2,0,0,-8,27,35,5,3
"5675","2",282,9,3,0,3,237,-106,0,4,217,44,0,4,0,-9,20,-150,0,0
"5676","2",206,2,4,0,0,175,-90,-1,-3,-88,24,-1,2,0,-2,263,-114,0,-5
"5677","2",161,1,2,0,2,-242,43,-4,-4,105,84,1,-3,0,-1,-347,-41,-5,-1
"5678","2",28,1,4,0,1,-210,143,-4,-4,37,35,-1,-3,0,-1,-247,108,-3,-1
"5679","2",210,3,4,1,2,-245,-25,1,-2,233,-216,3,0,0,-3,-478,191,-2,-2
"5680","2",219,5,4,0,3,-1,-248,4,0,249,2,4,0,0,-5,-250,-250,0,0
"5681","2",426,9,4,1,3,239,-1,4,4,186,-6,-2,-2,0,-9,53,5,6,6
"5682","2",280,6,2,0,1,-33,-1,-1,1,249,3,4,3,0,-6,-282,-4,-5,-2
"5683","2",130,1,1,0,3,-122,22,-4,-4,77,63,4,1,0,-1,-199,-41,-8,-5
"5684","2",208,1,4,0,2,-221,171,-4,-4,195,201,2,2,0,-1,-416,-30,-6,-6
"5685","2",281,1,4,0,2,-235,11,-4,-4,5,-241,0,-4,0,-1,-240,252,-4,0
"5686","2",293,1,4,0,0,-188,9,-4,-4,-100,-31,-4,-4,0,-1,-88,40,0,0
"5687","2",29,1,4,1,0,-226,234,-4,-4,225,208,-3,-2,0,-1,-451,26,-1,-2
"5688","2",286,6,1,0,3,88,-9,1,1,63,-2,1,1,0,-6,25,-7,0,0
"5689","2",125,3,4,1,0,-184,-16,-4,-2,240,-242,-3,-4,0,-3,-424,226,-1,2
"5690","2",129,4,4,1,1,-140,-1,-1,-1,103,-6,1,1,0,-4,-243,5,-2,-2
"5691","2",158,2,3,0,0,-235,-26,-4,-3,-225,-231,0,-4,0,-2,-10,205,-4,1
"5692","2",283,6,1,0,1,-104,98,-3,1,-84,-119,-2,1,0,-6,-20,217,-1,0
"5693","2",207,1,1,0,0,-248,0,-4,-4,249,-1,4,4,0,-1,-497,1,-8,-8
"5694","2",162,3,3,1,3,-235,-8,-4,-2,187,142,3,4,0,-3,-422,-150,-7,-6
"5695","2",159,1,3,0,2,-238,4,-4,-4,222,0,4,4,0,-1,-460,4,-8,-8
"5696","2",211,3,3,0,1,-141,-132,-4,-2,91,103,2,-1,0,-3,-232,-235,-6,-1
"5697","2",296,6,1,0,3,4,135,-1,1,197,-2,1,2,0,-6,-193,137,-2,-1
"5698","2",427,1,4,0,1,-242,5,4,-4,-158,23,2,-3,0,-1,-84,-18,2,-1
"5699","2",285,1,2,0,1,-175,-139,-4,-4,29,119,-2,-3,0,-1,-204,-258,-2,-1
"5700","2",131,7,4,0,3,-122,46,3,2,131,12,3,3,0,-7,-253,34,0,-1
"5701","2",287,1,4,1,3,222,1,-4,-4,145,-1,3,3,0,-1,77,2,-7,-7
"5702","2",294,8,1,0,3,0,0,3,3,246,0,3,3,0,-8,-246,0,0,0
"5703","2",292,5,3,0,1,77,-80,0,0,1,-106,0,0,0,-5,76,26,0,0
"5704","2",290,3,1,0,1,-174,-188,-1,-2,221,-228,0,-1,0,-3,-395,40,-1,-1
"5705","2",284,1,3,0,1,-231,-189,0,-4,57,46,0,-2,0,-1,-288,-235,0,-2
"5706","2",13,2,4,0,1,-132,-116,-1,-3,107,-3,4,4,0,-2,-239,-113,-5,-7
"5707","2",160,7,2,1,0,-160,-2,-4,2,1,-210,-4,2,0,-7,-161,208,0,0
"5708","2",291,1,4,0,2,246,92,-4,-4,242,50,1,0,0,-1,4,42,-5,-4
"5709","2",289,1,1,1,3,-239,-21,-4,-4,226,224,3,3,0,-1,-465,-245,-7,-7
"5710","2",288,3,2,1,2,-108,1,-4,-2,-112,76,-2,-3,0,-3,4,-75,-2,1
"5711","2",295,5,1,0,1,4,3,0,0,-1,-2,0,0,0,-5,5,5,0,0
"5712","2",16,1,1,0,0,-233,243,-3,-4,229,14,2,1,0,-1,-462,229,-5,-5
"5713","20",406,7,2,1,2,-177,-164,2,2,-17,-22,2,3,4,-3,-160,-142,0,-1
"5714","20",398,7,4,1,2,176,179,2,2,37,32,1,1,4,-3,139,147,1,1
"5715","20",403,4,1,1,0,-63,-23,0,-1,-169,-34,-2,-4,4,0,106,11,2,3
"5716","20",402,1,3,1,0,-157,1,-3,-4,220,-41,1,-3,4,3,-377,42,-4,-1
"5717","20",407,2,2,0,2,-243,-2,-3,-3,230,15,2,2,4,2,-473,-17,-5,-5
"5718","20",399,7,4,1,3,64,-62,1,2,116,32,1,1,4,-3,-52,-94,0,1
"5719","20",404,4,1,1,1,43,-46,0,-1,34,-42,1,-1,4,0,9,-4,-1,0
"5720","20",397,7,4,1,3,139,9,2,2,119,62,1,1,4,-3,20,-53,1,1
"5721","20",400,5,4,1,2,-125,108,-2,0,135,-83,-2,-1,4,-1,-260,191,0,1
"5722","20",40,8,1,0,2,-156,-43,2,3,181,51,2,2,4,-4,-337,-94,0,1
"5723","20",335,3,2,1,1,-127,22,-1,-2,-121,17,-1,-2,4,1,-6,5,0,0
"5724","20",405,3,4,1,1,23,178,-2,-2,148,69,0,0,4,1,-125,109,-2,-2
"5725","20",401,2,2,0,1,-23,6,2,-3,72,16,1,-1,4,2,-95,-10,1,-2
"5726","20",332,5,1,0,0,-249,-2,0,0,-248,51,-2,-2,4,-1,-1,-53,2,2
"5727","20",336,2,4,1,3,-200,141,2,-3,177,118,3,-3,4,2,-377,23,-1,0
"5728","20",41,6,2,0,3,12,82,3,1,15,72,3,1,4,-2,-3,10,0,0
"5729","20",413,7,1,1,1,196,11,2,2,-164,12,1,-2,4,-3,360,-1,1,4
"5730","20",333,6,4,1,1,76,0,1,1,52,-112,1,1,4,-2,24,112,0,0
"5731","20",410,1,1,1,0,-68,-17,-2,-4,43,17,2,-2,4,3,-111,-34,-4,-2
"5732","20",330,4,2,0,2,-245,-1,0,-1,193,176,1,1,4,0,-438,-177,-1,-2
"5733","20",334,1,4,1,0,-234,-148,-4,-4,-247,-185,-4,-4,4,3,13,37,0,0
"5734","20",408,3,1,1,0,-54,-2,-1,-2,-160,8,-2,-3,4,1,106,-10,1,1
"5735","20",331,2,1,1,0,105,54,-4,-3,46,-243,-4,-3,4,2,59,297,0,0
"5736","20",473,6,3,1,0,25,-156,1,1,-24,-14,-1,-1,4,-2,49,-142,2,2
"5737","20",52,2,3,1,0,64,-2,2,-3,84,-2,1,-2,4,2,-20,0,1,-1
"5738","20",409,4,4,1,2,75,75,0,-1,127,114,2,2,4,0,-52,-39,-2,-3
"5739","20",474,1,1,0,0,3,-81,0,-4,4,-69,0,-4,4,3,-1,-12,0,0
"5740","20",182,8,4,0,3,-4,-129,2,3,0,-131,2,2,4,-4,-4,2,0,1
"5741","20",53,7,4,1,3,174,-2,2,2,6,-33,1,1,4,-3,168,31,1,1
"5742","20",5,1,2,0,2,-244,218,-3,-4,-241,220,-2,-4,4,3,-3,-2,-1,0
"5743","20",475,5,3,1,3,114,130,1,0,-207,112,1,0,4,-1,321,18,0,0
"5744","20",4,7,3,1,1,223,137,2,2,214,227,1,4,4,-3,9,-90,1,-2
"5745","20",414,4,1,1,0,-24,-18,-1,-1,83,92,2,2,4,0,-107,-110,-3,-3
"5746","20",320,1,2,0,2,-245,115,-4,-4,-247,93,-4,-4,4,3,2,22,0,0
"5747","20",51,4,4,1,1,-98,-159,2,-1,85,61,1,-1,4,0,-183,-220,1,0
"5748","20",411,1,2,0,2,-227,-222,-4,-4,-230,-219,-4,-4,4,3,3,-3,0,0
"5749","20",415,3,2,0,2,-219,-210,0,-2,150,174,0,4,4,1,-369,-384,0,-6
"5750","20",339,8,3,1,1,138,117,3,3,81,65,1,1,4,-4,57,52,2,2
"5751","20",49,2,4,1,1,-74,-82,-3,-3,-110,-76,-3,-3,4,2,36,-6,0,0
"5752","20",412,8,1,0,0,-238,-3,-4,3,-140,75,-4,4,4,-4,-98,-78,0,-1
"5753","20",416,1,4,1,0,-205,-218,-4,-4,-194,109,-4,-4,4,3,-11,-327,0,0
"5754","20",167,7,1,0,3,148,-113,2,2,166,-125,2,2,4,-3,-18,12,0,0
"5755","20",57,1,4,1,1,-6,-231,-2,-4,-18,-200,-4,-4,4,3,12,-31,2,0
"5756","20",32,5,1,0,1,2,4,0,0,161,-177,2,-4,4,-1,-159,181,-2,4
"5757","20",337,4,2,0,3,-162,70,-1,-1,221,-25,4,4,4,0,-383,95,-5,-5
"5758","20",54,6,4,1,1,9,-7,1,1,135,53,1,1,4,-2,-126,-60,0,0
"5759","20",50,3,2,1,1,31,-13,1,-2,89,2,1,-2,4,1,-58,-15,0,0
"5760","20",338,2,3,1,2,111,77,1,-3,169,180,-2,-2,4,2,-58,-103,3,-1
"5761","20",48,1,3,1,0,7,-8,-4,-4,87,-92,-4,-4,4,3,-80,84,0,0
"5762","20",185,7,4,1,2,59,-14,0,2,17,-10,2,2,4,-3,42,-4,-2,0
"5763","20",181,4,4,1,3,161,120,1,-1,129,-196,-1,-1,4,0,32,316,2,0
"5764","20",56,4,3,1,1,14,-33,-2,-1,27,-65,-2,0,4,0,-13,32,0,-1
"5765","20",186,5,2,0,2,37,21,0,0,-19,14,0,0,4,-1,56,7,0,0
"5766","20",19,3,2,0,2,-138,-191,-1,-2,92,-47,1,-1,4,1,-230,-144,-2,-1
"5767","20",34,6,4,1,2,100,-48,0,1,148,-46,2,1,4,-2,-48,-2,-2,0
"5768","20",179,5,1,0,1,222,1,2,0,-1,-2,0,2,4,-1,223,3,2,-2
"5769","20",187,1,4,1,2,-233,-9,-4,-4,-231,-4,-3,-3,4,3,-2,-5,-1,-1
"5770","20",183,3,4,1,1,58,55,1,-2,51,46,1,-3,4,1,7,9,0,1
"5771","20",168,6,1,1,3,99,-123,2,1,-45,-51,1,0,4,-2,144,-72,1,1
"5772","20",324,1,2,0,0,-68,-231,-4,-4,-141,-242,-4,-4,4,3,73,11,0,0
"5773","20",476,7,3,1,0,197,190,2,2,111,-130,0,0,4,-3,86,320,2,2
"5774","20",55,5,4,1,1,-12,-60,0,0,15,-38,0,0,4,-1,-27,-22,0,0
"5775","20",321,2,1,1,0,-222,-201,-3,-3,-194,-177,-2,-3,4,2,-28,-24,-1,0
"5776","20",468,6,1,0,3,63,63,0,1,60,32,-1,0,4,-2,3,31,1,1
"5777","20",464,3,1,1,1,-205,3,0,-2,-225,18,0,-3,4,1,20,-15,0,1
"5778","20",6,6,4,1,2,36,-5,1,1,15,0,1,1,4,-2,21,-5,0,0
"5779","20",174,6,4,1,3,106,20,0,1,5,1,0,0,4,-2,101,19,0,1
"5780","20",112,8,4,1,3,12,246,4,3,25,247,4,4,4,-4,-13,-1,0,-1
"5781","20",327,3,4,0,3,104,-17,2,-2,143,6,1,-1,4,1,-39,-23,1,-1
"5782","20",323,1,4,1,1,-1,-30,-4,-4,220,-3,0,0,4,3,-221,-27,-4,-4
"5783","20",417,5,2,0,2,4,2,0,0,-31,-29,-1,0,4,-1,35,31,1,0
"5784","20",340,5,1,1,1,13,12,0,0,82,10,0,0,4,-1,-69,2,0,0
"5785","20",58,6,4,1,1,-240,23,-3,1,-8,246,4,2,4,-2,-232,-223,-7,-1
"5786","20",418,4,2,0,2,-69,181,2,-1,179,150,1,-1,4,0,-248,31,1,0
"5787","20",341,9,1,0,3,249,-37,4,4,250,-45,3,4,4,-5,-1,8,1,0
"5788","20",59,6,1,1,0,66,-60,1,1,99,0,2,2,4,-2,-33,-60,-1,-1
"5789","20",189,8,1,1,1,-197,52,3,3,-176,51,2,-3,4,-4,-21,1,1,6
"5790","20",111,3,1,1,0,80,65,1,-2,-28,-11,-1,-3,4,1,108,76,2,1
"5791","20",178,5,1,0,1,0,2,0,0,0,2,0,0,4,-1,0,0,0,0
"5792","20",322,5,4,1,3,-1,-1,0,0,221,-208,3,3,4,-1,-222,207,-3,-3
"5793","20",469,1,4,1,0,67,24,-3,-4,87,85,-3,-4,4,3,-20,-61,0,0
"5794","20",465,5,4,1,3,230,12,2,0,12,-245,4,4,4,-1,218,257,-2,-4
"5795","20",60,7,1,0,3,198,1,1,2,-1,46,2,2,4,-3,199,-45,-1,0
"5796","20",190,7,4,1,3,92,139,2,2,173,184,2,2,4,-3,-81,-45,0,0
"5797","20",113,5,2,1,2,-148,123,-1,0,-171,220,0,0,4,-1,23,-97,-1,0
"5798","20",18,3,3,1,1,22,-14,1,-2,35,82,0,-3,4,1,-13,-96,1,1
"5799","20",188,9,2,1,3,234,-1,4,4,237,-1,4,4,4,-5,-3,0,0,0
"5800","20",184,6,3,1,3,137,-4,1,1,135,-3,1,1,4,-2,2,-1,0,0
"5801","20",169,1,3,1,0,-223,95,-4,-4,-178,82,-4,-4,4,3,-45,13,0,0
"5802","20",325,4,1,0,1,-169,-158,4,-1,51,46,0,4,4,0,-220,-204,4,-5
"5803","20",419,5,4,1,3,116,102,0,0,110,100,1,0,4,-1,6,2,-1,0
"5804","20",17,1,3,1,0,15,2,0,-4,166,124,-2,-4,4,3,-151,-122,2,0
"5805","20",63,4,4,1,1,-4,4,0,-1,-4,1,0,1,4,0,0,3,0,-2
"5806","20",193,1,1,0,0,-239,-64,-4,-4,138,45,1,1,4,3,-377,-109,-5,-5
"5807","20",116,8,2,0,3,60,-17,1,3,18,-16,1,1,4,-4,42,-1,0,2
"5808","20",109,1,1,0,1,0,-14,4,-4,1,-49,3,-4,4,3,-1,35,1,0
"5809","20",175,2,4,1,1,-204,-6,-2,-3,-183,-94,-1,-2,4,2,-21,88,-1,-1
"5810","20",171,5,1,1,1,6,14,0,0,28,2,0,0,4,-1,-22,12,0,0
"5811","20",328,4,3,1,1,-21,12,-1,-1,17,9,1,1,4,0,-38,3,-2,-2
"5812","20",297,4,3,1,2,11,15,1,-1,-201,24,-2,-3,4,0,212,-9,3,2
"5813","20",470,6,1,1,1,-52,17,1,1,-50,26,-1,-1,4,-2,-2,-9,2,2
"5814","20",467,2,1,0,3,-214,164,4,-3,137,124,4,0,4,2,-351,40,0,-3
"5815","20",62,9,2,0,3,222,234,0,4,235,229,4,4,4,-5,-13,5,-4,0
"5816","20",192,6,4,1,1,-3,6,1,1,-1,97,0,-1,4,-2,-2,-91,1,2
"5817","20",342,3,3,1,1,-136,-184,0,-2,-131,-242,-1,-4,4,1,-5,58,1,2
"5818","20",108,9,2,0,3,216,29,4,4,176,55,4,4,4,-5,40,-26,0,0
"5819","20",104,4,1,1,0,-36,0,1,-1,242,-1,-2,-3,4,0,-278,1,3,2
"5820","20",170,1,2,0,0,-243,-241,-4,-4,9,9,0,0,4,3,-252,-250,-4,-4
"5821","20",258,1,3,1,0,-245,2,-3,-4,20,1,-3,-3,4,3,-265,1,0,-1
"5822","20",254,4,2,0,3,16,-15,1,-1,135,-37,-3,-1,4,0,-119,22,4,0
"5823","20",47,7,4,1,3,95,0,1,2,167,-1,2,2,4,-3,-72,1,-1,0
"5824","20",466,7,3,1,0,109,-80,1,2,-139,-101,-2,-2,4,-3,248,21,3,4
"5825","20",61,2,1,1,3,249,-12,4,-3,-15,175,3,3,4,2,264,-187,1,-6
"5826","20",191,3,1,0,0,-190,-46,-2,-2,-170,-46,-2,-2,4,1,-20,0,0,0
"5827","20",114,2,4,1,1,-140,-159,0,-3,155,172,0,-3,4,2,-295,-331,0,0
"5828","20",180,3,2,0,2,-88,-1,0,-2,0,-76,-1,-3,4,1,-88,75,1,1
"5829","20",177,2,4,1,1,38,192,-3,-3,-85,122,-2,-2,4,2,123,70,-1,-1
"5830","20",115,5,3,0,3,1,1,0,0,248,3,0,0,4,-1,-247,-2,0,0
"5831","20",33,4,3,0,1,61,-50,-4,-1,-39,64,-1,1,4,0,100,-114,-3,-2
"5832","20",326,7,4,1,2,155,120,2,2,160,93,2,2,4,-3,-5,27,0,0
"5833","20",42,3,3,1,1,-7,6,2,-2,-25,17,2,-3,4,1,18,-11,0,1
"5834","20",343,4,2,0,2,-95,8,-1,-1,-53,0,-1,-1,4,0,-42,8,0,0
"5835","20",64,3,1,1,1,-59,48,-1,-2,187,-204,3,4,4,1,-246,252,-4,-6
"5836","20",194,7,1,1,0,-116,38,-4,2,-207,10,-4,2,4,-3,91,28,0,0
"5837","20",117,2,4,1,2,-155,7,-2,-3,-169,-4,-2,-3,4,2,14,11,0,0
"5838","20",11,4,4,1,1,190,84,3,-1,-130,102,-1,2,4,0,320,-18,4,-3
"5839","20",176,7,1,1,1,184,60,1,2,191,64,-3,2,4,-3,-7,-4,4,0
"5840","20",172,6,2,0,3,64,97,1,1,-2,131,3,3,4,-2,66,-34,-2,-2
"5841","20",329,5,4,1,3,-123,133,-1,0,-165,64,-1,-1,4,-1,42,69,0,1
"5842","20",298,3,1,0,0,-242,1,-1,-2,-1,-240,0,-2,4,1,-241,241,-1,0
"5843","20",471,5,3,1,2,-155,-29,-1,0,110,-160,1,1,4,-1,-265,131,-2,-1
"5844","20",395,3,3,1,1,-33,7,-2,-2,195,18,3,3,4,1,-228,-11,-5,-5
"5845","20",249,1,3,1,0,-137,-20,-2,-4,-223,-17,-4,-4,4,3,86,-3,2,0
"5846","20",460,5,1,1,0,95,19,-2,0,177,42,-3,1,4,-1,-82,-23,1,-1
"5847","20",314,1,4,1,1,-236,11,4,-4,-239,12,4,-4,4,3,3,-1,0,0
"5848","20",27,3,2,0,2,-180,121,-2,-2,-13,210,0,-2,4,1,-167,-89,-2,0
"5849","20",105,6,1,1,0,46,3,-1,1,-33,-4,-2,1,4,-2,79,7,1,0
"5850","20",101,1,3,1,0,-237,240,-4,-4,229,234,-3,-3,4,3,-466,6,-1,-1
"5851","20",259,2,3,1,1,1,2,4,-3,48,24,4,-2,4,2,-47,-22,0,-1
"5852","20",255,5,3,1,1,-113,-150,0,0,-84,-132,0,0,4,-1,-29,-18,0,0
"5853","20",446,5,4,1,1,80,7,0,0,12,14,0,0,4,-1,68,-7,0,0
"5854","20",442,6,4,1,1,20,29,0,1,28,31,1,1,4,-2,-8,-2,-1,0
"5855","20",439,5,2,0,1,0,-2,0,0,-1,-4,0,0,4,-1,1,2,0,0
"5856","20",362,7,4,1,3,172,-217,4,2,141,124,3,1,4,-3,31,-341,1,1
"5857","20",435,5,4,1,1,-4,-43,0,0,6,4,0,0,4,-1,-10,-47,0,0
"5858","20",269,4,4,1,2,250,83,0,-1,248,58,-1,-1,4,0,2,25,1,0
"5859","20",265,9,1,0,3,212,1,4,4,2,-1,0,0,4,-5,210,2,4,4
"5860","20",100,9,4,1,3,189,1,3,4,1,-157,-1,-1,4,-5,188,158,4,5
"5861","20",302,3,1,1,0,9,-16,-2,-2,206,53,-2,-2,4,1,-197,-69,0,0
"5862","20",3,4,3,1,0,162,2,-2,-1,-56,0,-3,-3,4,0,218,2,1,2
"5863","20",420,4,4,0,3,-93,-1,-1,-1,-3,0,2,3,4,0,-90,-1,-3,-4
"5864","20",344,7,4,1,3,154,-98,1,2,48,94,0,1,4,-3,106,-192,1,1
"5865","20",65,7,1,0,3,72,57,2,2,52,40,1,2,4,-3,20,17,1,0
"5866","20",195,1,1,1,1,-233,235,4,-4,-236,230,4,-4,4,3,3,5,0,0
"5867","20",118,6,3,1,1,-14,-17,-2,1,20,24,-2,1,4,-2,-34,-41,0,0
"5868","20",110,7,1,0,1,-120,95,-3,2,46,-124,-4,2,4,-3,-166,219,1,0
"5869","20",107,2,2,0,3,-52,47,3,-3,59,47,-3,0,4,2,-111,0,6,-3
"5870","20",173,6,4,1,3,121,6,1,1,178,33,0,0,4,-2,-57,-27,1,1
"5871","20",301,6,4,1,1,43,0,2,1,33,3,1,2,4,-2,10,-3,1,-1
"5872","20",299,4,4,1,1,-124,141,-1,-1,17,226,4,4,4,0,-141,-85,-5,-5
"5873","20",472,1,1,1,0,-22,11,-4,-4,-201,15,-4,-4,4,3,179,-4,0,0
"5874","20",396,1,1,1,1,-181,113,4,-4,-192,141,4,-4,4,3,11,-28,0,0
"5875","20",25,2,4,1,2,-10,-10,-2,-3,-124,-115,-1,-2,4,2,114,105,-1,-1
"5876","20",461,4,4,1,2,74,41,1,-1,47,57,0,0,4,0,27,-16,1,-1
"5877","20",315,8,3,1,3,0,0,3,3,247,9,3,3,4,-4,-247,-9,0,0
"5878","20",270,3,3,1,1,77,3,1,-2,249,4,4,4,4,1,-172,-1,-3,-6
"5879","20",106,3,2,0,1,-157,-95,-2,-2,-179,-132,-2,-2,4,1,22,37,0,0
"5880","20",102,9,4,1,3,-123,122,2,4,-86,-140,2,3,4,-5,-37,262,0,1
"5881","20",26,3,1,1,0,-36,-32,0,-2,-21,-26,-2,-2,4,1,-15,-6,2,0
"5882","20",256,5,3,1,1,41,-2,0,0,93,53,0,0,4,-1,-52,-55,0,0
"5883","20",447,2,4,1,2,-94,2,-2,-3,-60,19,-2,-2,4,2,-34,-17,0,-1
"5884","20",443,3,1,0,0,-211,26,0,-2,83,64,1,1,4,1,-294,-38,-1,-3
"5885","20",44,1,2,1,2,116,27,-1,-4,239,241,-4,-4,4,3,-123,-214,3,0
"5886","20",363,8,3,1,3,249,-48,3,3,250,-1,3,3,4,-4,-1,-47,0,0
"5887","20",436,4,4,1,3,6,25,0,-1,88,-9,3,-1,4,0,-82,34,-3,0
"5888","20",310,7,4,1,2,73,1,1,2,0,-2,-1,1,4,-3,73,3,2,1
"5889","20",266,3,1,0,1,-100,-14,-2,-2,-114,-110,-1,-1,4,1,14,96,-1,-1
"5890","20",262,6,4,1,3,95,1,1,1,35,37,1,1,4,-2,60,-36,0,0
"5891","20",303,2,3,1,2,-204,-215,-3,-3,-184,-185,-3,-3,4,2,-20,-30,0,0
"5892","20",30,1,2,1,2,-247,-27,-4,-4,-191,-1,2,4,4,3,-56,-26,-6,-8
"5893","20",421,5,3,1,1,49,51,0,0,216,218,2,-2,4,-1,-167,-167,-2,2
"5894","20",345,3,1,1,0,14,-210,-2,-2,7,-151,0,-3,4,1,7,-59,-2,1
"5895","20",66,3,1,0,1,64,4,1,-2,125,-1,1,-2,4,1,-61,5,0,0
"5896","20",196,3,3,1,0,30,38,-1,-2,-2,3,0,0,4,1,32,35,-1,-2
"5897","20",119,4,3,1,3,-52,89,-1,-1,45,75,1,1,4,0,-97,14,-2,-2
"5898","20",272,5,4,1,2,154,-55,0,0,29,35,0,-1,4,-1,125,-90,0,1
"5899","20",31,1,1,0,0,-136,104,-4,-4,-128,106,-4,-4,4,3,-8,-2,0,0
"5900","20",261,9,1,0,3,130,74,4,4,94,80,4,4,4,-5,36,-6,0,0
"5901","20",306,5,3,1,3,134,118,1,0,142,111,1,0,4,-1,-8,7,0,0
"5902","20",452,3,3,1,1,-70,3,-2,-2,2,-52,0,0,4,1,-72,55,-2,-2
"5903","20",449,6,4,1,3,-25,77,1,1,27,72,0,0,4,-2,-52,5,1,1
"5904","20",445,7,4,1,3,107,-61,1,2,116,-56,1,3,4,-3,-9,-5,0,-1
"5905","20",250,6,1,0,3,68,17,1,1,79,22,1,1,4,-2,-11,-5,0,0
"5906","20",462,9,3,1,3,232,167,4,4,228,191,4,4,4,-5,4,-24,0,0
"5907","20",316,3,3,1,0,-146,-18,-2,-2,-109,-42,-2,-2,4,1,-37,24,0,0
"5908","20",271,7,3,1,1,112,2,0,2,98,-5,3,4,4,-3,14,7,-3,-2
"5909","20",268,8,4,1,3,80,-87,3,3,145,-153,3,3,4,-4,-65,66,0,0
"5910","20",103,2,2,1,3,83,3,-2,-3,-124,-17,-2,-3,4,2,207,20,0,0
"5911","20",260,7,3,1,0,80,75,2,2,1,-2,0,0,4,-3,79,77,2,2
"5912","20",257,1,1,1,0,-139,46,0,-4,97,22,1,-4,4,3,-236,24,-1,0
"5913","20",448,8,2,0,2,-4,44,-1,3,244,0,4,4,4,-4,-248,44,-5,-1
"5914","20",444,1,2,1,2,-237,80,-2,-4,-224,85,-4,-4,4,3,-13,-5,2,0
"5915","20",440,4,3,1,0,-25,-15,-1,-1,-17,1,-1,-1,4,0,-8,-16,0,0
"5916","20",364,3,3,1,1,-146,-2,-2,-2,-105,-5,0,0,4,1,-41,3,-2,-2
"5917","20",437,3,1,0,0,-193,0,-2,-2,-171,-2,-2,-2,4,1,-22,2,0,0
"5918","20",311,6,2,1,2,42,-4,-2,1,200,7,4,-4,4,-2,-158,-11,-6,5
"5919","20",267,5,3,1,1,-1,-1,0,0,-1,-1,0,0,4,-1,0,0,0,0
"5920","20",263,5,4,1,0,0,-2,0,0,0,2,0,0,4,-1,0,-4,0,0
"5921","20",304,3,2,0,2,-41,-42,-2,-2,76,-46,1,1,4,1,-117,4,-3,-3
"5922","20",300,5,1,1,0,-2,1,0,0,18,32,0,0,4,-1,-20,-31,0,0
"5923","20",422,1,3,1,1,-121,-201,4,-4,-2,-213,3,0,4,3,-119,12,1,-4
"5924","20",346,7,3,1,0,-245,-7,-3,2,185,-1,2,2,4,-3,-430,-6,-5,0
"5925","20",67,3,1,0,0,-50,34,0,-2,166,-161,1,1,4,1,-216,195,-1,-3
"5926","20",197,6,4,1,3,137,-6,1,1,64,-37,3,1,4,-2,73,31,-2,0
"5927","20",12,9,4,1,3,-2,-1,4,4,-2,3,4,4,4,-5,0,-4,0,0
"5928","20",273,4,1,0,0,0,-5,-1,-1,-29,-13,1,0,4,0,29,8,-2,-1
"5929","20",388,3,4,1,0,224,1,1,-2,-2,-245,1,-1,4,1,226,246,0,-1
"5930","20",384,2,1,0,0,-93,1,-3,-3,0,14,-2,-3,4,2,-93,-13,-1,0
"5931","20",307,6,4,1,2,207,189,2,1,199,165,1,2,4,-2,8,24,1,-1
"5932","20",453,2,4,1,2,-1,-120,0,-3,-3,-114,0,-3,4,2,2,-6,0,0
"5933","20",45,3,3,1,0,82,63,2,-2,109,111,1,1,4,1,-27,-48,1,-3
"5934","20",373,1,3,1,0,-207,-218,1,-4,-221,-177,-1,-4,4,3,14,-41,2,0
"5935","20",251,2,3,1,1,90,12,0,-3,-23,-148,-2,-2,4,2,113,160,2,-1
"5936","20",463,8,4,1,3,190,1,2,3,-95,3,1,1,4,-4,285,-2,1,2
"5937","20",317,4,4,0,2,-28,23,-1,-1,-96,104,-2,-2,4,0,68,-81,1,1
"5938","20",313,6,3,1,0,83,90,1,1,94,115,2,2,4,-2,-11,-25,-1,-1
"5939","20",431,5,3,0,0,-16,3,-1,0,56,47,-1,0,4,-1,-72,-44,0,0
"5940","20",428,1,1,0,0,-121,-102,-2,-4,-197,-216,-3,-3,4,3,76,114,1,-1
"5941","20",132,6,4,1,1,-27,-126,0,1,-76,90,-2,1,4,-2,49,-216,2,0
"5942","20",76,6,4,1,3,67,-1,1,1,35,1,1,1,4,-2,32,-2,0,0
"5943","20",424,3,2,0,2,-144,-5,-2,-2,42,4,1,-1,4,1,-186,-9,-3,-1
"5944","20",348,5,3,1,1,63,62,-2,0,102,79,0,-1,4,-1,-39,-17,-2,1
"5945","20",441,8,4,1,2,-1,-234,4,3,23,-213,3,2,4,-4,-24,-21,1,1
"5946","20",365,1,3,1,1,-234,-10,-4,-4,-213,-2,-4,-4,4,3,-21,-8,0,0
"5947","20",438,5,4,1,3,45,-1,4,0,0,-3,4,0,4,-1,45,2,0,0
"5948","20",312,5,4,1,1,-79,-54,0,0,156,35,0,0,4,-1,-235,-89,0,0
"5949","20",309,4,4,1,2,143,106,-2,-1,85,-68,2,1,4,0,58,174,-4,-2
"5950","20",264,3,4,1,2,97,40,0,-2,-15,-188,-4,-4,4,1,112,228,4,2
"5951","20",305,9,4,1,3,206,157,4,4,214,199,4,4,4,-5,-8,-42,0,0
"5952","20",451,2,1,0,0,-157,-172,-3,-3,-140,-182,-3,-3,4,2,-17,10,0,0
"5953","20",423,7,1,1,3,196,-38,2,2,-205,-38,0,3,4,-3,401,0,2,-1
"5954","20",347,7,1,1,3,-80,-226,1,2,-202,138,3,2,4,-3,122,-364,-2,0
"5955","20",68,1,4,1,0,59,4,-1,-4,131,6,-2,-4,4,3,-72,-2,1,0
"5956","20",198,3,1,0,1,-92,46,-1,-2,-101,-3,-1,-1,4,1,9,49,0,-1
"5957","20",120,3,3,1,1,-154,-164,-2,-2,-58,-99,-1,-1,4,1,-96,-65,-1,-1
"5958","20",274,6,4,1,2,-30,-222,-1,1,-77,-216,-1,1,4,-2,47,-6,0,0
"5959","20",389,3,3,1,2,141,1,-2,-2,38,-11,0,0,4,1,103,12,-2,-2
"5960","20",385,4,4,0,1,-46,66,-1,-1,144,72,2,2,4,0,-190,-6,-3,-3
"5961","20",308,3,4,1,0,-115,-98,-4,-2,-1,2,0,1,4,1,-114,-100,-4,-3
"5962","20",454,7,4,1,3,238,1,2,2,179,1,2,2,4,-3,59,0,0,0
"5963","20",450,3,4,0,3,70,-1,1,-2,-1,168,1,-2,4,1,71,-169,0,0
"5964","20",374,7,4,1,2,110,9,1,2,94,11,1,1,4,-3,16,-2,0,1
"5965","20",252,4,4,1,1,-82,-121,0,-1,-69,-109,-1,0,4,0,-13,-12,1,-1
"5966","20",1,4,1,0,1,-168,-86,-1,-1,-135,-102,-2,-1,4,0,-33,16,1,0
"5967","20",318,6,2,0,2,28,-90,-4,1,186,-101,-4,0,4,-2,-158,11,0,1
"5968","20",165,3,1,0,1,-190,-33,-2,-2,128,124,3,1,4,1,-318,-157,-5,-3
"5969","20",432,5,2,1,1,38,-37,-1,0,33,-54,0,0,4,-1,5,17,-1,0
"5970","20",429,1,2,0,0,-214,-219,-4,-4,-243,-106,-4,-4,4,3,29,-113,0,0
"5971","20",133,1,2,0,1,-214,-231,0,-4,-230,-25,2,-2,4,3,16,-206,-2,-2
"5972","20",77,6,3,1,1,-126,-9,-1,1,-34,4,-1,-1,4,-2,-92,-13,0,2
"5973","20",425,5,4,1,2,-24,-69,0,0,-10,-17,0,-1,4,-1,-14,-52,0,1
"5974","20",349,9,4,1,1,72,68,2,4,41,57,3,2,4,-5,31,11,-1,2
"5975","20",37,1,1,0,0,-227,119,-4,-4,-232,88,-4,-4,4,3,5,31,0,0
"5976","20",366,9,4,1,3,149,-59,3,4,201,-63,2,3,4,-5,-52,4,1,1
"5977","20",143,8,1,0,3,137,-14,3,3,136,-134,3,3,4,-4,1,120,0,0
"5978","20",87,8,4,1,3,80,0,3,3,0,0,0,1,4,-4,80,0,3,2
"5979","20",390,9,2,1,2,243,169,4,4,238,71,3,3,4,-5,5,98,1,1
"5980","20",387,2,3,1,1,-72,-63,-1,-3,106,67,1,2,4,2,-178,-130,-2,-5
"5981","20",46,1,1,0,0,-110,-245,-4,-4,-9,-234,-2,-3,4,3,-101,-11,-2,-1
"5982","20",456,2,1,1,0,-150,23,-1,-3,-144,62,-1,-3,4,2,-6,-39,0,0
"5983","20",38,6,4,1,3,40,-28,0,1,-6,-64,2,2,4,-2,46,36,-2,-1
"5984","20",376,3,4,1,1,50,-77,-2,-2,49,-77,-1,-1,4,1,1,0,-1,-1
"5985","20",69,6,4,1,1,-28,77,1,1,68,-45,-1,-2,4,-2,-96,122,2,3
"5986","20",199,2,4,1,2,-222,-145,-3,-3,-225,-142,-2,-2,4,2,3,-3,-1,-1
"5987","20",121,1,1,0,0,-37,33,-4,-4,231,19,-2,-4,4,3,-268,14,-2,0
"5988","20",275,8,4,1,2,236,3,2,3,228,5,2,-1,4,-4,8,-2,0,4
"5989","20",39,6,3,1,1,119,26,2,1,182,190,3,3,4,-2,-63,-164,-1,-2
"5990","20",386,1,1,0,0,-237,208,-4,-4,20,30,2,-1,4,3,-257,178,-6,-3
"5991","20",459,1,3,1,1,-116,70,3,-4,-166,170,3,-4,4,3,50,-100,0,0
"5992","20",455,2,2,1,2,-246,1,-3,-3,1,160,3,3,4,2,-247,-159,-6,-6
"5993","20",379,1,3,1,1,-56,-127,3,-4,128,59,2,0,4,3,-184,-186,1,-4
"5994","20",375,4,3,1,1,-11,1,-1,-1,0,-1,0,0,4,0,-11,2,-1,-1
"5995","20",253,6,3,1,3,38,42,1,1,1,0,1,1,4,-2,37,42,0,0
"5996","20",10,2,3,1,1,-199,2,-3,-3,-128,2,-2,-2,4,2,-71,0,-1,-1
"5997","20",319,3,1,1,1,52,32,-1,-2,43,41,1,2,4,1,9,-9,-2,-4
"5998","20",166,2,4,1,2,193,189,-3,-3,178,182,-2,1,4,2,15,7,-1,-4
"5999","20",433,1,1,0,0,-211,-218,-4,-4,227,241,3,4,4,3,-438,-459,-7,-8
"6000","20",43,1,3,1,0,-47,14,-4,-4,129,14,-4,-4,4,3,-176,0,0,0
"6001","20",134,7,2,0,2,5,-7,1,2,8,-6,1,0,4,-3,-3,-1,0,2
"6002","20",78,3,4,1,0,-203,-1,-2,-2,-171,-5,-2,-2,4,1,-32,4,0,0
"6003","20",426,9,4,1,3,2,222,4,4,-244,1,-3,-2,4,-5,246,221,7,6
"6004","20",35,2,1,0,3,42,118,1,-3,133,124,2,-1,4,2,-91,-6,-1,-2
"6005","20",370,4,1,1,3,-68,-12,-4,-1,-224,-39,-3,-4,4,0,156,27,-1,3
"6006","20",367,5,3,1,1,64,59,1,0,7,9,0,0,4,-1,57,50,1,0
"6007","20",144,1,3,1,0,154,2,1,-4,113,0,1,-1,4,3,41,2,0,-3
"6008","20",88,8,4,1,2,136,-18,3,3,203,-199,4,4,4,-4,-67,181,-1,-1
"6009","20",391,5,2,1,3,-37,-174,-1,0,155,-167,-2,0,4,-1,-192,-7,1,0
"6010","20",241,4,4,1,2,166,46,1,-1,192,183,2,0,4,0,-26,-137,-1,-1
"6011","20",137,6,1,1,1,32,26,-3,1,-38,-28,-4,-1,4,-2,70,54,1,2
"6012","20",457,2,3,1,1,-174,-18,-1,-3,16,231,3,2,4,2,-190,-249,-4,-5
"6013","20",380,2,4,1,1,211,-48,3,-3,-111,-34,3,-3,4,2,322,-14,0,0
"6014","20",377,1,1,0,0,-59,15,-4,-4,235,128,4,0,4,3,-294,-113,-8,-4
"6015","20",7,6,1,0,3,148,81,1,1,-109,78,0,0,4,-2,257,3,1,1
"6016","20",2,4,4,1,1,61,-68,2,-1,-43,-73,-3,0,4,0,104,5,5,-1
"6017","20",122,1,1,0,0,-217,-225,-4,-4,228,234,0,0,4,3,-445,-459,-4,-4
"6018","20",276,7,4,1,3,180,-1,2,2,186,1,2,2,4,-3,-6,-2,0,0
"6019","20",22,6,3,1,1,125,8,1,1,165,13,-3,1,4,-2,-40,-5,4,0
"6020","20",14,4,3,1,1,-42,-3,-1,-1,145,-33,1,1,4,0,-187,30,-2,-2
"6021","20",136,2,1,1,0,-170,135,-3,-3,143,-84,-3,-3,4,2,-313,219,0,0
"6022","20",8,6,3,1,1,217,-24,2,1,140,194,2,1,4,-2,77,-218,0,0
"6023","20",355,5,2,1,2,16,74,3,0,-182,137,-4,-3,4,-1,198,-63,7,3
"6024","20",351,5,1,0,0,-246,-245,0,0,244,247,-4,-4,4,-1,-490,-492,4,4
"6025","20",372,2,3,1,0,-187,-154,-3,-3,-229,-214,-3,-2,4,2,42,60,0,-1
"6026","20",369,4,4,1,0,-143,1,-1,-1,69,4,1,1,4,0,-212,-3,-2,-2
"6027","20",247,5,3,1,0,197,-9,0,0,247,-16,1,2,4,-1,-50,7,-1,-2
"6028","20",243,4,2,1,2,248,-197,3,-1,246,70,-1,-1,4,0,2,-267,4,0
"6029","20",434,6,4,0,3,113,-77,3,1,229,-30,2,2,4,-2,-116,-47,1,-1
"6030","20",430,5,2,0,1,31,-49,0,0,157,-73,1,1,4,-1,-126,24,-1,-1
"6031","20",135,5,1,0,1,-146,-47,1,0,-133,-17,0,0,4,-1,-13,-30,1,0
"6032","20",79,1,4,1,2,-228,26,-4,-4,-230,20,-4,-4,4,3,2,6,0,0
"6033","20",427,3,4,1,1,179,51,2,-2,-191,-79,3,-3,4,1,370,130,-1,1
"6034","20",350,4,4,0,1,-244,22,-2,-1,3,-244,2,1,4,0,-247,266,-4,-2
"6035","20",371,7,3,1,0,221,74,-3,2,128,109,-2,-2,4,-3,93,-35,-1,4
"6036","20",368,9,3,1,3,-27,132,4,4,-138,153,4,4,4,-5,111,-21,0,0
"6037","20",145,6,1,0,1,126,6,0,1,-17,14,0,1,4,-2,143,-8,0,0
"6038","20",89,4,3,1,0,71,1,-2,-1,-64,3,-4,-4,4,0,135,-2,2,3
"6039","20",392,2,1,1,0,-232,235,-3,-3,-136,0,-1,-1,4,2,-96,235,-2,-2
"6040","20",242,3,4,1,2,41,1,1,-2,17,0,0,-3,4,1,24,1,1,1
"6041","20",138,5,3,1,1,37,-99,0,0,19,-9,0,0,4,-1,18,-90,0,0
"6042","20",458,2,1,0,1,-56,-70,-1,-3,72,81,-1,-2,4,2,-128,-151,0,-1
"6043","20",381,1,2,0,2,-233,223,-4,-4,-3,1,0,0,4,3,-230,222,-4,-4
"6044","20",378,4,4,1,1,-116,-7,-2,-1,-162,-4,-2,-2,4,0,46,-3,0,1
"6045","20",70,1,2,0,2,-238,-79,4,-4,14,35,0,-4,4,3,-252,-114,4,0
"6046","20",20,5,3,1,0,35,30,-1,0,201,198,4,4,4,-1,-166,-168,-5,-4
"6047","20",123,6,4,1,2,31,25,-2,1,-128,41,-2,-2,4,-2,159,-16,0,3
"6048","20",277,1,4,0,1,-59,109,4,-4,13,-67,0,0,4,3,-72,176,4,-4
"6049","20",220,1,4,1,2,-238,181,-4,-4,100,135,-2,-2,4,3,-338,46,-2,-2
"6050","20",140,4,1,1,1,-32,-50,1,-1,-32,23,0,-1,4,0,0,-73,1,0
"6051","20",233,5,2,1,2,-21,44,-3,0,-158,13,0,0,4,-1,137,31,-3,0
"6052","20",80,7,4,1,3,250,-3,4,2,250,1,4,-4,4,-3,0,-4,0,6
"6053","20",356,4,4,1,1,33,1,1,-1,78,1,1,1,4,0,-45,0,0,-2
"6054","20",352,4,2,0,1,13,-24,0,-1,13,-80,0,-1,4,0,0,56,0,0
"6055","20",154,6,4,1,3,118,21,1,1,73,88,1,1,4,-2,45,-67,0,0
"6056","20",150,5,3,0,1,-2,2,0,0,-2,2,0,0,4,-1,0,0,0,0
"6057","20",248,9,4,1,3,240,159,4,4,-30,221,2,0,4,-5,270,-62,2,4
"6058","20",244,7,4,1,2,175,203,2,2,151,193,2,1,4,-3,24,10,0,1
"6059","20",394,9,3,1,0,47,3,4,4,-179,-2,4,4,4,-5,226,5,0,0
"6060","20",382,6,4,1,2,4,-1,1,1,185,19,3,3,4,-2,-181,-20,-2,-2
"6061","20",232,1,1,0,0,-234,-224,-4,-4,-243,-242,-4,-4,4,3,9,18,0,0
"6062","20",240,9,2,1,1,226,-209,4,4,215,-24,4,-4,4,-5,11,-185,0,8
"6063","20",383,5,4,1,1,1,-1,0,0,1,-12,0,0,4,-1,0,11,0,0
"6064","20",124,7,1,1,3,247,43,3,2,140,-234,3,2,4,-3,107,277,0,0
"6065","20",72,5,1,1,0,87,108,0,0,133,144,2,2,4,-1,-46,-36,-2,-2
"6066","20",201,7,3,1,1,178,-2,-2,2,68,2,1,-3,4,-3,110,-4,-3,5
"6067","20",146,2,2,1,0,-116,-143,-3,-3,-188,-186,-4,-3,4,2,72,43,1,0
"6068","20",9,5,4,1,2,101,57,1,0,74,37,1,-1,4,-1,27,20,0,1
"6069","20",393,1,1,0,0,-173,0,-4,-4,-163,0,-4,-4,4,3,-10,0,0,0
"6070","20",142,5,2,1,2,72,-26,-1,0,-1,1,-2,0,4,-1,73,-27,1,0
"6071","20",139,1,4,1,2,-249,3,-4,-4,-245,0,-4,-4,4,3,-4,3,0,0
"6072","20",24,1,2,1,2,-119,116,-4,-4,236,-239,1,4,4,3,-355,355,-5,-8
"6073","20",151,1,2,0,1,-238,12,0,-4,-243,13,0,-4,4,3,5,-1,0,0
"6074","20",148,6,1,1,1,69,-53,-2,1,-162,-1,2,0,4,-2,231,-52,-4,1
"6075","20",71,4,3,1,1,-37,14,-1,-1,41,34,-1,0,4,0,-78,-20,0,-1
"6076","20",200,1,3,1,0,-226,-201,-4,-4,-230,-142,-4,-4,4,3,4,-59,0,0
"6077","20",359,9,4,1,3,221,20,4,4,206,29,4,4,4,-5,15,-9,0,0
"6078","20",278,1,4,1,1,-236,-233,4,-4,-224,-232,4,-4,4,3,-12,-1,0,0
"6079","20",221,4,4,1,1,-161,7,-1,-1,-3,10,0,0,4,0,-158,-3,-1,-1
"6080","20",141,6,1,1,0,80,-10,2,1,-238,-39,-4,-2,4,-2,318,29,6,3
"6081","20",234,5,3,1,3,114,46,-1,0,79,33,0,1,4,-1,35,13,-1,-1
"6082","20",81,8,1,0,0,-230,214,4,3,-221,203,4,4,4,-4,-9,11,0,-1
"6083","20",357,7,4,1,2,87,-24,1,2,-71,72,2,-4,4,-3,158,-96,-1,6
"6084","20",353,7,2,1,2,232,177,3,2,218,223,0,-4,4,-3,14,-46,3,6
"6085","20",155,2,2,0,1,-238,-228,-3,-3,1,-3,0,0,4,2,-239,-225,-3,-3
"6086","20",223,5,1,0,1,-4,0,0,0,1,1,0,0,4,-1,-5,-1,0,0
"6087","20",358,1,4,1,2,189,199,0,-4,-202,110,-4,-4,4,3,391,89,4,0
"6088","20",245,2,1,1,0,-151,-17,-2,-3,-189,-10,-4,-4,4,2,38,-7,2,1
"6089","20",224,4,2,0,2,-48,-27,-3,-1,186,70,2,1,4,0,-234,-97,-5,-2
"6090","20",152,3,1,1,0,18,2,0,-2,-115,-4,0,-2,4,1,133,6,0,0
"6091","20",209,7,4,1,3,123,-5,2,2,-106,44,2,1,4,-3,229,-49,0,1
"6092","20",84,8,4,1,3,203,2,3,3,171,-1,1,3,4,-4,32,3,2,0
"6093","20",238,4,3,1,1,113,-89,-2,-1,1,-1,-2,-3,4,0,112,-88,0,2
"6094","20",125,3,4,1,0,-200,4,-4,-2,-181,-30,-3,-1,4,1,-19,34,-1,-1
"6095","20",73,4,4,1,2,-34,19,-1,-1,-81,-63,0,0,4,0,47,82,-1,-1
"6096","20",202,4,1,0,1,-124,49,-3,-1,-97,15,-3,-1,4,0,-27,34,0,0
"6097","20",147,6,2,1,3,136,-164,2,1,58,57,1,2,4,-2,78,-221,1,-1
"6098","20",90,4,4,1,0,-221,16,-1,-1,120,17,1,-1,4,0,-341,-1,-2,0
"6099","20",82,9,4,1,2,237,-92,4,4,57,78,4,3,4,-5,180,-170,0,1
"6100","20",203,9,4,1,3,-17,-232,4,4,-13,-48,4,4,4,-5,-4,-184,0,0
"6101","20",354,5,1,0,0,12,18,0,0,50,51,1,1,4,-1,-38,-33,-1,-1
"6102","20",83,6,1,1,3,135,-143,2,1,142,-125,2,1,4,-2,-7,-18,0,0
"6103","20",228,8,4,1,2,39,104,3,3,26,223,1,2,4,-4,13,-119,2,1
"6104","20",149,6,3,1,1,186,-7,-2,1,242,6,-3,1,4,-2,-56,-13,1,0
"6105","20",157,5,3,1,2,198,70,-2,0,91,50,-3,0,4,-1,107,20,1,0
"6106","20",153,5,1,0,3,-197,-30,3,0,-177,-125,1,1,4,-1,-20,95,2,-1
"6107","20",36,7,3,1,3,155,-180,3,2,167,-75,3,3,4,-3,-12,-105,0,-1
"6108","20",279,7,4,0,3,-75,-48,1,2,103,-31,3,2,4,-3,-178,-17,-2,0
"6109","20",222,2,1,0,0,0,0,-3,-3,-239,2,-3,-3,4,2,239,-2,0,0
"6110","20",239,7,1,0,1,-108,-25,1,2,125,-95,1,2,4,-3,-233,70,0,0
"6111","20",235,7,3,1,0,202,-4,2,2,236,-1,3,3,4,-3,-34,-3,-1,-1
"6112","20",74,6,3,1,0,80,-20,1,1,103,-62,2,1,4,-2,-23,42,-1,0
"6113","20",227,6,3,1,3,81,33,2,1,26,22,2,1,4,-2,55,11,0,0
"6114","20",127,1,1,0,0,-238,3,-4,-4,-2,1,-4,-4,4,3,-236,2,0,0
"6115","20",156,5,2,1,1,6,-2,0,0,-3,42,0,0,4,-1,9,-44,0,0
"6116","20",75,1,4,1,2,236,20,2,-4,207,67,0,-2,4,3,29,-47,2,-2
"6117","20",216,6,3,1,1,31,-1,1,1,116,16,0,-1,4,-2,-85,-17,1,2
"6118","20",246,6,4,1,3,219,1,4,1,55,-2,3,3,4,-2,164,3,1,-2
"6119","20",225,5,2,0,2,-6,87,0,0,-188,-69,0,0,4,-1,182,156,0,0
"6120","20",205,6,1,0,2,-9,1,0,1,4,-234,4,4,4,-2,-13,235,-4,-3
"6121","20",21,4,4,1,2,23,30,1,-1,92,45,4,-3,4,0,-69,-15,-3,2
"6122","20",85,1,2,0,2,-120,144,-3,-4,-94,-121,0,-1,4,3,-26,265,-3,-3
"6123","20",206,6,4,1,0,14,20,-1,1,241,245,4,4,4,-2,-227,-225,-5,-3
"6124","20",126,2,2,0,2,-223,-229,-3,-3,-216,-123,-3,-3,4,2,-7,-106,0,0
"6125","20",28,4,4,1,1,12,-40,-1,-1,6,-9,-1,-1,4,0,6,-31,0,0
"6126","20",86,6,4,1,3,130,-4,4,1,165,-8,2,3,4,-2,-35,4,2,-2
"6127","20",361,4,1,1,0,-1,-246,2,-1,-2,248,4,4,4,0,1,-494,-2,-5
"6128","20",91,4,2,0,3,-248,3,-1,-1,248,1,3,3,4,0,-496,2,-4,-4
"6129","20",280,5,2,0,1,97,101,1,0,-33,24,0,-1,4,-1,130,77,1,1
"6130","20",204,5,3,1,1,69,-41,1,0,102,-66,0,0,4,-1,-33,25,1,0
"6131","20",237,3,2,0,2,-236,48,-2,-2,86,-1,-1,0,4,1,-322,49,-1,-2
"6132","20",286,6,1,0,3,82,0,2,1,59,-4,1,1,4,-2,23,4,1,0
"6133","20",229,3,1,0,1,-164,-43,-2,-2,-197,-75,-2,-3,4,1,33,32,0,1
"6134","20",15,9,4,1,3,191,96,3,4,76,60,2,-1,4,-5,115,36,1,5
"6135","20",158,6,3,1,0,130,-115,-1,1,-165,-21,-2,-2,4,-2,295,-94,1,3
"6136","20",226,1,1,0,0,22,5,-1,-4,65,4,1,-3,4,3,-43,1,-2,-1
"6137","20",360,1,3,1,0,-48,-43,-1,-4,145,184,1,-4,4,3,-193,-227,-2,0
"6138","20",210,6,4,1,2,93,53,3,1,120,92,3,3,4,-2,-27,-39,0,-2
"6139","20",159,9,3,1,2,244,8,4,4,226,4,4,4,4,-5,18,4,0,0
"6140","20",207,6,1,1,0,64,-2,1,1,139,-2,0,0,4,-2,-75,0,1,1
"6141","20",236,5,1,0,1,-4,-10,0,0,-17,-18,0,0,4,-1,13,8,0,0
"6142","20",211,4,3,1,1,155,191,-4,-1,119,129,-1,-1,4,0,36,62,-3,0
"6143","20",16,2,1,1,0,-69,8,1,-3,137,-17,1,-2,4,2,-206,25,0,-1
"6144","20",128,7,1,0,3,154,-15,2,2,8,-101,1,1,4,-3,146,86,1,1
"6145","20",92,5,4,1,2,2,-2,0,0,-97,-84,-1,-1,4,-1,99,82,1,1
"6146","20",160,7,2,1,0,-137,147,-4,2,-194,213,-4,1,4,-3,57,-66,0,1
"6147","20",217,2,4,1,2,-91,25,-1,-3,-32,20,-1,-3,4,2,-59,5,0,0
"6148","20",93,6,1,0,1,-65,15,1,1,-89,20,-2,0,4,-2,24,-5,3,1
"6149","20",287,8,4,1,3,205,4,2,3,136,1,1,1,4,-4,69,3,1,2
"6150","20",23,8,1,1,3,206,206,3,3,227,203,4,4,4,-4,-21,3,-1,-1
"6151","20",98,6,3,1,0,-75,-191,1,1,-246,-8,-4,-4,4,-2,171,-183,5,5
"6152","20",94,3,4,1,1,86,-86,4,-2,110,-81,4,-2,4,1,-24,-5,0,0
"6153","20",288,4,2,0,2,-75,40,-2,-1,-126,59,-2,0,4,0,51,-19,0,-1
"6154","20",99,7,4,1,3,229,4,2,2,234,-30,3,3,4,-3,-5,34,-1,-1
"6155","20",130,9,1,0,3,208,27,4,4,118,45,4,4,4,-5,90,-18,0,0
"6156","20",95,1,4,1,2,-246,3,-4,-4,-238,-8,-4,-4,4,3,-8,11,0,0
"6157","20",208,5,4,1,2,-10,-5,0,0,-2,-1,0,0,4,-1,-8,-4,0,0
"6158","20",212,5,1,0,1,-177,-139,3,0,-185,-142,3,0,4,-1,8,3,0,0
"6159","20",281,1,4,1,2,-245,2,-4,-4,-248,-1,-4,-4,4,3,3,3,0,0
"6160","20",29,4,4,1,0,38,78,-1,-1,-182,154,-4,-4,4,0,220,-76,3,3
"6161","20",213,4,2,0,1,-54,1,-1,-1,120,2,1,1,4,0,-174,-1,-2,-2
"6162","20",282,9,3,1,3,-85,-41,0,4,179,33,0,4,4,-5,-264,-74,0,0
"6163","20",161,1,2,0,2,-249,168,-4,-4,57,50,0,-4,4,3,-306,118,-4,0
"6164","20",218,8,4,1,3,-72,-17,4,3,-104,-47,4,3,4,-4,32,30,0,0
"6165","20",214,9,1,1,3,127,-135,4,4,203,33,4,4,4,-5,-76,-168,0,0
"6166","20",283,6,1,0,1,-80,-90,-2,1,110,-132,-2,1,4,-2,-190,42,0,0
"6167","20",219,5,4,1,3,249,-1,4,0,-249,1,4,0,4,-1,498,-2,0,0
"6168","20",291,7,4,0,2,-177,240,1,2,115,72,1,2,4,-3,-292,168,0,0
"6169","20",215,2,1,1,0,115,25,-2,-3,89,23,-2,-3,4,2,26,2,0,0
"6170","20",289,7,1,1,3,127,-4,2,2,-190,-15,1,1,4,-3,317,11,1,1
"6171","20",131,8,4,1,3,129,-33,-1,3,69,-12,0,3,4,-4,60,-21,-1,0
"6172","20",292,5,3,0,1,88,-16,-2,0,-205,1,-2,-2,4,-1,293,-17,0,2
"6173","20",96,2,1,0,0,-238,-15,-3,-3,-225,7,-3,-3,4,2,-13,-22,0,0
"6174","20",129,5,4,1,1,194,4,0,0,188,-3,2,2,4,-1,6,7,-2,-2
"6175","20",293,1,4,1,0,-237,29,-4,-4,-210,12,-4,-4,4,3,-27,17,0,0
"6176","20",97,2,1,0,1,-203,22,2,-3,68,10,3,-1,4,2,-271,12,-1,-2
"6177","20",290,3,1,1,1,53,-61,1,-2,101,-82,0,-3,4,1,-48,21,1,1
"6178","20",13,3,4,1,1,97,-78,1,-2,33,-81,1,-2,4,1,64,3,0,0
"6179","20",284,2,3,1,1,147,68,-1,-3,-116,-64,-1,-4,4,2,263,132,0,1
"6180","20",162,8,3,1,3,143,138,-3,3,116,109,3,4,4,-4,27,29,-6,-1
"6181","20",230,6,1,1,0,-141,-16,-3,1,-213,-4,-3,0,4,-2,72,-12,0,1
"6182","20",295,5,1,0,1,-1,2,0,0,4,2,0,0,4,-1,-5,0,0,0
"6183","20",164,3,2,1,2,-65,0,-1,-2,-3,9,2,0,4,1,-62,-9,-3,-2
"6184","20",163,7,3,1,1,101,37,-1,2,139,39,1,2,4,-3,-38,-2,-2,0
"6185","20",231,3,4,1,0,-79,-75,0,-2,-1,3,-1,-2,4,1,-78,-78,1,0
"6186","20",296,6,1,0,3,23,6,1,1,-28,178,0,0,4,-2,51,-172,1,1
"6187","20",294,7,1,0,3,185,2,2,2,-1,0,2,2,4,-3,186,2,0,0
"6188","20",285,6,2,1,1,-43,-129,-2,1,-2,-151,-2,1,4,-2,-41,22,0,0
"6189","21",404,4,1,0,1,62,-47,0,-1,66,-70,1,0,6,2,-4,23,-1,-1
"6190","21",330,7,2,1,2,175,195,2,2,190,200,2,2,6,-1,-15,-5,0,0
"6191","21",111,1,1,0,0,-244,-237,-4,-4,-57,68,-1,0,6,5,-187,-305,-3,-4
"6192","21",333,6,4,1,1,95,-6,1,1,118,-112,1,1,6,0,-23,106,0,0
"6193","21",405,1,4,1,1,159,213,-4,-4,103,108,0,0,6,5,56,105,-4,-4
"6194","21",331,2,1,0,0,-42,64,-4,-3,44,57,-4,-3,6,4,-86,7,0,0
"6195","21",112,9,4,1,3,5,249,4,4,6,247,4,4,6,-3,-1,2,0,0
"6196","21",338,9,3,0,2,236,242,4,4,234,239,-4,-4,6,-3,2,3,8,8
"6197","21",406,7,2,1,2,217,183,0,2,193,173,-1,2,6,-1,24,10,1,0
"6198","21",332,5,1,0,0,-234,40,-2,0,40,12,1,3,6,1,-274,28,-3,-3
"6199","21",113,9,2,1,2,27,16,4,4,-130,-97,-2,-2,6,-3,157,113,6,6
"6200","21",388,4,4,1,0,63,249,-4,-1,242,-4,4,3,6,2,-179,253,-8,-4
"6201","21",401,2,2,1,1,51,12,-1,-3,-52,27,2,-1,6,4,103,-15,-3,-2
"6202","21",337,9,2,1,3,241,203,4,4,230,-13,4,4,6,-3,11,216,0,0
"6203","21",114,2,4,1,1,-237,-245,-2,-3,120,103,0,-3,6,4,-357,-348,-2,0
"6204","21",403,3,1,0,0,-34,-5,0,-2,74,-30,2,1,6,3,-108,25,-2,-3
"6205","21",407,7,2,0,2,225,10,-3,2,223,10,2,2,6,-1,2,0,-5,0
"6206","21",115,5,3,0,3,0,0,0,0,86,3,0,0,6,1,-86,-3,0,0
"6207","21",40,3,1,0,2,-140,56,-3,-2,202,100,4,1,6,3,-342,-44,-7,-3
"6208","21",335,4,2,1,1,-97,-7,-1,-1,-82,-23,-2,-1,6,2,-15,16,1,0
"6209","21",339,4,3,0,1,103,88,-1,-1,133,148,1,2,6,2,-30,-60,-2,-3
"6210","21",400,6,4,1,2,151,59,-1,1,110,31,2,2,6,0,41,28,-3,-1
"6211","21",56,4,3,1,1,28,-115,-3,-1,110,-123,-2,0,6,2,-82,8,-1,-1
"6212","21",336,2,4,1,3,190,198,3,-3,200,186,3,-3,6,4,-10,12,0,0
"6213","21",389,5,3,0,2,-166,-61,0,0,116,-73,0,0,6,1,-282,12,0,0
"6214","21",117,4,4,1,2,232,103,-4,-1,-133,-3,-2,-2,6,2,365,106,-2,1
"6215","21",474,1,1,0,0,13,-101,-4,-4,21,-125,-2,-4,6,5,-8,24,-2,0
"6216","21",393,1,1,0,0,-179,-208,-4,-4,179,-39,3,0,6,5,-358,-169,-7,-4
"6217","21",334,1,4,1,0,-249,239,-4,-4,114,-140,-4,-4,6,5,-363,379,0,0
"6218","21",402,1,3,0,0,-244,-2,-4,-4,-192,2,-2,-2,6,5,-52,-4,-2,-2
"6219","21",394,1,3,1,0,-249,247,-4,-4,-246,247,-4,-4,6,5,-3,0,0,0
"6220","21",390,9,2,1,2,233,237,4,4,-230,-91,-4,-4,6,-3,463,328,8,8
"6221","21",408,4,1,0,0,-84,-1,-2,-1,143,-3,1,2,6,2,-227,2,-3,-3
"6222","21",397,6,4,1,3,115,-11,1,1,85,117,1,1,6,0,30,-128,0,0
"6223","21",116,1,2,0,3,-96,-11,4,-4,102,-17,1,1,6,5,-198,6,3,-5
"6224","21",391,5,2,1,3,176,218,0,0,133,-115,0,0,6,1,43,333,0,0
"6225","21",473,3,3,1,0,-239,-13,-2,-2,-219,-19,0,-2,6,3,-20,6,-2,0
"6226","21",34,5,4,1,2,75,-77,1,0,58,-38,1,2,6,1,17,-39,0,-2
"6227","21",101,1,3,0,0,-235,236,-4,-4,184,197,-3,-3,6,5,-419,39,-1,-1
"6228","21",57,1,4,1,1,87,-64,-1,-4,73,-109,0,-4,6,5,14,45,-1,0
"6229","21",182,6,4,1,3,4,-97,-1,1,-214,3,-4,-4,6,0,218,-100,3,5
"6230","21",39,3,3,0,1,96,142,-1,-2,119,74,3,3,6,3,-23,68,-4,-5
"6231","21",118,6,3,0,1,-23,17,-1,1,80,28,-1,1,6,0,-103,-11,0,0
"6232","21",475,6,3,0,3,141,-153,1,1,61,-51,0,0,6,0,80,-102,1,1
"6233","21",366,9,4,1,3,127,-98,3,4,179,-124,3,4,6,-3,-52,26,0,0
"6234","21",55,5,4,1,1,4,-22,0,0,40,-19,1,0,6,1,-36,-3,-1,0
"6235","21",411,9,2,0,2,244,234,4,4,235,234,4,0,6,-3,9,0,0,4
"6236","21",172,6,2,1,3,140,176,-2,1,232,226,4,4,6,0,-92,-50,-6,-3
"6237","21",100,8,4,1,3,229,0,4,3,210,1,4,4,6,-2,19,-1,0,-1
"6238","21",409,5,4,1,2,177,191,3,0,131,90,2,2,6,1,46,101,1,-2
"6239","21",398,9,4,1,2,242,240,4,4,64,34,1,1,6,-3,178,206,3,3
"6240","21",178,5,1,0,1,-3,-1,0,0,-1,-3,0,0,6,1,-2,2,0,0
"6241","21",392,4,1,0,0,-101,-67,0,-1,112,39,1,1,6,2,-213,-106,-1,-2
"6242","21",41,6,2,1,3,55,81,3,1,16,68,3,1,6,0,39,13,0,0
"6243","21",340,4,1,0,1,-57,-28,0,-1,85,16,0,0,6,2,-142,-44,0,-1
"6244","21",102,8,4,0,3,-176,102,1,3,-127,148,3,3,6,-2,-49,-46,-2,0
"6245","21",410,1,1,0,0,-243,-154,-4,-4,5,4,1,-3,6,5,-248,-158,-5,-1
"6246","21",4,8,3,0,1,-244,5,0,3,42,133,0,2,6,-2,-286,-128,0,1
"6247","21",362,4,4,1,3,154,-126,2,-1,95,69,2,1,6,2,59,-195,0,-2
"6248","21",59,3,1,0,0,-118,141,-2,-2,74,-50,3,3,6,3,-192,191,-5,-5
"6249","21",108,9,2,1,3,235,214,4,4,142,170,4,4,6,-3,93,44,0,0
"6250","21",396,1,1,0,1,-240,196,4,-4,70,-81,-2,2,6,5,-310,277,6,-6
"6251","21",6,6,4,1,2,217,-1,1,1,-1,0,0,0,6,0,218,-1,1,1
"6252","21",181,9,4,1,3,190,213,3,4,166,95,1,0,6,-3,24,118,2,4
"6253","21",173,8,4,1,3,221,3,3,3,215,18,0,0,6,-2,6,-15,3,3
"6254","21",105,3,1,0,0,-214,25,-4,-2,223,37,-2,1,6,3,-437,-12,-2,-3
"6255","21",60,8,1,0,3,223,4,3,3,231,4,3,3,6,-2,-8,0,0,0
"6256","21",399,5,4,1,3,115,9,0,0,53,5,0,0,6,1,62,4,0,0
"6257","21",179,5,1,0,1,-4,-1,0,0,-4,-1,0,0,6,1,0,0,0,0
"6258","21",58,5,4,1,1,15,-249,0,0,3,242,4,4,6,1,12,-491,-4,-4
"6259","21",183,4,4,1,1,30,38,1,-1,48,23,1,-2,6,2,-18,15,0,1
"6260","21",395,8,3,0,1,204,35,3,3,181,75,-2,3,6,-2,23,-40,5,0
"6261","21",119,3,3,1,3,-218,97,-2,-2,152,201,3,3,6,3,-370,-104,-5,-5
"6262","21",476,2,3,0,0,89,-9,-3,-3,140,106,1,1,6,4,-51,-115,-4,-4
"6263","21",367,4,3,0,1,-143,-54,3,-1,-43,-51,2,-1,6,2,-100,-3,1,0
"6264","21",363,2,3,1,3,-250,2,-3,-3,249,0,3,3,6,4,-499,2,-6,-6
"6265","21",412,9,1,0,0,-249,145,-4,4,244,12,4,4,6,-3,-493,133,-8,0
"6266","21",109,2,1,0,1,-3,-200,1,-3,-2,-205,2,-3,6,4,-1,5,-1,0
"6267","21",261,8,1,1,3,202,177,4,3,224,230,4,4,6,-2,-22,-53,0,-1
"6268","21",254,3,2,1,3,182,226,-4,-2,154,-26,-1,-1,6,3,28,252,-3,-1
"6269","21",377,5,1,0,0,-243,7,-4,0,-36,14,-4,-4,6,1,-207,-7,0,4
"6270","21",174,6,4,1,3,134,89,0,1,111,151,0,0,6,0,23,-62,0,1
"6271","21",170,2,2,1,0,-183,-189,-3,-3,9,12,0,0,6,4,-192,-201,-3,-3
"6272","21",414,3,1,0,0,-135,-145,-2,-2,84,67,2,2,6,3,-219,-212,-4,-4
"6273","21",341,9,1,1,3,127,-12,4,4,233,-32,4,4,6,-3,-106,20,0,0
"6274","21",103,7,2,1,3,81,-1,1,2,5,6,1,1,6,-1,76,-7,0,1
"6275","21",415,7,2,1,2,171,221,0,2,172,199,0,1,6,-1,-1,22,0,1
"6276","21",189,3,1,0,1,-239,30,2,-2,-125,116,2,-2,6,3,-114,-86,0,0
"6277","21",104,1,1,0,0,-244,3,3,-4,240,3,2,-3,6,5,-484,0,1,-1
"6278","21",165,2,1,0,1,-161,-3,-3,-3,124,84,1,1,6,4,-285,-87,-4,-4
"6279","21",185,7,4,1,2,121,-16,0,2,75,-12,-2,1,6,-1,46,-4,2,1
"6280","21",368,1,3,0,3,150,-121,-4,-4,-103,176,4,4,6,5,253,-297,-8,-8
"6281","21",364,5,3,0,1,64,-2,0,0,-106,-4,-1,-1,6,1,170,2,1,1
"6282","21",413,1,1,0,1,-242,-8,0,-4,-21,0,-1,-2,6,5,-221,-8,1,-2
"6283","21",11,7,4,1,1,190,220,0,2,208,209,4,4,6,-1,-18,11,-4,-2
"6284","21",106,4,2,1,1,-199,-214,-1,-1,-210,-111,-2,-2,6,2,11,-103,1,1
"6285","21",61,2,1,0,3,-249,30,4,-3,192,-8,4,-3,6,4,-441,38,0,0
"6286","21",110,2,1,0,1,-96,91,-3,-3,167,138,3,3,6,4,-263,-47,-6,-6
"6287","21",18,4,3,0,1,-92,-28,0,-1,125,24,1,0,6,2,-217,-52,-1,-1
"6288","21",62,9,2,1,3,229,212,4,4,215,212,4,4,6,-3,14,0,0,0
"6289","21",184,6,3,0,3,93,4,1,1,85,3,1,1,6,0,8,1,0,0
"6290","21",180,5,2,1,2,-82,-1,0,0,-95,-1,-3,-2,6,1,13,0,3,2
"6291","21",12,9,4,1,3,-2,-3,4,4,-1,-2,4,4,6,-3,-1,-1,0,0
"6292","21",416,1,4,1,0,-246,242,-4,-4,-152,-131,-4,-4,6,5,-94,373,0,0
"6293","21",19,8,2,1,2,86,59,1,3,114,-39,1,2,6,-2,-28,98,0,1
"6294","21",266,5,1,0,1,-3,0,0,0,68,1,1,1,6,1,-71,-1,-1,-1
"6295","21",166,1,4,1,2,223,213,-4,-4,133,105,-2,4,6,5,90,108,-2,-8
"6296","21",186,5,2,1,2,219,217,1,0,18,9,0,0,6,1,201,208,1,0
"6297","21",262,6,4,1,3,79,94,1,1,57,61,1,1,6,0,22,33,0,0
"6298","21",255,3,3,0,1,-111,-141,-2,-2,179,99,2,2,6,3,-290,-240,-4,-4
"6299","21",378,1,4,1,1,124,-2,-4,-4,131,17,2,2,6,5,-7,-19,-6,-6
"6300","21",175,7,4,0,1,-76,153,1,2,111,110,1,0,6,-1,-187,43,0,2
"6301","21",171,5,1,0,1,27,3,0,0,7,22,0,0,6,1,20,-19,0,0
"6302","21",471,5,3,0,2,10,8,1,0,117,-107,-4,1,6,1,-107,115,5,-1
"6303","21",342,3,3,0,1,-204,15,-1,-2,11,-116,1,-1,6,3,-215,131,-2,-1
"6304","21",265,4,1,1,3,-236,-29,-3,-1,3,2,0,0,6,2,-239,-31,-3,-1
"6305","21",63,5,4,1,1,247,0,0,0,1,0,0,0,6,1,246,0,0,0
"6306","21",38,9,4,1,3,208,-5,4,4,173,-51,4,4,6,-3,35,46,0,0
"6307","21",376,3,4,1,1,-34,-112,-2,-2,36,-95,-2,-2,6,3,-70,-17,0,0
"6308","21",258,1,3,1,0,-82,6,-3,-4,30,2,2,-2,6,5,-112,4,-5,-2
"6309","21",417,8,2,1,2,132,84,2,3,-1,1,0,0,6,-2,133,83,2,3
"6310","21",369,4,4,0,0,-27,1,0,-1,114,-2,2,2,6,2,-141,3,-2,-3
"6311","21",365,5,3,0,1,27,4,0,0,144,0,0,0,6,1,-117,4,0,0
"6312","21",418,4,2,1,2,237,-26,2,-1,170,71,-1,-1,6,2,67,-97,3,0
"6313","21",191,3,1,0,0,-189,23,-2,-2,115,33,1,1,6,3,-304,-10,-3,-3
"6314","21",107,8,2,1,3,-96,37,1,3,137,-113,3,-1,6,-2,-233,150,-2,4
"6315","21",168,7,1,1,3,95,-103,1,2,130,-77,2,2,6,-1,-35,-26,-1,0
"6316","21",192,3,4,1,1,0,-85,-2,-2,121,-2,1,2,6,3,-121,-83,-3,-4
"6317","21",375,4,3,0,1,-48,1,-1,-1,-1,2,0,0,6,2,-47,-1,-1,-1
"6318","21",257,1,1,0,0,-205,33,2,-4,109,106,1,-4,6,5,-314,-73,1,0
"6319","21",472,1,1,0,0,-244,15,-4,-4,-62,11,-4,-4,6,5,-182,4,0,0
"6320","21",343,7,2,1,2,73,6,2,2,-71,2,-1,-1,6,-1,144,4,3,3
"6321","21",120,4,3,0,1,-80,-69,-1,-1,-79,-141,-1,-1,6,2,-1,72,0,0
"6322","21",64,1,1,0,1,-235,227,-4,-4,211,-201,3,3,6,5,-446,428,-7,-7
"6323","21",190,5,4,1,3,164,215,1,0,142,123,3,3,6,1,22,92,-2,-3
"6324","21",267,5,3,0,1,-49,-3,0,0,177,32,2,1,6,1,-226,-35,-2,-1
"6325","21",167,6,1,0,3,92,47,1,1,-220,-120,-2,-2,6,0,312,167,3,3
"6326","21",187,9,4,1,2,234,1,3,4,115,12,1,2,6,-3,119,-11,2,2
"6327","21",263,3,4,1,0,-185,-1,-3,-2,0,-3,-1,-1,6,3,-185,2,-2,-1
"6328","21",256,5,3,0,1,-125,0,0,0,123,94,1,1,6,1,-248,-94,-1,-1
"6329","21",379,5,3,0,1,-82,-34,2,0,232,111,3,1,6,1,-314,-145,-1,-1
"6330","21",176,9,1,0,1,-239,74,-4,4,184,62,1,2,6,-3,-423,12,-5,2
"6331","21",1,7,1,0,1,93,77,1,2,135,122,1,2,6,-1,-42,-45,0,0
"6332","21",169,1,3,0,0,-231,226,-4,-4,129,117,-4,-4,6,5,-360,109,0,0
"6333","21",193,2,1,0,0,-195,-203,-4,-3,114,51,2,0,6,4,-309,-254,-6,-3
"6334","21",27,5,2,0,2,-153,87,2,0,109,210,2,0,6,1,-262,-123,0,0
"6335","21",49,5,4,1,1,7,26,1,0,54,65,2,2,6,1,-47,-39,-1,-2
"6336","21",380,1,4,1,1,-144,-26,3,-4,123,-37,3,-4,6,5,-267,11,0,0
"6337","21",158,2,3,0,0,-233,-13,-3,-3,238,-239,-2,1,6,4,-471,226,-1,-4
"6338","21",259,1,3,0,1,-161,53,4,-4,143,46,3,-3,6,5,-304,7,1,-1
"6339","21",421,8,3,0,1,-189,-76,-2,3,101,100,-1,-1,6,-2,-290,-176,-1,4
"6340","21",37,2,1,0,0,-132,-53,-2,-3,-1,-47,-2,-3,6,4,-131,-6,0,0
"6341","21",147,6,2,0,3,-88,98,-2,1,-154,165,-1,1,6,0,66,-67,-1,0
"6342","21",419,5,4,1,3,164,112,0,0,226,151,2,2,6,1,-62,-39,-2,-2
"6343","21",387,3,3,1,1,22,48,-1,-2,57,58,2,1,6,3,-35,-10,-3,-3
"6344","21",269,6,4,1,2,232,96,0,1,249,86,-1,-1,6,0,-17,10,1,2
"6345","21",48,1,3,0,0,0,0,-4,-4,95,-89,-4,-4,6,5,-95,89,0,0
"6346","21",431,2,3,0,0,-207,95,-3,-3,179,158,-1,0,6,4,-386,-63,-2,-3
"6347","21",428,1,1,0,0,-239,241,-4,-4,195,163,3,-3,6,5,-434,78,-7,-1
"6348","21",424,4,2,1,2,54,13,-1,-1,29,0,1,-2,6,2,25,13,-2,1
"6349","21",420,6,4,1,3,1,1,0,1,-4,-60,1,2,6,0,5,61,-1,-1
"6350","21",344,5,4,1,3,223,-25,2,0,209,-28,2,1,6,1,14,3,0,-1
"6351","21",121,1,1,0,0,-208,-1,-4,-4,245,-73,-1,-4,6,5,-453,72,-3,0
"6352","21",65,8,1,0,3,-48,82,-1,3,90,98,1,2,6,-2,-138,-16,-2,1
"6353","21",386,1,1,0,0,-245,-250,-4,-4,59,38,1,0,6,5,-304,-288,-5,-4
"6354","21",268,7,4,1,3,159,75,3,2,141,106,4,4,6,-1,18,-31,-1,-2
"6355","21",143,6,1,0,3,210,18,1,1,185,0,3,3,6,0,25,18,-2,-2
"6356","21",188,9,2,1,3,219,-1,4,4,235,-4,3,4,6,-3,-16,3,1,0
"6357","21",264,6,4,1,2,247,113,1,1,-2,8,-2,-4,6,0,249,105,3,5
"6358","21",260,3,3,1,0,-195,-200,-3,-2,25,24,-1,1,6,3,-220,-224,-2,-3
"6359","21",42,2,3,0,1,-9,-37,2,-3,5,15,2,-2,6,4,-14,-52,0,-1
"6360","21",177,1,4,1,1,83,169,-4,-4,-112,83,-4,-4,6,5,195,86,0,0
"6361","21",10,3,3,1,1,-162,-1,-2,-2,-215,-3,0,-3,6,3,53,2,-2,1
"6362","21",17,1,3,0,0,-203,2,-3,-4,111,79,-1,-4,6,5,-314,-77,-2,0
"6363","21",194,8,1,0,0,-166,36,-4,3,218,22,-3,3,6,-2,-384,14,-1,0
"6364","21",270,5,3,0,1,3,4,0,0,-8,98,2,1,6,1,11,-94,-2,-1
"6365","21",5,2,2,0,2,-235,211,-2,-3,-231,142,-2,-3,6,4,-4,69,0,0
"6366","21",381,6,2,1,2,57,55,1,1,228,228,4,4,6,0,-171,-173,-3,-3
"6367","21",159,1,3,0,2,-248,10,-4,-4,241,2,4,4,6,5,-489,8,-8,-8
"6368","21",26,1,1,0,0,-221,218,-4,-4,43,39,-2,-3,6,5,-264,179,-2,-1
"6369","21",422,6,3,0,1,-74,-246,4,1,-107,-234,4,-4,6,0,33,-12,0,5
"6370","21",370,1,1,0,3,-237,-17,-4,-4,241,-8,0,-4,6,5,-478,-9,-4,0
"6371","21",148,2,1,0,1,-246,-96,0,-3,-72,64,1,-2,6,4,-174,-160,-1,-1
"6372","21",144,3,3,0,0,-19,-232,-1,-2,250,248,3,1,6,3,-269,-480,-4,-3
"6373","21",464,6,1,0,1,-17,105,1,1,119,20,1,1,6,0,-136,85,0,0
"6374","21",460,3,1,0,0,-193,-45,-4,-2,205,77,-2,3,6,3,-398,-122,-2,-5
"6375","21",52,2,3,0,0,-236,1,-2,-3,170,5,2,-1,6,4,-406,-4,-4,-2
"6376","21",432,4,2,1,1,98,113,-2,-1,38,-42,0,0,6,2,60,155,-2,-1
"6377","21",429,1,2,1,0,115,17,-2,-4,8,5,0,-4,6,5,107,12,-2,0
"6378","21",425,8,4,1,2,83,154,2,3,-9,82,2,2,6,-2,92,72,0,1
"6379","21",373,5,3,0,0,232,213,3,0,220,211,4,1,6,1,12,2,-1,-1
"6380","21",345,1,1,0,0,-245,245,-4,-4,-4,-114,-2,-3,6,5,-241,359,-2,-1
"6381","21",122,1,1,0,0,-200,-221,-4,-4,-235,-241,-4,-4,6,5,35,20,0,0
"6382","21",66,1,1,1,1,-71,2,-1,-4,83,2,-2,0,6,5,-154,0,1,-4
"6383","21",196,1,3,0,0,-240,-1,-4,-4,48,77,1,1,6,5,-288,-78,-5,-5
"6384","21",272,7,4,1,2,142,111,2,2,147,71,0,1,6,-1,-5,40,2,1
"6385","21",51,7,4,1,1,-187,103,0,2,108,88,-1,-1,6,-1,-295,15,1,3
"6386","21",383,5,4,1,1,1,2,0,0,5,1,0,0,6,1,-4,1,0,0
"6387","21",160,7,2,1,0,135,-26,-4,2,-159,67,-4,2,6,-1,294,-93,0,0
"6388","21",157,1,3,1,2,-24,-232,-4,-4,71,56,-2,0,6,5,-95,-288,-2,-4
"6389","21",351,1,1,0,0,-244,-244,-4,-4,132,119,-4,-4,6,5,-376,-363,0,0
"6390","21",372,5,3,0,0,3,-243,-4,0,221,239,4,2,6,1,-218,-482,-8,-2
"6391","21",15,3,4,1,3,-75,33,-1,-2,-41,39,-1,-2,6,3,-34,-6,0,0
"6392","21",47,8,4,1,3,219,-8,2,3,174,3,3,2,6,-2,45,-11,-1,1
"6393","21",195,1,1,0,1,-250,249,4,-4,15,-19,2,0,6,5,-265,268,2,-4
"6394","21",271,3,3,0,1,-230,-1,-2,-2,220,-1,4,4,6,3,-450,0,-6,-6
"6395","21",50,3,2,1,1,155,0,2,-2,72,2,1,-2,6,3,83,-2,1,0
"6396","21",382,5,4,1,2,110,-7,0,0,81,-10,1,1,6,1,29,3,-1,-1
"6397","21",16,1,1,0,0,-243,239,-4,-4,112,-8,2,0,6,5,-355,247,-6,-4
"6398","21",156,4,2,1,1,-118,17,-1,-1,57,3,1,1,6,2,-175,14,-2,-2
"6399","21",423,4,1,1,3,-51,-35,2,-1,148,-12,1,0,6,2,-199,-23,1,-1
"6400","21",371,1,3,0,0,-214,-198,-4,-4,106,-195,-1,1,6,5,-320,-3,-3,-5
"6401","21",149,5,3,0,1,-200,-16,-4,0,249,6,-3,1,6,1,-449,-22,-1,-1
"6402","21",145,6,1,0,1,189,0,2,1,-45,-116,1,2,6,0,234,116,1,-1
"6403","21",465,5,4,0,3,207,22,3,0,37,-234,3,3,6,1,170,256,0,-3
"6404","21",461,3,4,1,2,87,37,-1,-2,90,30,1,1,6,3,-3,7,-2,-3
"6405","21",53,7,4,1,3,188,5,2,2,208,0,2,2,6,-1,-20,5,0,0
"6406","21",433,1,1,0,0,-183,-211,-4,-4,171,171,3,-3,6,5,-354,-382,-7,-1
"6407","21",43,2,3,0,0,-69,-2,-3,-3,121,3,-1,-3,6,4,-190,-5,-2,0
"6408","21",426,9,4,1,3,-13,-224,4,4,238,-5,4,2,6,-3,-251,-219,0,2
"6409","21",374,8,4,1,2,216,16,3,3,146,12,2,2,6,-2,70,4,1,1
"6410","21",346,8,3,0,0,-245,1,0,3,241,91,1,3,6,-2,-486,-90,-1,0
"6411","21",123,6,4,1,2,82,26,-2,1,-54,21,-2,-2,6,0,136,5,0,3
"6412","21",67,2,1,1,0,-22,8,-3,-3,161,-171,2,2,6,4,-183,179,-5,-5
"6413","21",197,4,4,1,3,-54,-14,4,-1,-177,-24,2,-2,6,2,123,10,2,1
"6414","21",273,4,1,0,0,-166,4,-1,-1,215,227,4,3,6,2,-381,-223,-5,-4
"6415","21",318,9,2,1,2,188,178,-4,4,187,-181,-4,0,6,-3,1,359,0,4
"6416","21",384,3,1,0,0,-56,0,-2,-2,0,1,0,0,6,3,-56,-1,-2,-2
"6417","21",161,2,2,1,2,111,175,-1,-3,34,38,0,-3,6,4,77,137,-1,0
"6418","21",457,1,3,1,1,-84,-28,-4,-4,4,-219,2,3,6,5,-88,191,-6,-7
"6419","21",352,4,2,0,1,-30,-28,0,-1,7,-185,0,-1,6,2,-37,157,0,0
"6420","21",45,1,3,0,0,-198,225,-4,-4,160,153,-2,1,6,5,-358,72,-2,-5
"6421","21",150,5,3,0,1,1,-2,0,0,165,-1,1,1,6,1,-164,-1,-1,-1
"6422","21",470,4,1,0,1,-93,32,-1,-1,34,58,1,1,6,2,-127,-26,-2,-2
"6423","21",467,5,1,0,3,163,132,3,0,144,191,4,0,6,1,19,-59,-1,0
"6424","21",463,8,4,1,3,-245,-2,-3,3,2,-225,3,-2,6,-2,-247,223,-6,5
"6425","21",320,7,2,1,2,124,101,1,2,-179,98,-1,0,6,-1,303,3,2,2
"6426","21",435,4,4,1,1,-117,-30,-1,-1,-65,24,0,0,6,2,-52,-54,-1,-1
"6427","21",359,9,4,1,3,235,12,4,4,232,13,4,4,6,-3,3,-1,0,0
"6428","21",355,4,2,1,2,146,150,-2,-1,-192,143,0,-3,6,2,338,7,-2,2
"6429","21",456,1,1,0,0,-179,-167,-2,-4,152,190,2,-1,6,5,-331,-357,-4,-3
"6430","21",348,3,3,0,1,-119,-3,0,-2,156,132,0,-1,6,3,-275,-135,0,-1
"6431","21",125,2,4,1,0,-52,-40,-3,-3,243,-246,-4,-2,6,4,-295,206,1,-1
"6432","21",146,2,2,0,0,-130,-143,-3,-3,-162,-117,-3,-3,6,4,32,-26,0,0
"6433","21",466,4,3,0,0,-119,-76,-1,-1,81,-109,3,3,6,2,-200,33,-4,-4
"6434","21",462,9,3,0,3,0,242,4,4,222,226,-4,-4,6,-3,-222,16,8,8
"6435","21",54,5,4,1,1,-200,-8,0,0,140,72,0,0,6,1,-340,-80,0,0
"6436","21",434,6,4,1,3,73,-21,3,1,140,-10,2,1,6,0,-67,-11,1,0
"6437","21",430,3,2,1,1,167,-164,2,-2,81,-38,1,1,6,3,86,-126,1,-3
"6438","21",427,4,4,1,1,229,100,1,-1,-177,-47,2,-2,6,2,406,147,-1,1
"6439","21",455,7,2,1,2,151,6,3,2,-1,223,3,3,6,-1,152,-217,0,-1
"6440","21",347,5,1,0,3,-146,111,-4,0,113,142,2,3,6,1,-259,-31,-6,-3
"6441","21",124,5,1,0,3,241,4,3,0,250,24,3,2,6,1,-9,-20,0,-2
"6442","21",68,2,4,1,0,90,3,0,-3,231,1,3,0,6,4,-141,2,-3,-3
"6443","21",198,4,1,0,1,-55,-59,-1,-1,-108,62,0,-1,6,2,53,-121,-1,0
"6444","21",274,7,4,1,2,99,77,2,2,53,39,2,2,6,-1,46,38,0,0
"6445","21",319,2,1,0,1,-231,0,3,-3,57,98,2,1,6,4,-288,-98,1,-4
"6446","21",385,6,4,1,1,38,10,1,1,56,53,1,1,6,0,-18,-43,0,0
"6447","21",162,9,3,0,3,68,66,2,4,195,198,4,4,6,-3,-127,-132,-2,0
"6448","21",458,2,1,0,1,-31,-25,-1,-3,88,88,-1,-2,6,4,-119,-113,0,-1
"6449","21",353,1,2,1,2,229,240,-4,-4,239,95,3,-2,6,5,-10,145,-7,-2
"6450","21",450,3,4,1,3,242,1,2,-2,0,234,3,-2,6,3,242,-233,-1,0
"6451","21",151,1,2,1,1,65,8,0,-4,-218,11,0,-4,6,5,283,-3,0,0
"6452","21",329,9,4,1,3,-77,38,-4,4,129,68,2,3,6,-3,-206,-30,-6,1
"6453","21",468,6,1,0,3,150,49,2,1,46,47,1,1,6,0,104,2,1,0
"6454","21",321,1,1,1,0,-187,-186,-4,-4,96,112,0,0,6,5,-283,-298,-4,-4
"6455","21",249,1,3,1,0,-208,-179,-3,-4,148,-39,4,-2,6,5,-356,-140,-7,-2
"6456","21",436,1,4,0,3,62,-43,-2,-4,106,-134,2,-2,6,5,-44,91,-4,-2
"6457","21",36,3,3,0,3,-90,203,2,-2,142,168,2,2,6,3,-232,35,0,-4
"6458","21",356,4,4,1,1,-9,-2,0,-1,43,66,1,1,6,2,-52,-68,-1,-2
"6459","21",310,7,4,1,2,181,1,3,2,76,-3,2,2,6,-1,105,4,1,0
"6460","21",349,5,4,1,1,54,-80,1,0,-186,-159,-2,-3,6,1,240,79,3,3
"6461","21",126,2,2,1,2,36,95,-1,-3,-219,-213,-3,-3,6,4,255,308,2,0
"6462","21",446,5,4,1,1,162,132,0,0,171,195,-2,0,6,1,-9,-63,2,0
"6463","21",442,6,4,1,1,24,29,0,1,25,26,1,1,6,0,-1,3,-1,0
"6464","21",439,3,2,1,1,4,2,-2,-2,1,2,-1,-2,6,3,3,0,-1,0
"6465","21",223,5,1,0,1,-157,-1,-1,0,165,0,-1,0,6,1,-322,-1,0,0
"6466","21",244,8,4,1,2,201,194,3,3,208,216,3,3,6,-2,-7,-22,0,0
"6467","21",164,8,2,1,2,191,3,3,3,30,-1,1,1,6,-2,161,4,2,2
"6468","21",46,9,1,0,0,-104,-240,-4,4,225,232,0,-3,6,-3,-329,-472,-4,7
"6469","21",132,3,4,1,1,56,28,-1,-2,-2,149,1,2,6,3,58,-121,-2,-4
"6470","21",452,4,3,1,1,-76,3,-1,-1,2,5,1,0,6,2,-78,-2,-2,-1
"6471","21",153,7,1,0,3,-74,81,2,2,-72,-84,1,0,6,-1,-2,165,1,2
"6472","21",69,7,4,1,1,20,59,1,2,38,-40,-1,-3,6,-1,-18,99,2,5
"6473","21",199,7,4,1,2,198,122,2,2,201,50,1,1,6,-1,-3,72,1,1
"6474","21",275,8,4,1,2,-4,240,3,3,-228,6,0,0,6,-2,224,234,3,3
"6475","21",32,4,1,0,1,191,-137,2,-1,160,-176,2,-2,6,2,31,39,0,1
"6476","21",243,4,2,1,2,249,40,-2,-1,243,192,-2,-1,6,2,6,-152,0,0
"6477","21",163,5,3,1,1,-73,16,2,0,133,-3,1,3,6,1,-206,19,1,-3
"6478","21",459,1,3,0,1,-16,-179,3,-4,48,-57,1,-2,6,5,-64,-122,2,-2
"6479","21",354,3,1,0,0,-203,120,1,-2,229,235,4,4,6,3,-432,-115,-3,-6
"6480","21",451,1,1,0,0,-232,-198,-4,-4,-178,-187,-2,-2,6,5,-54,-11,-2,-2
"6481","21",152,3,1,0,0,1,-3,0,-2,0,-3,0,-2,6,3,1,0,0,0
"6482","21",33,5,3,0,1,58,73,0,0,164,-56,-2,1,6,1,-106,129,2,-1
"6483","21",469,2,4,1,0,131,82,-4,-3,107,82,-3,-4,6,4,24,0,-1,1
"6484","21",322,4,4,1,3,-25,31,-1,-1,237,-227,4,4,6,2,-262,258,-5,-5
"6485","21",25,5,4,1,2,19,34,0,0,30,42,0,0,6,1,-11,-8,0,0
"6486","21",437,3,1,0,0,-187,1,-2,-2,-196,-1,-2,-2,6,3,9,2,0,0
"6487","21",360,1,3,0,0,-164,-116,0,-4,220,219,2,-4,6,5,-384,-335,-2,0
"6488","21",357,6,4,1,2,68,-12,1,1,213,208,2,2,6,0,-145,-220,-1,-1
"6489","21",311,1,2,1,2,208,4,4,-4,181,9,4,-4,6,5,27,-5,0,0
"6490","21",35,3,1,0,3,110,195,4,-2,200,202,4,-2,6,3,-90,-7,0,0
"6491","21",127,1,1,0,0,-235,-2,-4,-4,204,195,0,0,6,5,-439,-197,-4,-4
"6492","21",447,5,4,1,2,63,150,2,0,-61,0,-2,-2,6,1,124,150,4,2
"6493","21",443,1,1,0,0,-168,-151,-4,-4,96,96,1,1,6,5,-264,-247,-5,-5
"6494","21",44,1,2,1,2,198,200,-1,-4,231,239,0,-4,6,5,-33,-39,-1,0
"6495","21",224,7,2,1,2,175,111,2,2,171,70,2,1,6,-1,4,41,0,1
"6496","21",245,1,1,0,0,-124,106,-4,-4,79,-10,-2,-3,6,5,-203,116,-2,-1
"6497","21",241,5,4,1,2,206,215,3,0,194,170,2,0,6,1,12,45,1,0
"6498","21",314,1,4,1,1,-244,10,4,-4,-239,7,4,-4,6,5,-5,3,0,0
"6499","21",133,3,2,1,1,-198,-32,0,-2,194,17,2,-1,6,3,-392,-49,-2,-1
"6500","21",453,8,4,1,2,204,-5,3,3,198,6,3,3,6,-2,6,-11,0,0
"6501","21",154,5,4,0,3,-19,23,0,0,44,107,0,0,6,1,-63,-84,0,0
"6502","21",7,4,1,0,3,149,13,2,-1,25,63,-2,1,6,2,124,-50,4,-2
"6503","21",2,7,4,1,1,-9,-54,0,2,-68,-76,-1,0,6,-1,59,22,1,2
"6504","21",276,8,4,1,3,202,-3,2,3,136,-2,2,2,6,-2,66,-1,0,1
"6505","21",251,4,3,0,1,-35,-198,-1,-1,-4,-200,0,-1,6,2,-31,2,-1,0
"6506","21",22,5,3,0,1,6,-6,0,0,237,-16,1,1,6,1,-231,10,-1,-1
"6507","21",87,7,4,1,3,13,7,2,2,185,24,2,0,6,-1,-172,-17,0,2
"6508","21",136,1,1,0,0,-230,245,-4,-4,213,-215,-3,-2,6,5,-443,460,-1,-2
"6509","21",313,1,3,0,0,-247,-242,-4,-4,233,231,4,4,6,5,-480,-473,-8,-8
"6510","21",209,9,4,1,3,83,-15,4,4,-4,200,1,1,6,-3,87,-215,3,3
"6511","21",129,2,4,1,1,-227,0,-3,-3,-216,-1,-3,-3,6,4,-11,1,0,0
"6512","21",449,6,4,1,3,84,135,2,1,12,86,2,1,6,0,72,49,0,0
"6513","21",327,6,4,1,3,100,116,2,1,111,19,1,0,6,0,-11,97,1,1
"6514","21",323,1,4,1,1,223,-1,0,-4,238,-1,4,-4,6,5,-15,0,-4,0
"6515","21",250,6,1,0,3,82,22,1,1,46,30,1,1,6,0,36,-8,0,0
"6516","21",438,7,4,1,3,248,4,4,2,70,6,4,1,6,-1,178,-2,0,1
"6517","21",361,1,1,0,0,-248,-1,0,-4,247,5,4,4,6,5,-495,-6,-4,-8
"6518","21",358,1,4,1,2,246,241,0,-4,183,182,0,-4,6,5,63,59,0,0
"6519","21",312,5,4,1,1,-49,123,0,0,-123,-77,0,-2,6,1,74,200,0,2
"6520","21",350,5,4,1,1,248,6,3,0,-246,5,0,0,6,1,494,1,3,0
"6521","21",128,5,1,0,3,-32,8,0,0,169,-193,4,-1,6,1,-201,201,-4,1
"6522","21",448,9,2,0,2,1,73,4,4,8,-27,1,2,6,-3,-7,100,3,2
"6523","21",444,5,2,1,2,-229,80,2,0,-236,67,-4,-4,6,1,7,13,6,4
"6524","21",440,4,3,0,0,-104,-35,0,-1,46,2,0,0,6,2,-150,-37,0,-1
"6525","21",225,1,2,0,2,-230,-25,-4,-4,14,244,4,4,6,5,-244,-269,-8,-8
"6526","21",246,8,4,1,3,237,-3,4,3,59,2,4,3,6,-2,178,-5,0,0
"6527","21",242,4,4,1,2,127,1,2,-1,30,0,1,-3,6,2,97,1,1,2
"6528","21",315,9,3,1,3,0,0,4,4,242,25,4,4,6,-3,-242,-25,0,0
"6529","21",134,5,2,1,2,87,4,2,0,-26,-11,0,0,6,1,113,15,2,0
"6530","21",454,7,4,1,3,192,0,2,2,192,0,2,2,6,-1,0,0,0,0
"6531","21",155,7,2,1,1,97,-31,-2,2,-10,-10,0,0,6,-1,107,-21,-2,2
"6532","21",70,7,2,1,2,241,240,4,2,82,110,1,-3,6,-1,159,130,3,5
"6533","21",20,3,3,0,0,-230,-230,-4,-2,-45,-26,-1,1,6,3,-185,-204,-3,-3
"6534","21",277,6,4,1,1,39,-102,4,1,-24,-83,3,-4,6,0,63,-19,1,5
"6535","21",252,5,4,1,1,-117,-75,-1,0,134,81,1,1,6,1,-251,-156,-2,-1
"6536","21",220,3,4,0,2,-207,104,4,-2,41,43,-4,-4,6,3,-248,61,8,2
"6537","21",88,9,4,1,2,223,-10,4,4,217,-224,4,4,6,-3,6,214,0,0
"6538","21",137,8,1,0,1,-221,-79,-3,3,140,69,3,3,6,-2,-361,-148,-6,0
"6539","21",217,2,4,1,2,54,32,1,-3,-29,24,-1,-3,6,4,83,8,2,0
"6540","21",21,4,4,1,2,76,83,2,-1,77,72,3,-2,6,2,-1,11,-1,1
"6541","21",13,3,4,1,1,5,-85,-2,-2,1,0,1,0,6,3,4,-85,-3,-2
"6542","21",98,1,3,0,0,-224,40,-4,-4,104,-159,1,1,6,5,-328,199,-5,-5
"6543","21",328,4,3,0,1,-40,8,-1,-1,21,11,1,1,6,2,-61,-3,-2,-2
"6544","21",324,1,2,1,0,72,-1,-4,-4,-97,-220,-2,-4,6,5,169,219,-2,0
"6545","21",227,5,3,0,3,-119,-30,2,0,155,71,2,-1,6,1,-274,-101,0,1
"6546","21",248,9,4,1,3,237,240,3,4,30,48,1,-2,6,-3,207,192,2,6
"6547","21",90,1,4,0,0,-239,2,-4,-4,0,7,0,0,6,5,-239,-5,-4,-4
"6548","21",317,5,4,1,2,23,-20,0,0,108,-108,2,2,6,1,-85,88,-2,-2
"6549","21",216,5,3,0,1,51,5,-1,0,5,0,-2,-1,6,1,46,5,1,1
"6550","21",31,6,1,1,0,78,-46,1,1,-95,-15,-2,-2,6,0,173,-31,3,3
"6551","21",233,8,2,1,2,212,75,3,3,-213,38,-3,0,6,-2,425,37,6,3
"6552","21",72,3,1,1,0,-228,33,-2,-2,134,154,2,2,6,3,-362,-121,-4,-4
"6553","21",445,6,4,1,3,104,-37,1,1,121,-99,1,1,6,0,-17,62,0,0
"6554","21",441,8,4,1,2,-1,-231,2,3,-4,-241,2,3,6,-2,3,10,0,0
"6555","21",226,1,1,0,0,-34,0,-1,-4,194,2,2,-3,6,5,-228,-2,-3,-1
"6556","21",247,3,3,0,0,-227,-4,-2,-2,182,-16,1,1,6,3,-409,12,-3,-3
"6557","21",9,4,4,0,2,-43,15,0,-1,226,-39,2,1,6,2,-269,54,-2,-2
"6558","21",316,5,3,0,0,-115,-106,0,0,-119,-129,0,0,6,1,4,23,0,0
"6559","21",135,5,1,0,1,-181,70,-3,0,182,-96,2,2,6,1,-363,166,-5,-2
"6560","21",309,3,4,1,2,177,174,-2,-2,54,-39,1,0,6,3,123,213,-3,-2
"6561","21",232,1,1,0,0,-239,-43,-4,-4,-158,-26,-1,-4,6,5,-81,-17,-3,0
"6562","21",71,4,3,0,1,-97,27,1,-1,21,24,-1,0,6,2,-118,3,2,-1
"6563","21",200,1,3,0,0,-221,13,-4,-4,240,99,-3,-3,6,5,-461,-86,-1,-1
"6564","21",278,1,4,1,1,213,227,4,-4,-237,-231,4,-4,6,5,450,458,0,0
"6565","21",253,9,3,0,3,-21,1,4,4,216,216,4,4,6,-3,-237,-215,0,0
"6566","21",221,1,4,1,1,-249,0,-4,-4,1,10,1,1,6,5,-250,-10,-5,-5
"6567","21",89,5,3,0,0,96,2,-4,0,-2,-54,-1,-3,6,1,98,56,-3,3
"6568","21",138,5,3,0,1,168,-10,0,0,145,-27,1,1,6,1,23,17,-1,-1
"6569","21",218,8,4,1,3,-1,-1,4,3,-46,-17,4,3,6,-2,45,16,0,0
"6570","21",210,8,4,1,2,173,124,3,3,100,-38,2,-4,6,-2,73,162,1,7
"6571","21",130,9,1,0,3,73,-60,4,4,62,-32,2,-3,6,-3,11,-28,2,7
"6572","21",99,8,4,1,3,0,0,3,3,221,-12,2,2,6,-2,-221,12,1,1
"6573","21",300,3,1,0,0,-118,23,-1,-2,23,27,1,2,6,3,-141,-4,-2,-4
"6574","21",325,9,1,0,1,-11,-12,0,4,207,196,4,4,6,-3,-218,-208,-4,0
"6575","21",228,9,4,1,2,106,92,4,4,104,105,2,2,6,-3,2,-13,2,2
"6576","21",95,6,4,1,2,142,4,1,1,-163,-1,-3,-3,6,0,305,5,4,4
"6577","21",91,5,2,0,3,206,1,1,0,-240,0,-2,0,6,1,446,1,3,0
"6578","21",140,3,1,0,1,-11,21,-1,-2,52,3,0,-1,6,3,-63,18,-1,-1
"6579","21",306,5,3,0,3,116,109,1,0,69,51,1,0,6,1,47,58,0,0
"6580","21",238,1,3,0,1,-154,99,1,-4,113,84,1,1,6,5,-267,15,0,-5
"6581","21",234,4,3,0,3,99,52,-1,-1,163,58,1,0,6,2,-64,-6,-2,-1
"6582","21",73,6,4,1,2,119,-123,-2,1,73,83,-3,1,6,0,46,-206,1,0
"6583","21",30,1,2,0,2,0,0,4,-4,-235,0,-3,-4,6,5,235,0,7,0
"6584","21",297,9,3,0,2,201,196,4,4,80,105,3,3,6,-3,121,91,1,1
"6585","21",139,9,4,1,2,237,-5,4,4,-249,3,0,-4,6,-3,486,-8,4,8
"6586","21",94,1,4,1,1,-141,-134,2,-4,220,-219,3,3,6,5,-361,85,-1,-7
"6587","21",211,3,3,0,1,-239,-238,-4,-2,95,127,-1,-2,6,3,-334,-365,-3,0
"6588","21",14,5,3,0,1,-5,1,0,0,226,-17,2,2,6,1,-231,18,-2,-2
"6589","21",305,9,4,1,3,248,35,4,4,218,109,4,4,6,-3,30,-74,0,0
"6590","21",212,4,1,1,1,101,44,0,-1,60,26,2,-1,6,2,41,18,-2,0
"6591","21",8,6,3,0,1,10,-8,0,1,241,-13,4,4,6,0,-231,5,-4,-3
"6592","21",229,2,1,0,1,-240,242,-3,-3,-109,55,-1,-1,6,4,-131,187,-2,-2
"6593","21",201,2,3,1,1,-17,-2,-1,-3,117,0,1,-2,6,4,-134,-2,-2,-1
"6594","21",279,7,4,1,3,161,135,2,2,124,-21,2,2,6,-1,37,156,0,0
"6595","21",23,1,1,1,3,202,184,4,-4,187,165,4,-4,6,5,15,19,0,0
"6596","21",222,2,1,0,0,-246,3,-4,-3,42,-4,0,0,6,4,-288,7,-4,-3
"6597","21",93,6,1,0,1,-187,71,-2,1,33,-31,-1,0,6,0,-220,102,-1,1
"6598","21",235,2,3,0,0,-244,-230,-4,-3,-244,2,-1,-1,6,4,0,-232,-3,-2
"6599","21",219,4,4,0,3,249,1,4,-1,249,3,4,-2,6,2,0,-2,0,1
"6600","21",203,9,4,0,3,-14,-249,4,4,-16,-235,4,4,6,-3,2,-14,0,0
"6601","21",131,8,4,1,3,162,-104,-2,3,64,-16,0,3,6,-2,98,-88,-2,0
"6602","21",236,5,1,0,1,9,-9,0,0,19,-22,0,0,6,1,-10,13,0,0
"6603","21",301,6,4,1,1,73,1,1,1,181,2,3,3,6,0,-108,-1,-2,-2
"6604","21",326,7,4,1,2,123,69,2,2,100,71,2,2,6,-1,23,-2,0,0
"6605","21",237,8,2,1,2,46,-1,-3,3,75,1,-2,1,6,-2,-29,-2,-1,2
"6606","21",96,3,1,0,0,-4,-5,-2,-2,5,-12,0,0,6,3,-9,7,-2,-2
"6607","21",92,5,4,1,2,3,2,0,0,-48,-57,-1,-1,6,1,51,59,1,1
"6608","21",141,1,1,0,0,-246,-8,-4,-4,176,15,2,2,6,5,-422,-23,-6,-6
"6609","21",307,9,4,1,2,249,211,4,4,160,231,1,1,6,-3,89,-20,3,3
"6610","21",239,1,1,0,1,-154,-128,-4,-4,213,214,-2,-1,6,5,-367,-342,-2,-3
"6611","21",28,4,4,1,1,-36,-7,-1,-1,135,125,-2,-2,6,2,-171,-132,1,1
"6612","21",74,1,3,0,0,-218,1,-4,-4,68,2,0,0,6,5,-286,-1,-4,-4
"6613","21",308,1,4,1,0,-233,-227,-4,-4,68,45,0,2,6,5,-301,-272,-4,-6
"6614","21",298,1,1,0,0,-245,14,-2,-4,225,25,1,2,6,5,-470,-11,-3,-6
"6615","21",280,6,2,1,1,-99,54,-1,1,-71,-107,0,0,6,0,-28,161,-1,1
"6616","21",75,1,4,1,2,228,25,4,-4,171,53,3,3,6,5,57,-28,1,-7
"6617","21",240,5,2,1,1,197,2,2,0,161,-16,2,-1,6,1,36,18,0,1
"6618","21",299,3,4,1,1,-177,-99,-1,-2,145,172,2,2,6,3,-322,-271,-3,-4
"6619","21",76,5,4,1,3,42,-3,0,0,12,1,1,1,6,1,30,-4,-1,-1
"6620","21",213,6,2,0,1,-74,3,0,1,94,2,-2,0,6,0,-168,1,2,1
"6621","21",80,7,4,0,3,231,0,4,2,237,1,3,3,6,-1,-6,-1,1,-1
"6622","21",84,7,4,1,3,193,2,2,2,190,0,2,2,6,-1,3,2,0,0
"6623","21",202,4,1,0,1,-13,40,3,-1,-43,83,2,1,6,2,30,-43,1,-2
"6624","21",214,9,1,0,3,103,27,1,4,115,148,1,4,6,-3,-12,-121,0,0
"6625","21",142,5,2,1,2,192,41,-1,0,-179,12,-4,-1,6,1,371,29,3,1
"6626","21",85,9,2,1,2,142,140,4,4,-111,-102,-2,-3,6,-3,253,242,6,7
"6627","21",24,9,2,1,2,244,-1,4,4,243,2,4,4,6,-3,1,-3,0,0
"6628","21",215,5,1,0,0,1,15,0,0,-172,36,-2,-3,6,1,173,-21,2,3
"6629","21",82,8,4,1,2,28,228,4,3,199,15,4,0,6,-2,-171,213,0,3
"6630","21",204,6,3,0,1,2,-62,0,1,190,-123,0,0,6,0,-188,61,0,1
"6631","21",208,5,4,0,2,-9,2,0,0,-7,1,0,0,6,1,-2,1,0,0
"6632","21",83,6,1,0,3,114,-111,2,1,122,-110,2,1,6,0,-8,-1,0,0
"6633","21",302,3,1,0,0,-142,-18,-3,-2,239,241,-4,-2,6,3,-381,-259,1,0
"6634","21",3,2,3,0,0,-190,182,-3,-3,245,-244,0,4,6,4,-435,426,-3,-7
"6635","21",282,9,3,0,3,180,-23,1,4,176,39,1,4,6,-3,4,-62,0,0
"6636","21",97,1,1,0,1,-243,-63,4,-4,203,222,0,2,6,5,-446,-285,4,-6
"6637","21",303,8,3,1,2,18,-43,2,3,-152,-131,-3,-2,6,-2,170,88,5,5
"6638","21",81,1,1,0,0,-246,86,-4,-4,38,63,1,-2,6,5,-284,23,-5,-2
"6639","21",283,6,1,0,1,-134,97,-3,1,147,94,-1,3,6,0,-281,3,-2,-2
"6640","21",304,3,2,0,2,-226,-13,4,-2,69,-29,1,1,6,3,-295,16,3,-3
"6641","21",207,5,1,0,0,-188,70,-4,0,-1,-248,4,4,6,1,-187,318,-8,-4
"6642","21",231,8,4,0,0,-213,-5,-4,3,-97,-42,-4,1,6,-2,-116,37,0,2
"6643","21",79,6,4,1,2,77,-18,1,1,-240,-18,-4,-4,6,0,317,0,5,5
"6644","21",292,5,3,0,1,46,4,0,0,-81,-2,-1,-1,6,1,127,6,1,1
"6645","21",281,9,4,1,2,248,2,4,4,249,2,4,-4,6,-3,-1,0,0,8
"6646","21",29,1,4,1,0,-208,242,-4,-4,229,139,-1,-1,6,5,-437,103,-3,-3
"6647","21",205,5,1,0,2,193,1,4,0,182,5,3,4,6,1,11,-4,1,-4
"6648","21",286,6,1,0,3,90,9,1,1,65,-2,1,1,6,0,25,11,0,0
"6649","21",77,4,3,0,1,-50,-2,-1,-1,-17,7,-1,-1,6,2,-33,-9,0,0
"6650","21",290,2,1,0,1,-177,-116,-3,-3,114,-84,1,-3,6,4,-291,-32,-4,0
"6651","21",230,6,1,0,0,-24,12,-3,1,211,23,-2,3,6,0,-235,-11,-1,-2
"6652","21",287,9,4,1,3,93,-8,4,4,149,-10,2,2,6,-3,-56,2,2,2
"6653","21",78,2,4,0,0,-159,-1,-3,-3,-154,-14,-2,-2,6,4,-5,13,-1,-1
"6654","21",291,8,4,1,2,149,113,2,3,-155,-182,-4,-4,6,-2,304,295,6,7
"6655","21",288,7,2,1,2,93,22,1,2,-112,1,-1,0,6,-1,205,21,2,2
"6656","21",86,7,4,1,3,170,-4,2,2,161,1,2,3,6,-1,9,-5,0,-1
"6657","21",284,2,3,0,1,110,127,-3,-3,104,93,0,-3,6,4,6,34,-3,0
"6658","21",289,1,1,1,3,-240,-21,-4,-4,168,165,2,0,6,5,-408,-186,-6,-4
"6659","21",285,7,2,0,1,-151,32,-4,2,102,-37,-2,0,6,-1,-253,69,-2,2
"6660","21",293,1,4,0,0,-140,32,-4,-4,-173,19,-4,-4,6,5,33,13,0,0
"6661","21",294,9,1,0,3,-127,1,-1,4,163,5,2,2,6,-3,-290,-4,-3,2
"6662","21",296,5,1,0,3,24,-18,0,0,154,30,0,0,6,1,-130,-48,0,0
"6663","21",206,2,4,1,0,-145,-76,-3,-3,222,226,2,4,6,4,-367,-302,-5,-7
"6664","21",295,5,1,0,1,-1,-2,0,0,-1,1,0,0,6,1,0,-3,0,0
"6665","22",401,5,2,1,1,71,12,-1,0,-91,8,1,-1,5,0,162,4,-2,1
"6666","22",398,9,4,1,2,250,248,4,4,189,190,3,3,5,-4,61,58,1,1
"6667","22",59,2,1,0,0,-160,200,-3,-3,110,-186,2,2,5,3,-270,386,-5,-5
"6668","22",407,8,2,1,2,187,20,3,3,231,15,2,2,5,-3,-44,5,1,1
"6669","22",399,6,4,1,3,121,9,1,1,123,19,1,1,5,-1,-2,-10,0,0
"6670","22",404,5,1,1,1,60,-56,-1,0,58,-49,1,0,5,0,2,-7,-2,0
"6671","22",397,7,4,1,3,91,-18,-3,2,110,-87,2,3,5,-2,-19,69,-5,-1
"6672","22",113,9,2,1,2,88,108,4,4,211,19,2,2,5,-4,-123,89,2,2
"6673","22",55,4,4,1,1,-12,-5,0,-1,57,6,0,0,5,1,-69,-11,0,-1
"6674","22",41,6,2,1,3,80,81,3,1,37,81,3,1,5,-1,43,0,0,0
"6675","22",413,1,1,1,1,-240,-1,-4,-4,133,2,1,1,5,4,-373,-3,-5,-5
"6676","22",58,1,4,1,1,-229,-2,-4,-4,-3,245,4,4,5,4,-226,-247,-8,-8
"6677","22",57,1,4,1,1,106,-181,-2,-4,84,-90,-2,-4,5,4,22,-91,0,0
"6678","22",111,2,1,0,0,-209,-220,-4,-3,125,-93,-1,1,5,3,-334,-127,-3,-4
"6679","22",115,5,3,0,3,58,2,0,0,106,0,0,1,5,0,-48,2,0,-1
"6680","22",408,4,1,0,0,-135,-1,-4,-1,-85,12,-1,-2,5,1,-50,-13,-3,1
"6681","22",112,9,4,1,3,7,246,4,4,39,241,4,4,5,-4,-32,5,0,0
"6682","22",56,6,3,0,1,113,-115,-3,1,70,-111,-2,-1,5,-1,43,-4,-1,2
"6683","22",6,6,4,1,2,221,-43,1,1,82,-2,1,-1,5,-1,139,-41,0,2
"6684","22",400,4,4,1,2,136,32,-1,-1,122,55,-2,-1,5,1,14,-23,1,0
"6685","22",331,2,1,1,0,-33,-20,-4,-3,-27,30,-4,-3,5,3,-6,-50,0,0
"6686","22",49,5,4,1,1,9,16,0,0,30,12,0,0,5,0,-21,4,0,0
"6687","22",405,3,4,1,1,138,-106,-2,-2,107,-53,0,-2,5,2,31,-53,-2,0
"6688","22",336,2,4,1,3,149,152,2,-3,77,105,-2,3,5,3,72,47,4,-6
"6689","22",114,2,4,1,1,-52,-54,0,-3,137,135,1,-3,5,3,-189,-189,-1,0
"6690","22",410,1,1,0,0,-240,-30,-3,-4,-51,-16,-1,-3,5,4,-189,-14,-2,-1
"6691","22",4,6,3,1,1,177,-1,1,1,238,230,3,3,5,-1,-61,-231,-2,-2
"6692","22",402,1,3,0,0,-242,0,-4,-4,245,-4,4,1,5,4,-487,4,-8,-5
"6693","22",403,3,1,0,0,-175,-12,0,-2,36,-9,1,1,5,2,-211,-3,-1,-3
"6694","22",40,6,1,0,2,-177,58,2,1,162,93,-3,-2,5,-1,-339,-35,5,3
"6695","22",116,7,2,1,3,178,-7,2,2,73,-17,1,-1,5,-2,105,10,1,3
"6696","22",48,1,3,0,0,-3,-4,-4,-4,81,-78,-4,-4,5,4,-84,74,0,0
"6697","22",409,7,4,1,2,119,132,2,2,174,177,2,2,5,-2,-55,-45,0,0
"6698","22",412,9,1,0,0,-243,-245,-4,4,-247,-244,4,4,5,-4,4,-1,-8,0
"6699","22",117,3,4,1,2,229,103,-4,-2,91,-5,-1,-2,5,2,138,108,-3,0
"6700","22",60,3,1,0,3,213,-1,3,-2,214,9,3,3,5,2,-1,-10,0,-5
"6701","22",474,1,1,0,0,2,-108,-4,-4,1,-113,-4,-4,5,4,1,5,0,0
"6702","22",332,4,1,0,0,-234,80,-3,-1,-221,55,-1,0,5,1,-13,25,-2,-1
"6703","22",61,1,1,0,3,-243,-149,4,-4,164,-6,4,-4,5,4,-407,-143,0,0
"6704","22",414,3,1,0,0,-126,-139,-2,-2,7,9,0,0,5,2,-133,-148,-2,-2
"6705","22",418,4,2,1,2,206,-14,1,-1,158,152,1,-1,5,1,48,-166,0,0
"6706","22",62,7,2,1,3,153,119,2,2,219,221,3,4,5,-2,-66,-102,-1,-2
"6707","22",411,9,2,1,2,241,235,4,4,237,237,4,4,5,-4,4,-2,0,0
"6708","22",330,7,2,1,2,163,181,2,2,204,196,2,2,5,-2,-41,-15,0,0
"6709","22",12,9,4,1,3,-1,-1,4,4,-2,-1,4,4,5,-4,1,0,0,0
"6710","22",335,4,2,1,1,-25,1,0,-1,-75,26,-1,-1,5,1,50,-25,1,0
"6711","22",339,3,3,0,1,-156,-38,-2,-2,-48,-16,-1,-1,5,2,-108,-22,-1,-1
"6712","22",266,5,1,0,1,-1,1,0,0,-1,1,0,0,5,0,0,0,0,0
"6713","22",52,2,3,0,0,-233,4,-2,-3,112,4,2,1,5,3,-345,0,-4,-4
"6714","22",178,5,1,0,1,-2,3,0,0,-6,5,0,0,5,0,4,-2,0,0
"6715","22",417,7,2,1,2,135,117,2,2,188,158,2,2,5,-2,-53,-41,0,0
"6716","22",5,5,2,1,2,67,54,1,0,-155,77,-2,-3,5,0,222,-23,3,3
"6717","22",406,7,2,1,2,216,150,1,2,203,154,-1,2,5,-2,13,-4,2,0
"6718","22",337,9,2,1,3,246,218,4,4,239,-10,4,4,5,-4,7,228,0,0
"6719","22",119,7,3,0,3,150,-67,2,2,118,-55,1,1,5,-2,32,-12,1,1
"6720","22",334,1,4,1,0,-238,205,-4,-4,-218,34,-4,-4,5,4,-20,171,0,0
"6721","22",415,9,2,1,2,187,222,0,4,145,189,0,1,5,-4,42,33,0,3
"6722","22",265,8,1,0,3,22,1,0,3,-2,4,0,0,5,-3,24,-3,0,3
"6723","22",63,5,4,1,1,-2,1,0,0,-2,1,0,0,5,0,0,0,0,0
"6724","22",473,3,3,0,0,-236,-16,-2,-2,-226,-16,-1,-1,5,2,-10,0,-1,-1
"6725","22",416,1,4,0,0,-229,245,-4,-4,-234,225,-4,-4,5,4,5,20,0,0
"6726","22",120,4,3,1,1,-76,-80,-1,-1,-109,-98,-1,-1,5,1,33,18,0,0
"6727","22",64,9,1,0,1,-235,239,-4,4,208,-222,4,3,5,-4,-443,461,-8,1
"6728","22",34,6,4,1,2,106,-95,1,1,68,-52,1,1,5,-1,38,-43,0,0
"6729","22",118,4,3,0,1,-61,25,-1,-1,81,27,-2,1,5,1,-142,-2,1,-2
"6730","22",462,9,3,0,3,-2,194,4,4,213,218,-4,-4,5,-4,-215,-24,8,8
"6731","22",475,5,3,0,3,72,-85,0,0,54,-46,0,0,5,0,18,-39,0,0
"6732","22",333,6,4,1,1,62,-9,1,1,-115,117,1,1,5,-1,177,-126,0,0
"6733","22",463,8,4,1,3,-240,-12,-3,3,-7,-228,2,1,5,-3,-233,216,-5,2
"6734","22",338,1,3,0,2,-225,-221,1,-4,229,236,-4,-4,5,4,-454,-457,5,0
"6735","22",419,6,4,1,3,201,132,1,1,168,120,1,0,5,-1,33,12,0,1
"6736","22",51,7,4,1,1,73,70,1,2,-68,-123,2,-1,5,-2,141,193,-1,3
"6737","22",464,6,1,0,1,21,122,0,1,150,0,1,1,5,-1,-129,122,-1,0
"6738","22",169,1,3,1,0,0,0,-4,-4,-243,87,-4,-4,5,4,243,-87,0,0
"6739","22",165,3,1,0,1,63,64,-2,-2,47,36,0,0,5,2,16,28,-2,-2
"6740","22",19,7,2,1,2,97,113,1,2,80,51,1,1,5,-2,17,62,0,1
"6741","22",105,2,1,0,0,-203,9,-4,-3,-56,-19,-1,1,5,3,-147,28,-3,-4
"6742","22",267,5,3,1,1,55,-12,0,0,52,-11,1,1,5,0,3,-1,-1,-1
"6743","22",53,7,4,1,3,205,2,2,2,219,1,2,2,5,-2,-14,1,0,0
"6744","22",179,5,1,0,1,1,4,0,0,-12,3,0,4,5,0,13,1,0,-4
"6745","22",421,2,3,0,1,-141,125,-3,-3,78,82,1,2,5,3,-219,43,-4,-5
"6746","22",50,3,2,1,1,110,-2,1,-2,161,2,2,-2,5,2,-51,-4,-1,0
"6747","22",66,4,1,0,1,-52,0,1,-1,99,-2,-2,1,5,1,-151,2,3,-2
"6748","22",341,9,1,0,3,246,-27,4,4,236,-30,4,4,5,-4,10,3,0,0
"6749","22",468,7,1,0,3,77,-61,2,2,153,102,2,1,5,-2,-76,-163,0,1
"6750","22",189,3,1,0,1,-152,142,2,-2,-81,100,2,-3,5,2,-71,42,0,1
"6751","22",104,1,1,1,0,-241,1,-3,-4,237,0,1,-3,5,4,-478,1,-4,-1
"6752","22",100,9,4,1,3,242,6,4,4,198,1,4,4,5,-4,44,5,0,0
"6753","22",181,5,4,1,3,195,194,2,0,204,101,2,1,5,0,-9,93,0,-1
"6754","22",261,9,1,0,3,202,169,4,4,206,194,4,4,5,-4,-4,-25,0,0
"6755","22",420,7,4,1,3,59,1,1,2,-41,0,0,0,5,-2,100,1,1,2
"6756","22",121,1,1,0,0,-63,12,-4,-4,242,-44,-1,-4,5,4,-305,56,-3,0
"6757","22",65,7,1,0,3,-132,-20,0,2,21,-18,1,1,5,-2,-153,-2,-1,1
"6758","22",340,4,1,0,1,-68,-20,0,-1,78,13,0,0,5,1,-146,-33,0,-1
"6759","22",122,5,1,0,0,-204,-203,0,0,-14,-22,0,0,5,0,-190,-181,0,0
"6760","22",54,1,4,1,1,49,7,-2,-4,41,40,0,0,5,4,8,-33,-2,-4
"6761","22",476,2,3,0,0,-208,-187,-3,-3,169,85,1,1,5,3,-377,-272,-4,-4
"6762","22",269,6,4,1,2,250,137,1,1,249,135,1,1,5,-1,1,2,0,0
"6763","22",472,1,1,0,0,-244,190,-4,-4,-233,123,-4,-4,5,4,-11,67,0,0
"6764","22",180,6,2,1,2,39,4,2,1,-3,2,0,0,5,-1,42,2,2,1
"6765","22",42,2,3,1,1,0,-14,2,-3,2,11,2,-2,5,3,-2,-25,0,-1
"6766","22",469,2,4,1,0,101,93,-4,-3,102,75,-3,-3,5,3,-1,18,-1,0
"6767","22",465,7,4,1,3,0,0,3,2,-3,213,4,3,5,-2,3,-213,-1,-1
"6768","22",17,1,3,0,0,-137,43,-3,-4,138,86,-2,-4,5,4,-275,-43,-1,0
"6769","22",166,2,4,1,2,161,160,-3,-3,132,108,-2,-1,5,3,29,52,-1,-2
"6770","22",190,7,4,1,3,204,-5,2,2,203,-132,3,3,5,-2,1,127,-1,-1
"6771","22",106,4,2,1,1,-166,-154,-1,-1,-164,-179,-1,-1,5,1,-2,25,0,0
"6772","22",268,7,4,1,3,116,150,2,2,131,-117,3,2,5,-2,-15,267,-1,0
"6773","22",471,6,3,0,2,31,-17,1,1,102,-116,-2,0,5,-1,-71,99,3,1
"6774","22",18,3,3,0,1,-162,-54,0,-2,85,25,1,0,5,2,-247,-79,-1,-2
"6775","22",422,5,3,0,1,-109,-241,3,0,-54,-235,4,-2,5,0,-55,-6,-1,2
"6776","22",123,3,4,1,2,96,-35,-2,-2,-48,23,-2,-2,5,2,144,-58,0,0
"6777","22",67,2,1,0,0,-28,30,-3,-3,141,-145,1,1,5,3,-169,175,-4,-4
"6778","22",342,4,3,0,1,-213,33,-2,-1,-83,-137,-1,-2,5,1,-130,170,-1,1
"6779","22",27,6,2,1,2,34,63,1,1,115,109,0,0,5,-1,-81,-46,1,1
"6780","22",193,1,1,0,0,-148,-163,-4,-4,205,119,1,1,5,4,-353,-282,-5,-5
"6781","22",109,1,1,0,1,-2,-204,2,-4,-7,-177,1,-3,5,4,5,-27,1,-1
"6782","22",101,1,3,0,0,-236,239,-4,-4,206,202,-3,-3,5,4,-442,37,-1,-1
"6783","22",182,6,4,1,3,-1,-83,2,1,1,-161,2,1,5,-1,-2,78,0,0
"6784","22",262,6,4,1,3,122,81,1,1,72,49,1,1,5,-1,50,32,0,0
"6785","22",259,1,3,0,1,-134,48,4,-4,-3,2,4,-4,5,4,-131,46,0,0
"6786","22",470,4,1,1,1,-89,34,-1,-1,-45,73,-1,-1,5,1,-44,-39,0,0
"6787","22",467,3,1,0,3,179,190,3,-2,140,125,4,0,5,2,39,65,-1,-2
"6788","22",171,4,1,1,1,-220,145,-1,-1,11,14,0,0,5,1,-231,131,-1,-1
"6789","22",168,3,1,1,3,122,-52,-1,-2,107,-98,2,2,5,2,15,46,-3,-4
"6790","22",192,6,4,1,1,-69,1,1,1,1,50,0,0,5,-1,-70,-49,1,1
"6791","22",108,9,2,1,3,231,35,4,4,216,208,4,4,5,-4,15,-173,0,0
"6792","22",185,6,4,1,2,113,-8,0,1,125,-11,0,2,5,-1,-12,3,0,-1
"6793","22",233,7,2,1,2,177,80,2,2,47,31,1,1,5,-2,130,49,1,1
"6794","22",157,8,3,0,2,159,122,3,3,132,87,-2,0,5,-3,27,35,5,3
"6795","22",258,1,3,0,0,-19,-4,-4,-4,-33,-1,-1,-3,5,4,14,-3,-3,-1
"6796","22",47,7,4,1,3,201,2,2,2,40,-2,2,2,5,-2,161,4,0,0
"6797","22",466,4,3,0,0,84,-52,-1,-1,81,-86,3,3,5,1,3,34,-4,-4
"6798","22",170,2,2,1,0,46,45,-3,-3,24,20,0,0,5,3,22,25,-3,-3
"6799","22",167,4,1,0,3,-157,-117,2,-1,-178,-138,-2,-2,5,1,21,21,4,1
"6800","22",191,2,1,0,0,-214,-48,-2,-3,-202,20,-2,-2,5,3,-12,-68,0,-1
"6801","22",107,6,2,1,3,-228,-39,-2,1,-17,228,1,-1,5,-1,-211,-267,-3,2
"6802","22",103,5,2,1,3,2,0,-1,0,62,1,0,1,5,0,-60,-1,-1,-1
"6803","22",184,7,3,0,3,119,-2,1,2,132,7,2,2,5,-2,-13,-9,-1,0
"6804","22",156,5,2,0,1,-38,2,0,0,81,23,1,1,5,0,-119,-21,-1,-1
"6805","22",423,8,1,0,3,58,-45,1,3,-109,7,3,-1,5,-3,167,-52,-2,4
"6806","22",124,3,1,1,3,237,0,-4,-2,247,1,3,2,5,2,-10,-1,-7,-4
"6807","22",68,2,4,1,0,72,0,-2,-3,201,1,1,-2,5,3,-129,-1,-3,-1
"6808","22",343,7,2,1,2,121,0,2,2,110,0,1,1,5,-2,11,0,1,1
"6809","22",270,4,3,0,1,138,3,1,-1,41,4,1,0,5,1,97,-1,0,-1
"6810","22",194,8,1,0,0,-135,17,-4,3,-211,16,-4,3,5,-3,76,1,0,0
"6811","22",11,6,4,1,1,46,79,2,1,107,151,3,2,5,-1,-61,-72,-1,-1
"6812","22",102,9,4,0,3,98,-86,2,4,-91,33,4,3,5,-4,189,-119,-2,1
"6813","22",183,3,4,1,1,24,23,1,-2,38,38,1,-2,5,2,-14,-15,0,0
"6814","22",263,2,4,1,0,-206,-7,-1,-3,-55,2,-1,-3,5,3,-151,-9,0,0
"6815","22",26,1,1,0,0,-223,218,-4,-4,16,-69,-2,-3,5,4,-239,287,-2,-1
"6816","22",1,7,1,0,1,-45,20,1,2,148,129,1,2,5,-2,-193,-109,0,0
"6817","22",395,3,3,0,1,221,32,-2,-2,198,24,3,3,5,2,23,8,-5,-5
"6818","22",172,7,2,1,3,106,141,2,2,175,180,3,3,5,-2,-69,-39,-1,-1
"6819","22",321,5,1,0,0,1,-2,0,0,36,32,4,4,5,0,-35,-34,-4,-4
"6820","22",318,9,2,1,2,183,-162,-4,4,183,-185,-4,1,5,-4,0,23,0,3
"6821","22",460,2,1,0,0,-210,-70,-4,-3,200,28,-3,1,5,3,-410,-98,-1,-4
"6822","22",186,5,2,1,2,112,124,0,0,221,224,0,1,5,0,-109,-100,0,-1
"6823","22",234,7,3,0,3,162,48,1,2,142,34,1,2,5,-2,20,14,0,0
"6824","22",158,4,3,1,0,46,-30,-1,-1,36,-33,-2,0,5,1,10,3,1,-1
"6825","22",98,1,3,0,0,-212,38,-4,-4,111,-159,1,1,5,4,-323,197,-5,-5
"6826","22",30,8,2,1,2,243,-3,3,3,-18,0,2,1,5,-3,261,-3,1,2
"6827","22",297,9,3,0,2,220,78,4,4,229,226,4,3,5,-4,-9,-148,0,1
"6828","22",37,1,1,0,0,-171,-12,-3,-4,-159,-17,-3,-4,5,4,-12,5,0,0
"6829","22",366,8,4,1,3,128,54,2,3,145,-127,4,2,5,-3,-17,181,-2,1
"6830","22",362,6,4,1,3,154,-109,3,1,106,133,4,1,5,-1,48,-242,-1,0
"6831","22",244,4,4,1,2,56,18,0,-1,214,216,3,3,5,1,-158,-198,-3,-4
"6832","22",237,7,2,1,2,242,54,-2,2,85,0,-2,1,5,-2,157,54,0,1
"6833","22",164,8,2,1,2,209,-163,3,3,185,176,2,3,5,-3,24,-339,1,0
"6834","22",428,1,1,0,0,-239,-227,-4,-4,-235,217,-4,-4,5,4,-4,-444,0,0
"6835","22",424,4,2,1,2,54,56,-1,-1,47,11,-1,-1,5,1,7,45,0,0
"6836","22",125,3,4,1,0,-184,-16,-4,-2,240,-242,-4,-4,5,2,-424,226,0,2
"6837","22",69,6,4,1,1,65,93,2,1,49,84,-3,-2,5,-1,16,9,5,3
"6838","22",344,7,4,1,3,119,105,3,2,-91,54,0,1,5,-2,210,51,3,1
"6839","22",271,2,3,0,1,-226,0,-3,-3,240,3,3,4,5,3,-466,-3,-6,-7
"6840","22",195,1,1,0,1,-246,245,4,-4,19,-17,2,0,5,4,-265,262,2,-4
"6841","22",110,6,1,0,1,-106,150,-4,1,146,93,3,1,5,-1,-252,57,-7,0
"6842","22",188,9,2,1,3,218,2,4,4,233,6,4,4,5,-4,-15,-4,0,0
"6843","22",232,1,1,0,0,-237,-59,-2,-4,-182,-30,-2,-4,5,4,-55,-29,0,0
"6844","22",264,5,4,1,2,237,248,4,0,126,26,1,-1,5,0,111,222,3,1
"6845","22",260,2,3,0,0,-210,-218,-3,-3,-195,-187,-2,-2,5,3,-15,-31,-1,-1
"6846","22",10,4,3,1,1,-165,-4,-2,-1,-3,-142,-2,-2,5,1,-162,138,0,1
"6847","22",396,1,1,0,1,-245,242,4,-4,43,-68,-2,1,5,4,-288,310,6,-5
"6848","22",173,8,4,1,3,186,16,3,3,197,34,0,0,5,-3,-11,-18,3,3
"6849","22",322,6,4,1,3,34,-36,1,1,234,-237,4,4,5,-1,-200,201,-3,-3
"6850","22",319,8,1,0,1,-153,-46,3,3,21,-39,1,2,5,-3,-174,-7,2,1
"6851","22",461,5,4,1,2,115,26,2,0,54,46,1,-1,5,0,61,-20,1,1
"6852","22",187,9,4,1,2,192,176,4,4,204,90,3,3,5,-4,-12,86,1,1
"6853","22",235,1,3,0,0,-238,-1,-4,-4,81,2,2,2,5,4,-319,-3,-6,-6
"6854","22",159,1,3,0,2,-238,4,-4,-4,222,0,4,4,5,4,-460,4,-8,-8
"6855","22",99,7,4,1,3,233,13,2,2,227,-20,2,2,5,-2,6,33,0,0
"6856","22",300,2,1,0,0,-204,21,-2,-3,-24,31,-1,-1,5,3,-180,-10,-1,-2
"6857","22",298,1,1,0,0,-240,12,-2,-4,10,-174,1,1,5,4,-250,186,-3,-5
"6858","22",370,1,1,1,3,-238,-8,-4,-4,242,-11,0,-4,5,4,-480,3,-4,0
"6859","22",367,3,3,0,1,-199,-91,2,-2,-122,-59,2,-1,5,2,-77,-32,0,-1
"6860","22",363,2,3,0,3,-249,-1,-3,-3,-244,1,-3,-3,5,3,-5,-2,0,0
"6861","22",245,1,1,0,0,-83,-77,-4,-4,-105,0,-2,-3,5,4,22,-77,-2,-1
"6862","22",238,1,3,0,1,-206,79,0,-4,100,-1,1,1,5,4,-306,80,-1,-5
"6863","22",388,1,4,1,0,-241,10,-4,-4,-242,2,-1,1,5,4,1,8,-3,-5
"6864","22",429,9,2,0,0,-238,-2,4,4,103,10,0,-4,5,-4,-341,-12,4,8
"6865","22",425,6,4,1,2,-1,56,1,1,14,70,2,2,5,-1,-15,-14,-1,-1
"6866","22",126,3,2,1,2,67,179,-1,-2,26,88,-2,-2,5,2,41,91,1,0
"6867","22",7,5,1,0,3,94,16,1,0,120,49,2,2,5,0,-26,-33,-1,-2
"6868","22",345,7,1,0,0,-243,245,-4,2,-192,45,-4,-4,5,-2,-51,200,0,6
"6869","22",272,7,4,1,2,129,126,2,2,136,105,2,2,5,-2,-7,21,0,0
"6870","22",196,1,3,0,0,-217,0,-4,-4,167,190,3,3,5,4,-384,-190,-7,-7
"6871","22",143,7,1,1,3,237,-23,3,2,26,-73,2,2,5,-2,211,50,1,0
"6872","22",240,5,2,1,1,208,9,0,0,-45,14,0,0,5,0,253,-5,0,0
"6873","22",435,5,4,1,1,-4,6,0,0,57,-10,1,0,5,0,-61,16,-1,0
"6874","22",160,7,2,0,0,-76,13,-4,2,-20,9,-4,2,5,-2,-56,4,0,0
"6875","22",306,5,3,0,3,145,91,1,0,100,86,1,0,5,0,45,5,0,0
"6876","22",302,3,1,0,0,-192,-43,-3,-2,208,55,-2,-2,5,2,-400,-98,-1,0
"6877","22",254,4,2,1,3,216,-233,-4,-1,172,-70,-3,1,5,1,44,-163,-1,-2
"6878","22",174,5,4,1,3,46,56,0,0,149,98,0,1,5,0,-103,-42,0,-1
"6879","22",323,1,4,1,1,233,-1,-1,-4,224,7,4,-4,5,4,9,-8,-5,0
"6880","22",32,3,1,0,1,149,25,4,-2,181,-149,2,-2,5,2,-32,174,2,0
"6881","22",243,3,2,1,2,209,247,-1,-2,248,186,2,0,5,2,-39,61,-3,-2
"6882","22",236,5,1,1,1,24,-32,0,0,22,-38,0,0,5,0,2,6,0,0
"6883","22",163,1,3,0,1,-238,3,-3,-4,73,-15,1,2,5,4,-311,18,-4,-6
"6884","22",16,1,1,0,0,-233,243,-3,-4,229,14,2,1,5,4,-462,229,-5,-5
"6885","22",305,9,4,1,3,237,237,4,4,241,238,4,4,5,-4,-4,-1,0,0
"6886","22",301,4,4,1,1,-85,1,-1,-1,56,-1,3,2,5,1,-141,2,-4,-3
"6887","22",299,2,4,1,1,40,209,-2,-3,39,219,3,4,5,3,1,-10,-5,-7
"6888","22",371,1,3,0,0,-218,-182,-4,-4,153,-69,-4,2,5,4,-371,-113,0,-6
"6889","22",368,1,3,1,3,129,-141,-4,-4,-103,106,4,4,5,4,232,-247,-8,-8
"6890","22",364,6,3,0,1,91,7,1,1,-36,1,0,1,5,-1,127,6,1,0
"6891","22",246,8,4,1,3,174,0,4,3,3,-58,4,3,5,-3,171,58,0,0
"6892","22",239,3,1,0,1,128,186,2,-2,162,-75,2,2,5,2,-34,261,0,-4
"6893","22",389,3,3,0,2,20,2,-2,-2,1,-2,0,0,5,2,19,4,-2,-2
"6894","22",43,1,3,0,0,-211,7,-3,-4,82,6,1,-4,5,4,-293,1,-4,0
"6895","22",426,9,4,1,3,6,242,4,4,247,-4,4,3,5,-4,-241,246,0,1
"6896","22",127,1,1,0,0,-236,-2,-4,-4,-110,0,-4,-4,5,4,-126,-2,0,0
"6897","22",70,5,2,1,2,174,235,0,0,239,234,4,4,5,0,-65,1,-4,-4
"6898","22",346,8,3,0,0,-249,0,0,3,240,42,0,3,5,-3,-489,-42,0,0
"6899","22",273,2,1,0,0,-224,-178,-4,-3,-29,10,4,4,5,3,-195,-188,-8,-7
"6900","22",197,3,4,1,3,-129,11,3,-2,-234,8,3,0,5,2,105,3,0,-2
"6901","22",144,3,3,1,0,-242,-4,2,-2,0,6,1,0,5,2,-242,-10,1,-2
"6902","22",241,5,4,1,2,197,156,3,0,192,203,3,0,5,0,5,-47,0,0
"6903","22",436,3,4,1,3,72,-250,1,-2,95,-222,3,0,5,2,-23,-28,-2,-2
"6904","22",161,2,2,1,2,127,93,0,-3,70,46,1,-3,5,3,57,47,-1,0
"6905","22",307,4,4,1,2,-104,-80,-1,-1,225,-100,3,3,5,1,-329,20,-4,-4
"6906","22",303,4,3,0,2,-40,-64,-1,-1,-80,-108,0,0,5,1,40,44,-1,-1
"6907","22",255,1,3,0,1,118,-117,-4,-4,117,-138,1,1,5,4,1,21,-5,-5
"6908","22",175,6,4,0,1,175,-18,2,1,0,-51,1,2,5,-1,175,33,1,-1
"6909","22",324,1,2,1,0,121,-1,-4,-4,-7,3,-4,-4,5,4,128,-4,0,0
"6910","22",320,8,2,1,2,196,140,3,3,108,111,1,2,5,-3,88,29,2,1
"6911","22",248,9,4,1,3,240,238,4,4,80,233,4,4,5,-4,160,5,0,0
"6912","22",394,1,3,0,0,-250,248,-4,-4,-248,246,-4,-4,5,4,-2,2,0,0
"6913","22",390,9,2,1,2,245,246,4,4,-30,-27,-2,-1,5,-4,275,273,6,5
"6914","22",431,4,3,0,0,-218,53,-1,-1,1,4,0,0,5,1,-219,49,-1,-1
"6915","22",132,6,4,1,1,11,100,1,1,6,103,1,1,5,-1,5,-3,0,0
"6916","22",129,3,4,1,1,-212,1,-2,-2,-216,5,-3,-3,5,2,4,-4,1,1
"6917","22",3,3,3,0,0,-1,-3,2,-2,-178,184,-3,-3,5,2,177,-187,5,1
"6918","22",372,1,3,0,0,-211,-230,-4,-4,223,239,3,2,5,4,-434,-469,-7,-6
"6919","22",369,5,4,0,0,59,-1,0,0,114,1,1,0,5,0,-55,-2,-1,0
"6920","22",365,5,3,0,1,3,-121,0,0,4,9,0,0,5,0,-1,-130,0,0
"6921","22",247,3,3,0,0,-207,-10,-2,-2,174,-19,1,1,5,2,-381,9,-3,-3
"6922","22",24,8,2,1,2,224,2,3,3,245,-1,4,4,5,-3,-21,3,-1,-1
"6923","22",39,3,3,1,1,-71,34,-1,-2,140,-169,3,2,5,2,-211,203,-4,-4
"6924","22",430,3,2,1,1,52,-44,1,-2,188,-98,1,-2,5,2,-136,54,0,0
"6925","22",427,4,4,1,1,248,20,1,-1,-212,-25,2,-2,5,1,460,45,-1,1
"6926","22",128,6,1,0,3,154,-55,1,1,-34,-110,4,0,5,-1,188,55,-3,1
"6927","22",71,4,3,0,1,-74,21,1,-1,40,22,-1,0,5,1,-114,-1,2,-1
"6928","22",347,5,1,1,3,-171,190,4,0,149,195,2,2,5,0,-320,-5,2,-2
"6929","22",274,7,4,1,2,103,111,2,2,94,111,2,2,5,-2,9,0,0,0
"6930","22",198,4,1,0,1,-163,113,-1,-1,75,68,3,1,5,1,-238,45,-4,-2
"6931","22",145,6,1,0,1,93,-2,1,1,95,43,1,0,5,-1,-2,-45,0,1
"6932","22",242,3,4,1,2,117,44,1,-2,122,33,2,-1,5,2,-5,11,-1,-1
"6933","22",437,4,1,0,0,-128,0,-1,-1,-135,1,-1,-1,5,1,7,-1,0,0
"6934","22",162,7,3,1,3,46,106,-2,2,215,168,3,3,5,-2,-169,-62,-5,-1
"6935","22",308,1,4,1,0,-249,-246,-4,-4,247,250,4,4,5,4,-496,-496,-8,-8
"6936","22",304,4,2,1,2,20,-48,-2,-1,215,-33,-2,-2,5,1,-195,-15,0,1
"6937","22",256,5,3,0,1,-87,-1,0,0,130,107,1,1,5,0,-217,-108,-1,-1
"6938","22",176,9,1,0,1,-238,53,-4,4,187,50,1,2,5,-4,-425,3,-5,2
"6939","22",325,7,1,0,1,-66,-59,-1,2,1,2,0,4,5,-2,-67,-61,-1,-2
"6940","22",249,1,3,0,0,-204,-126,-3,-4,72,-199,3,-3,5,4,-276,73,-6,-1
"6941","22",447,6,4,1,2,93,94,3,1,120,106,2,1,5,-1,-27,-12,1,0
"6942","22",443,3,1,0,0,116,46,-2,-2,67,52,2,1,5,2,49,-6,-4,-3
"6943","22",391,3,2,0,3,-190,167,3,-2,194,152,0,0,5,2,-384,15,3,-2
"6944","22",432,4,2,1,1,61,88,-1,-1,51,-58,0,0,5,1,10,146,-1,-1
"6945","22",133,1,2,1,1,-238,-21,0,-4,209,29,4,0,5,4,-447,-50,-4,-4
"6946","22",13,3,4,1,1,-32,-92,-2,-2,-1,-45,-1,-2,5,2,-31,-47,-1,0
"6947","22",154,5,4,0,3,-15,-236,0,0,-60,49,0,0,5,0,45,-285,0,0
"6948","22",373,1,3,0,0,-246,-28,0,-4,-225,-34,0,-4,5,4,-21,6,0,0
"6949","22",150,5,3,0,1,3,1,0,0,21,5,0,0,5,0,-18,-4,0,0
"6950","22",147,7,2,1,3,-2,168,1,2,134,76,2,2,5,-2,-136,92,-1,0
"6951","22",446,5,4,1,1,9,27,-1,0,50,22,0,0,5,0,-41,5,-1,0
"6952","22",442,6,4,1,1,-26,28,-1,1,27,27,1,1,5,-1,-53,1,-2,0
"6953","22",439,5,2,1,1,3,3,0,0,4,2,0,0,5,0,-1,1,0,0
"6954","22",387,8,3,0,1,174,148,2,3,65,35,1,0,5,-3,109,113,1,3
"6955","22",31,1,1,1,0,-118,73,-4,-4,-71,-105,-1,-1,5,4,-47,178,-3,-3
"6956","22",383,5,4,1,1,-1,2,0,0,1,-2,-1,0,5,0,-2,4,1,0
"6957","22",72,2,1,0,0,-192,-117,-2,-3,142,163,2,2,5,3,-334,-280,-4,-5
"6958","22",348,2,3,0,1,-96,1,0,-3,71,63,0,-3,5,3,-167,-62,0,0
"6959","22",275,7,4,1,2,238,4,3,2,-3,245,2,-1,5,-2,241,-241,1,3
"6960","22",199,7,4,1,2,200,51,2,2,167,49,1,1,5,-2,33,2,1,1
"6961","22",146,2,2,1,0,-163,-153,-3,-3,-140,-111,-3,-3,5,3,-23,-42,0,0
"6962","22",393,1,1,1,0,-225,-10,-4,-4,136,-122,3,-2,5,4,-361,112,-7,-2
"6963","22",438,7,4,1,3,249,0,4,2,137,2,2,4,5,-2,112,-2,2,-2
"6964","22",386,1,1,0,0,-242,-247,-4,-4,-7,7,-1,-2,5,4,-235,-254,-3,-2
"6965","22",309,3,4,1,2,187,82,-1,-2,110,69,-1,-1,5,2,77,13,0,-1
"6966","22",382,6,4,1,2,76,-7,1,1,51,0,1,1,5,-1,25,-7,0,0
"6967","22",257,1,1,0,0,-167,54,2,-4,193,93,4,-4,5,4,-360,-39,-2,0
"6968","22",177,1,4,1,1,62,190,-4,-4,44,199,-4,-4,5,4,18,-9,0,0
"6969","22",326,7,4,1,2,151,80,2,2,102,61,2,2,5,-2,49,19,0,0
"6970","22",25,4,4,1,2,0,2,0,-1,7,19,0,-2,5,1,-7,-17,0,1
"6971","22",448,9,2,1,2,245,-6,-4,4,0,-8,0,0,5,-4,245,2,-4,4
"6972","22",444,5,2,1,2,93,56,2,0,76,43,1,0,5,0,17,13,1,0
"6973","22",392,4,1,0,0,-98,-96,-1,-1,-78,-46,-1,-2,5,1,-20,-50,0,1
"6974","22",433,1,1,0,0,-223,-151,-3,-4,180,162,3,-3,5,4,-403,-313,-6,-1
"6975","22",134,6,2,1,2,62,3,2,1,15,1,2,0,5,-1,47,2,0,1
"6976","22",130,9,1,0,3,196,26,4,4,79,-37,4,4,5,-4,117,63,0,0
"6977","22",155,7,2,1,1,60,-13,2,2,58,-13,3,3,5,-2,2,0,-1,-1
"6978","22",374,7,4,1,2,191,57,2,2,199,59,2,3,5,-2,-8,-2,0,-1
"6979","22",151,1,2,1,1,61,7,0,-4,-147,13,0,-4,5,4,208,-6,0,0
"6980","22",148,1,1,0,1,-246,1,3,-4,-201,-46,1,-3,5,4,-45,47,2,-1
"6981","22",14,7,3,0,1,134,-30,2,2,179,-24,1,1,5,-2,-45,-6,1,1
"6982","22",136,1,1,0,0,0,0,-4,-4,-238,30,-3,-3,5,4,238,-30,-1,-1
"6983","22",44,5,2,1,2,237,-229,0,0,232,154,0,-4,5,0,5,-383,0,4
"6984","22",314,1,4,1,1,-242,10,4,-4,-241,21,4,-4,5,4,-1,-11,0,0
"6985","22",310,8,4,1,2,180,38,3,3,194,1,3,3,5,-3,-14,37,0,0
"6986","22",384,3,1,1,0,-67,0,-2,-2,1,1,-2,-2,5,2,-68,-1,0,0
"6987","22",73,7,4,1,2,121,-76,1,2,100,-110,-1,-1,5,-2,21,34,2,3
"6988","22",349,4,4,1,1,-89,-70,0,-1,-126,104,1,3,5,1,37,-174,-1,-4
"6989","22",276,8,4,1,3,234,-3,3,3,161,-4,2,2,5,-3,73,1,1,1
"6990","22",2,4,4,1,1,-47,-65,-1,-1,-98,-86,-2,2,5,1,51,21,1,-3
"6991","22",434,5,4,1,3,207,-24,2,0,177,-29,2,2,5,0,30,5,0,-2
"6992","22",135,2,1,0,1,-179,101,-3,-3,-27,6,-1,-1,5,3,-152,95,-2,-2
"6993","22",94,3,4,1,1,-32,-33,-1,-2,189,-173,1,3,5,2,-221,140,-2,-5
"6994","22",379,1,3,0,1,6,15,1,-4,-15,-39,1,0,5,4,21,54,0,-4
"6995","22",375,4,3,1,1,-103,25,-1,-1,0,1,0,0,5,1,-103,24,-1,-1
"6996","22",8,3,3,1,1,-82,-20,2,-2,236,-12,0,-1,5,2,-318,-8,2,-1
"6997","22",38,9,4,1,3,0,0,2,4,180,-25,4,4,5,-4,-180,25,-2,0
"6998","22",376,3,4,1,1,-48,-123,-2,-2,5,-101,-2,-2,5,2,-53,-22,0,0
"6999","22",327,6,4,1,3,124,4,2,1,81,167,2,-1,5,-1,43,-163,0,2
"7000","22",250,6,1,1,3,97,38,1,1,80,21,1,1,5,-1,17,17,0,0
"7001","22",449,7,4,1,3,81,104,2,2,40,92,2,1,5,-2,41,12,0,1
"7002","22",445,6,4,1,3,102,-34,1,1,109,-48,1,1,5,-1,-7,14,0,0
"7003","22",441,7,4,1,2,20,-224,3,2,8,-229,3,2,5,-2,12,5,0,0
"7004","22",74,1,3,0,0,-244,0,-4,-4,-88,-1,-3,-3,5,4,-156,1,-1,-1
"7005","22",35,6,1,0,3,61,156,0,1,166,206,4,-1,5,-1,-105,-50,-4,2
"7006","22",131,8,4,1,3,186,33,-1,3,55,-25,0,3,5,-3,131,58,-1,0
"7007","22",20,9,3,0,0,-238,-236,-4,4,-238,-243,-4,1,5,-4,0,7,0,3
"7008","22",317,5,4,1,2,1,0,0,0,34,-40,1,1,5,0,-33,40,-1,-1
"7009","22",152,2,1,0,0,-113,-1,-2,-3,126,-1,0,-3,5,3,-239,0,-2,0
"7010","22",149,5,3,1,1,-1,-3,-1,0,247,2,-3,1,5,0,-248,-5,2,-1
"7011","22",140,3,1,1,1,-35,101,0,-2,-32,47,0,-1,5,2,-3,54,0,-1
"7012","22",137,6,1,0,1,-231,-230,-3,1,184,200,-1,2,5,-1,-415,-430,-2,-1
"7013","22",440,2,3,0,0,-148,-8,-3,-3,1,2,0,0,5,3,-149,-10,-3,-3
"7014","22",315,9,3,0,3,249,11,4,4,-10,243,4,4,5,-4,259,-232,0,0
"7015","22",311,1,2,1,2,192,7,4,-4,212,9,4,-4,5,4,-20,-2,0,0
"7016","22",385,8,4,1,1,86,65,3,3,131,55,1,1,5,-3,-45,10,2,2
"7017","22",251,6,3,0,1,-1,-220,1,1,1,-236,0,-2,5,-1,-2,16,1,3
"7018","22",316,4,3,0,0,-106,-7,-1,-1,-95,-36,-1,-1,5,1,-11,29,0,0
"7019","22",277,6,4,1,1,35,-116,3,1,-27,-77,2,-3,5,-1,62,-39,1,4
"7020","22",82,9,4,1,2,23,228,4,4,212,-19,2,-2,5,-4,-189,247,2,6
"7021","22",75,2,4,1,2,155,17,2,-3,239,238,2,-2,5,3,-84,-221,0,-1
"7022","22",313,1,3,0,0,-236,-229,-4,-4,223,230,3,3,5,4,-459,-459,-7,-7
"7023","22",95,7,4,1,2,135,4,2,2,10,7,1,1,5,-2,125,-3,1,1
"7024","22",76,5,4,1,3,-1,-7,0,0,9,5,2,0,5,0,-10,-12,-2,0
"7025","22",351,1,1,0,0,-245,-244,-4,-4,119,123,-4,-4,5,4,-364,-367,0,0
"7026","22",80,6,4,1,3,139,2,3,1,242,1,2,2,5,-1,-103,1,1,-1
"7027","22",380,3,4,1,1,-83,-39,3,-2,-132,-34,3,-3,5,2,49,-5,0,1
"7028","22",377,1,1,0,0,-244,10,-4,-4,-240,8,4,-4,5,4,-4,2,-8,0
"7029","22",328,4,3,0,1,-27,11,-1,-1,-37,24,-1,-1,5,1,10,-13,0,0
"7030","22",97,2,1,0,1,-239,75,2,-3,177,124,3,-2,5,3,-416,-49,-1,-1
"7031","22",381,7,2,1,2,190,212,2,2,213,242,2,2,5,-2,-23,-30,0,0
"7032","22",312,5,4,1,1,-32,91,0,0,113,-108,0,-4,5,0,-145,199,0,4
"7033","22",329,8,4,1,3,-207,-15,-3,3,-113,52,-4,3,5,-3,-94,-67,1,0
"7034","22",252,4,4,1,1,-190,-160,-1,-1,69,-99,1,1,5,1,-259,-61,-2,-2
"7035","22",350,9,4,1,1,246,9,3,4,243,-3,2,1,5,-4,3,12,1,3
"7036","22",83,5,1,0,3,81,-118,1,0,146,-124,2,1,5,0,-65,6,-1,-1
"7037","22",200,1,3,0,0,-230,-170,-4,-4,-167,-14,-4,-3,5,4,-63,-156,0,-1
"7038","22",91,7,2,1,3,234,207,2,2,220,1,1,-1,5,-2,14,206,1,3
"7039","22",153,5,1,1,3,-83,90,1,0,-60,-97,0,1,5,0,-23,187,1,-1
"7040","22",15,3,4,1,3,-60,10,-2,-2,-67,30,-1,-2,5,2,7,-20,-1,0
"7041","22",141,1,1,0,0,-233,68,-4,-4,134,9,4,4,5,4,-367,59,-8,-8
"7042","22",138,6,3,0,1,98,-93,1,1,163,-35,1,1,5,-1,-65,-58,0,0
"7043","22",81,1,1,0,0,-239,93,-4,-4,-213,132,4,1,5,4,-26,-39,-8,-5
"7044","22",45,1,3,0,0,-250,143,-4,-4,-127,44,-3,-3,5,4,-123,99,-1,-1
"7045","22",378,3,4,1,1,-199,1,1,-2,97,2,1,1,5,2,-296,-1,0,-3
"7046","22",139,9,4,1,2,158,9,4,4,239,0,4,4,5,-4,-81,9,0,0
"7047","22",86,3,4,1,3,160,15,-1,-2,177,-2,2,3,5,2,-17,17,-3,-5
"7048","22",90,1,4,1,0,-234,22,-4,-4,245,-1,4,4,5,4,-479,23,-8,-8
"7049","22",278,1,4,1,1,234,229,4,-4,-232,-231,4,-4,5,4,466,460,0,0
"7050","22",223,5,1,0,1,-136,1,-1,0,77,-1,-1,0,5,0,-213,2,0,0
"7051","22",359,9,4,1,3,237,11,4,4,229,12,4,4,5,-4,8,-1,0,0
"7052","22",88,9,4,1,2,236,225,4,4,224,-208,4,4,5,-4,12,433,0,0
"7053","22",96,4,1,0,0,-243,0,-3,-1,-21,4,-1,-1,5,1,-222,-4,-2,0
"7054","22",77,4,3,1,1,-243,4,1,-1,-63,-1,-1,-1,5,1,-180,5,2,0
"7055","22",352,4,2,1,1,11,-12,0,-1,7,-90,0,-1,5,1,4,78,0,0
"7056","22",230,7,1,0,0,-79,14,-3,2,-60,13,-3,2,5,-2,-19,1,0,0
"7057","22",85,8,2,1,2,146,154,4,3,117,108,4,3,5,-3,29,46,0,0
"7058","22",142,5,2,1,2,203,112,1,0,123,34,-2,0,5,0,80,78,3,0
"7059","22",353,1,2,1,2,217,196,-4,-4,243,173,-3,1,5,4,-26,23,-1,-5
"7060","22",231,7,4,1,0,-113,-119,-4,2,-2,85,-4,3,5,-2,-111,-204,0,-1
"7061","22",79,7,4,1,2,160,-10,2,2,103,-15,1,1,5,-2,57,5,1,1
"7062","22",87,7,4,1,3,94,16,2,2,7,-5,0,1,5,-2,87,21,2,1
"7063","22",33,5,3,0,1,87,-30,-1,0,-208,56,-2,2,5,0,295,-86,1,-2
"7064","22",253,9,3,0,3,-22,0,4,4,229,234,4,4,5,-4,-251,-234,0,0
"7065","22",46,5,1,0,0,-27,-234,-4,0,-1,-239,-4,4,5,0,-26,5,0,-4
"7066","22",84,8,4,1,3,192,1,3,3,200,3,2,2,5,-3,-8,-2,1,1
"7067","22",201,1,3,1,1,-74,-1,-3,-4,31,-1,1,-3,5,4,-105,0,-4,-1
"7068","22",92,5,4,1,2,0,0,0,0,0,0,0,0,5,0,0,0,0,0
"7069","22",89,4,3,0,0,-239,5,-4,-1,-244,3,-4,0,5,1,5,2,0,-1
"7070","22",28,3,4,1,1,-48,-25,-2,-2,66,40,-1,-1,5,2,-114,-65,-1,-1
"7071","22",78,3,4,1,0,-191,3,-2,-2,-193,9,-2,-2,5,2,2,-6,0,0
"7072","22",93,5,1,0,1,-159,84,-2,0,-72,18,-1,0,5,0,-87,66,-1,0
"7073","22",9,4,4,1,2,33,21,1,-1,78,19,1,-1,5,1,-45,2,0,0
"7074","22",450,4,4,1,3,238,0,1,-1,227,1,2,-2,5,1,11,-1,-1,1
"7075","22",459,2,3,0,1,-13,-166,3,-3,-19,-65,3,-4,5,3,6,-101,0,1
"7076","22",227,7,3,0,3,-90,-25,2,2,45,13,2,-1,5,-2,-135,-38,0,3
"7077","22",455,5,2,1,2,2,-1,0,0,246,6,3,3,5,0,-244,-7,-3,-3
"7078","22",293,1,4,0,0,-188,9,-4,-4,-100,-31,-4,-4,5,4,-88,40,0,0
"7079","22",279,7,4,1,3,168,63,1,2,158,-29,2,2,5,-2,10,92,-1,0
"7080","22",224,8,2,1,2,140,49,3,3,180,67,2,1,5,-3,-40,-18,1,2
"7081","22",36,8,3,0,3,182,-81,3,3,105,38,2,2,5,-3,77,-119,1,1
"7082","22",356,6,4,1,1,129,0,1,1,104,72,1,2,5,-1,25,-72,0,-1
"7083","22",229,2,1,0,1,-240,161,-3,-3,-191,42,-2,-2,5,3,-49,119,-1,-1
"7084","22",202,4,1,1,1,38,-31,1,-1,-21,102,1,-1,5,1,59,-133,0,0
"7085","22",360,1,3,0,0,-95,-125,0,-4,164,161,2,-4,5,4,-259,-286,-2,0
"7086","22",357,6,4,1,2,87,-20,1,1,60,-78,1,1,5,-1,27,58,0,0
"7087","22",226,1,1,0,0,-103,1,-2,-4,191,0,2,-2,5,4,-294,1,-4,-2
"7088","22",361,1,1,0,0,-249,-2,0,-4,-1,242,4,2,5,4,-248,-244,-4,-6
"7089","22",354,1,1,0,0,-219,-232,-2,-4,144,147,2,3,5,4,-363,-379,-4,-7
"7090","22",358,1,4,1,2,248,201,0,-4,242,240,0,-4,5,4,6,-39,0,0
"7091","22",451,3,1,0,0,-194,-175,-2,-2,-206,-125,-3,-3,5,2,12,-50,1,1
"7092","22",228,8,4,1,2,24,79,3,3,-52,115,3,3,5,-3,76,-36,0,0
"7093","22",456,1,1,0,0,-221,-201,-2,-4,158,176,2,-1,5,4,-379,-377,-4,-3
"7094","22",452,5,3,0,1,-4,7,0,0,-4,4,0,0,5,0,0,3,0,0
"7095","22",294,8,1,0,3,0,0,3,3,246,0,3,3,5,-3,-246,0,0,0
"7096","22",290,1,1,0,1,-209,163,-4,-4,-212,67,-2,-4,5,4,3,96,-2,0
"7097","22",225,7,2,1,2,69,20,2,2,18,179,2,2,5,-2,51,-159,0,0
"7098","22",453,8,4,1,2,201,3,1,3,199,-6,2,2,5,-3,2,9,-1,1
"7099","22",295,5,1,0,1,4,3,0,0,-1,-2,0,0,5,0,5,5,0,0
"7100","22",280,6,2,1,1,14,-238,-1,1,232,-21,0,-1,5,-1,-218,-217,-1,2
"7101","22",203,9,4,1,3,-14,-55,4,4,-15,-236,4,4,5,-4,1,181,0,0
"7102","22",296,7,1,0,3,83,3,1,2,83,3,1,1,5,-2,0,0,0,1
"7103","22",207,1,1,0,0,-248,0,-4,-4,249,-1,4,4,5,4,-497,1,-8,-8
"7104","22",281,1,4,1,2,249,-42,-4,-4,5,-245,4,-4,5,4,244,203,-8,0
"7105","22",355,3,2,1,2,119,139,-2,-2,-1,72,-2,-2,5,2,120,67,0,0
"7106","22",29,1,4,1,0,-226,234,-4,-4,225,208,-3,-2,5,4,-451,26,-1,-2
"7107","22",282,9,3,1,3,72,-103,1,4,174,37,1,4,5,-4,-102,-140,0,0
"7108","22",205,9,1,0,2,225,6,4,4,-1,-221,3,3,5,-4,226,227,1,1
"7109","22",209,8,4,1,3,0,0,3,3,244,-1,3,3,5,-3,-244,1,0,0
"7110","22",457,1,3,0,1,-125,46,-4,-4,-122,-2,-1,-2,5,4,-3,48,-3,-2
"7111","22",283,6,1,0,1,-104,98,-3,1,-84,-119,-2,1,5,-1,-20,217,-1,0
"7112","22",206,4,4,1,0,-34,24,-2,-1,-47,33,-2,1,5,1,13,-9,0,-2
"7113","22",23,9,1,0,3,216,213,4,4,217,207,3,-4,5,-4,-1,6,1,8
"7114","22",458,2,1,0,1,-59,-52,0,-3,66,66,-1,-2,5,3,-125,-118,1,-1
"7115","22",454,7,4,1,3,217,0,2,2,207,4,2,2,5,-2,10,-4,0,0
"7116","22",288,8,2,1,2,96,64,1,3,72,9,1,2,5,-3,24,55,0,1
"7117","22",292,5,3,0,1,71,53,0,0,16,-5,0,0,5,0,55,58,0,0
"7118","22",204,5,3,1,1,28,-14,0,0,-152,-168,0,0,5,0,180,154,0,0
"7119","22",208,6,4,1,2,65,92,1,1,-4,-3,0,0,5,-1,69,95,1,1
"7120","22",22,6,3,0,1,220,14,1,1,240,-17,1,1,5,-1,-20,31,0,0
"7121","22",286,6,1,0,3,88,-9,1,1,63,-2,1,1,5,-1,25,-7,0,0
"7122","22",216,6,3,0,1,17,-7,0,1,-22,19,-1,1,5,-1,39,-26,1,0
"7123","22",220,4,4,1,2,130,108,-3,-1,167,143,-4,-4,5,1,-37,-35,1,3
"7124","22",284,1,3,0,1,-231,-189,0,-4,57,46,0,-2,5,4,-288,-235,0,-2
"7125","22",287,9,4,1,3,225,16,3,4,199,22,2,4,5,-4,26,-6,1,0
"7126","22",291,6,4,1,2,112,111,2,1,-7,-11,-1,0,5,-1,119,122,3,1
"7127","22",221,2,4,1,1,-249,38,-3,-3,-3,11,1,1,5,3,-246,27,-4,-4
"7128","22",289,1,1,1,3,-239,-21,-4,-4,226,224,3,3,5,4,-465,-245,-7,-7
"7129","22",211,3,3,0,1,-141,-132,-4,-2,91,103,2,-1,5,2,-232,-235,-6,-1
"7130","22",210,8,4,1,2,129,154,4,3,171,173,4,4,5,-3,-42,-19,0,-1
"7131","22",285,7,2,1,1,-76,-15,1,2,33,41,-2,1,5,-2,-109,-56,3,1
"7132","22",212,5,1,0,1,-64,17,0,0,-101,-48,2,-3,5,0,37,65,-2,3
"7133","22",214,9,1,0,3,198,1,2,4,187,4,2,4,5,-4,11,-3,0,0
"7134","22",215,2,1,0,0,-68,35,-2,-3,87,23,-2,-3,5,3,-155,12,0,0
"7135","22",21,6,4,1,2,43,38,1,1,113,123,2,-1,5,-1,-70,-85,-1,2
"7136","22",213,6,2,1,1,-47,5,0,1,-106,4,-1,0,5,-1,59,1,1,1
"7137","22",219,5,4,0,3,-1,-248,4,0,249,2,4,0,5,0,-250,-250,0,0
"7138","22",218,8,4,1,3,22,17,4,3,11,13,4,3,5,-3,11,4,0,0
"7139","22",222,2,1,0,0,-249,-4,-3,-3,-238,-2,-3,-3,5,3,-11,-2,0,0
"7140","22",217,4,4,1,2,77,35,1,-1,38,25,1,-3,5,1,39,10,0,2
"7141","23",409,6,4,1,2,66,83,1,1,120,134,2,2,4,-2,-54,-51,-1,-1
"7142","23",403,4,1,0,0,-2,-3,0,-1,-11,-26,1,-1,4,0,9,23,-1,0
"7143","23",408,3,1,0,0,-180,-1,-2,-2,-140,-92,1,-1,4,1,-40,91,-3,-1
"7144","23",407,7,2,1,2,195,5,2,2,168,26,3,3,4,-3,27,-21,-1,-1
"7145","23",412,9,1,0,0,-244,-38,-4,4,-239,-117,4,4,4,-5,-5,79,-8,0
"7146","23",416,1,4,1,0,-81,36,-4,-4,-231,218,-4,-4,4,3,150,-182,0,0
"7147","23",410,2,1,0,0,-192,-24,-2,-3,-216,-17,-3,-4,4,2,24,-7,1,1
"7148","23",411,9,2,1,2,247,240,4,4,226,229,4,4,4,-5,21,11,0,0
"7149","23",413,3,1,1,1,-224,-13,-2,-2,-246,0,-4,-4,4,1,22,-13,2,2
"7150","23",341,9,1,1,3,244,-10,4,4,246,-23,4,4,4,-5,-2,13,0,0
"7151","23",415,4,2,1,2,9,7,0,-1,161,208,0,4,4,0,-152,-201,0,-5
"7152","23",414,3,1,0,0,-136,-116,-2,-2,6,6,1,1,4,1,-142,-122,-3,-3
"7153","23",338,1,3,1,2,-218,-225,-4,-4,-222,-230,-4,-4,4,3,4,5,0,0
"7154","23",404,4,1,0,1,57,-51,-1,-1,58,-59,1,1,4,0,-1,8,-2,-2
"7155","23",335,6,2,0,1,-12,22,1,1,-34,4,0,0,4,-2,22,18,1,1
"7156","23",34,6,4,1,2,132,-101,1,1,116,-64,1,1,4,-2,16,-37,0,0
"7157","23",342,4,3,1,1,-100,-46,0,-1,-158,33,-1,-3,4,0,58,-79,1,2
"7158","23",405,6,4,1,1,-2,1,0,1,94,109,0,-1,4,-2,-96,-108,0,2
"7159","23",41,6,2,1,3,33,88,3,1,72,87,3,1,4,-2,-39,1,0,0
"7160","23",340,4,1,0,1,-80,-21,0,-1,83,15,0,0,4,0,-163,-36,0,-1
"7161","23",406,7,2,1,2,170,66,1,2,183,183,0,1,4,-3,-13,-117,1,1
"7162","23",418,4,2,1,2,138,48,1,-1,166,86,1,-2,4,0,-28,-38,0,1
"7163","23",421,6,3,1,1,3,10,0,1,0,0,0,0,4,-2,3,10,0,1
"7164","23",334,1,4,1,0,-241,103,-4,-4,-239,107,-4,-4,4,3,-2,-4,0,0
"7165","23",339,1,3,1,1,153,25,1,-4,-68,-62,-4,-4,4,3,221,87,5,0
"7166","23",172,7,2,1,3,41,87,2,2,122,127,2,2,4,-3,-81,-40,0,0
"7167","23",169,1,3,1,0,-201,223,-4,-4,-240,218,-4,-4,4,3,39,5,0,0
"7168","23",397,9,4,1,3,190,-1,2,4,135,73,0,2,4,-5,55,-74,2,2
"7169","23",42,3,3,1,1,2,-19,2,-2,-2,19,2,-2,4,1,4,-38,0,0
"7170","23",343,6,2,1,2,102,-3,1,1,144,5,2,2,4,-2,-42,-8,-1,-1
"7171","23",17,1,3,1,0,26,0,-1,-4,163,138,-1,-4,4,3,-137,-138,0,0
"7172","23",417,7,2,1,2,162,161,2,2,150,111,1,1,4,-3,12,50,1,1
"7173","23",420,8,4,1,3,-3,-64,2,3,-2,6,1,2,4,-4,-1,-70,1,1
"7174","23",344,6,4,1,3,-125,65,2,1,69,-51,-1,-1,4,-2,-194,116,3,2
"7175","23",337,9,2,1,3,242,239,4,4,242,-20,4,4,4,-5,0,259,0,0
"7176","23",271,6,3,1,1,29,5,1,1,210,0,4,4,4,-2,-181,5,-3,-3
"7177","23",345,4,1,0,0,-169,169,-4,-1,226,-216,-1,0,4,0,-395,385,-3,-1
"7178","23",419,6,4,1,3,195,108,1,1,174,132,2,1,4,-2,21,-24,-1,0
"7179","23",330,6,2,1,2,131,57,1,1,175,189,2,2,4,-2,-44,-132,-1,-1
"7180","23",422,3,3,1,1,-96,-239,4,-2,-96,-241,3,-1,4,1,0,2,1,-1
"7181","23",346,7,3,1,0,-245,-81,-3,2,232,17,0,3,4,-3,-477,-98,-3,-1
"7182","23",331,2,1,1,0,10,-69,-4,-3,21,-31,-4,-3,4,2,-11,-38,0,0
"7183","23",173,6,4,1,3,183,16,1,1,187,26,0,0,4,-2,-4,-10,1,1
"7184","23",400,5,4,1,2,28,-112,2,0,110,-130,0,0,4,-1,-82,18,2,0
"7185","23",336,3,4,1,3,-195,140,2,-2,223,138,3,-3,4,1,-418,2,-1,1
"7186","23",332,2,1,0,0,-242,98,-3,-3,-242,74,-3,-2,4,2,0,24,0,-1
"7187","23",174,6,4,1,3,2,31,1,1,165,90,0,0,4,-2,-163,-59,1,1
"7188","23",170,2,2,1,0,62,68,-3,-3,68,56,0,0,4,2,-6,12,-3,-3
"7189","23",399,7,4,1,3,110,-6,2,2,-42,16,1,1,4,-3,152,-22,1,1
"7190","23",175,6,4,1,1,13,-9,0,1,-5,64,1,-1,4,-2,18,-73,-1,2
"7191","23",269,6,4,1,2,223,159,1,1,250,159,1,1,4,-2,-27,0,0,0
"7192","23",272,6,4,1,2,65,-24,1,1,138,126,2,3,4,-2,-73,-150,-1,-2
"7193","23",265,6,1,0,3,95,0,0,1,-1,1,0,0,4,-2,96,-1,0,1
"7194","23",40,6,1,0,2,110,-56,2,1,171,-69,3,-1,4,-2,-61,13,-1,2
"7195","23",27,5,2,1,2,53,67,1,0,70,95,1,0,4,-1,-17,-28,0,0
"7196","23",266,5,1,0,1,-1,0,0,0,1,-1,0,0,4,-1,-2,1,0,0
"7197","23",423,7,1,1,3,21,-80,1,2,-146,-174,3,0,4,-3,167,94,-2,2
"7198","23",398,9,4,1,2,247,247,4,4,245,243,4,4,4,-5,2,4,0,0
"7199","23",270,5,3,0,1,0,5,0,0,95,3,2,1,4,-1,-95,2,-2,-1
"7200","23",267,5,3,1,1,-31,-4,-1,0,82,-12,1,1,4,-1,-113,8,-2,-1
"7201","23",401,4,2,1,1,-27,14,0,-1,78,9,-1,-1,4,0,-105,5,1,0
"7202","23",348,2,3,0,1,-61,3,0,-3,40,40,0,-2,4,2,-101,-37,0,-1
"7203","23",333,4,4,1,1,39,-1,-1,-1,66,-48,1,1,4,0,-27,47,-2,-2
"7204","23",171,5,1,1,1,-10,14,0,0,35,17,0,0,4,-1,-45,-3,0,0
"7205","23",4,7,3,1,1,152,0,2,2,241,241,-1,2,4,-3,-89,-241,3,0
"7206","23",168,6,1,0,3,97,-84,0,1,87,-70,-1,1,4,-2,10,-14,1,0
"7207","23",176,7,1,0,1,-59,1,-1,2,200,77,-2,0,4,-3,-259,-76,1,2
"7208","23",108,9,2,1,3,223,54,4,4,221,229,4,4,4,-5,2,-175,0,0
"7209","23",104,1,1,1,0,244,4,4,-4,242,2,1,-4,4,3,2,2,3,0
"7210","23",12,9,4,1,3,0,2,4,4,-1,1,4,4,4,-5,1,1,0,0
"7211","23",347,8,1,1,3,194,-81,2,3,158,-97,2,2,4,-4,36,16,0,1
"7212","23",109,1,1,0,1,1,-202,2,-4,3,-199,2,-4,4,3,-2,-3,0,0
"7213","23",105,1,1,0,0,-199,-35,-4,-4,-171,-35,-3,-4,4,3,-28,0,-1,0
"7214","23",424,4,2,1,2,38,48,1,-1,72,106,1,1,4,0,-34,-58,0,-2
"7215","23",113,5,2,0,2,-111,43,0,0,26,59,1,1,4,-1,-137,-16,-1,-1
"7216","23",167,4,1,0,3,-110,53,1,-1,-132,93,-2,-2,4,0,22,-40,3,1
"7217","23",373,1,3,1,0,-208,-22,0,-4,-239,-39,1,-3,4,3,31,17,-1,-1
"7218","23",297,1,3,1,2,-234,26,1,-4,235,201,4,4,4,3,-469,-175,-3,-8
"7219","23",110,7,1,0,1,-85,53,-4,2,91,47,3,0,4,-3,-176,6,-7,2
"7220","23",119,6,3,1,3,159,70,2,1,-106,136,0,0,4,-2,265,-66,2,1
"7221","23",395,8,3,1,1,229,23,-2,3,195,33,-2,3,4,-4,34,-10,0,0
"7222","23",273,5,1,1,0,-53,-1,0,0,113,8,2,1,4,-1,-166,-9,-2,-1
"7223","23",55,5,4,1,1,-15,-6,0,0,-4,25,0,0,4,-1,-11,-31,0,0
"7224","23",112,7,4,1,3,182,-180,-3,2,13,248,4,4,4,-3,169,-428,-7,-2
"7225","23",396,1,1,0,1,-242,244,4,-4,239,-246,-4,4,4,3,-481,490,8,-8
"7226","23",274,7,4,1,2,119,85,2,2,126,130,2,2,4,-3,-7,-45,0,0
"7227","23",120,3,3,1,1,-152,-51,-2,-2,-166,-171,-3,-3,4,1,14,120,1,1
"7228","23",101,2,3,1,0,-214,217,-3,-3,233,237,-3,-3,4,2,-447,-20,0,0
"7229","23",11,7,4,1,1,-41,57,0,2,54,159,2,1,4,-3,-95,-102,-2,1
"7230","23",268,7,4,1,3,93,119,2,2,158,54,3,2,4,-3,-65,65,-1,0
"7231","23",402,4,3,1,0,-246,1,-1,-1,-234,0,-3,-3,4,0,-12,1,2,2
"7232","23",349,4,4,1,1,-63,-31,0,-1,71,-68,1,2,4,0,-134,37,-1,-3
"7233","23",107,3,2,1,3,-127,88,3,-2,-133,55,-1,2,4,1,6,33,4,-4
"7234","23",111,1,1,0,0,-183,-117,-2,-4,-98,30,-1,1,4,3,-85,-147,-1,-5
"7235","23",59,4,1,0,0,-182,36,-1,-1,-15,-94,1,1,4,0,-167,130,-2,-2
"7236","23",249,1,3,1,0,-133,-148,-2,-4,124,-85,2,-4,4,3,-257,-63,-4,0
"7237","23",177,1,4,1,1,46,182,-4,-4,94,166,-4,-4,4,3,-48,16,0,0
"7238","23",116,6,2,1,3,120,-16,1,1,121,-23,1,1,4,-2,-1,7,0,0
"7239","23",6,6,4,1,2,126,0,1,1,104,0,1,1,4,-2,22,0,0,0
"7240","23",56,3,3,1,1,42,-126,-2,-2,51,-122,-2,-1,4,1,-9,-4,0,-1
"7241","23",48,1,3,1,0,35,-34,-4,-4,75,-78,-4,-4,4,3,-40,44,0,0
"7242","23",473,5,3,0,0,-135,-29,0,0,-228,-16,-2,-2,4,-1,93,-13,2,2
"7243","23",106,5,2,1,1,31,41,0,0,-50,-50,-1,-1,4,-1,81,91,1,1
"7244","23",425,6,4,1,2,10,23,1,1,15,64,1,1,4,-2,-5,-41,0,0
"7245","23",114,2,4,1,1,5,7,1,-3,82,100,1,-3,4,2,-77,-93,0,0
"7246","23",276,7,4,1,3,241,-1,2,2,189,3,2,2,4,-3,52,-4,0,0
"7247","23",374,6,4,1,2,104,22,1,1,170,48,2,2,4,-2,-66,-26,-1,-1
"7248","23",298,1,1,0,0,-132,11,-1,-4,-35,12,-1,-2,4,3,-97,-1,0,-2
"7249","23",313,2,3,1,0,-32,-27,-3,-3,-242,-234,-4,-4,4,2,210,207,1,1
"7250","23",245,1,1,0,0,-221,48,-3,-4,-137,9,-2,-3,4,3,-84,39,-1,-1
"7251","23",100,9,4,1,3,240,4,4,4,185,3,3,4,4,-5,55,1,1,0
"7252","23",299,7,4,0,1,214,-49,2,2,28,217,2,2,4,-3,186,-266,0,0
"7253","23",25,3,4,1,2,-25,-19,-2,-2,10,39,-1,-1,4,1,-35,-58,-1,-1
"7254","23",246,8,4,1,3,200,2,3,3,213,-1,3,2,4,-4,-13,3,0,1
"7255","23",117,1,4,1,2,-41,1,-4,-4,234,203,-4,-1,4,3,-275,-202,0,-3
"7256","23",275,4,4,1,2,0,243,2,-1,1,239,3,3,4,0,-1,4,-1,-4
"7257","23",121,1,1,0,0,-176,3,-4,-4,243,-49,-1,-4,4,3,-419,52,-3,0
"7258","23",102,9,4,1,3,148,30,3,4,-31,85,3,4,4,-5,179,-55,0,0
"7259","23",312,5,4,1,1,-87,121,0,0,-94,93,3,0,4,-1,7,28,-3,0
"7260","23",122,9,1,0,0,180,201,4,4,-77,-42,0,0,4,-5,257,243,4,4
"7261","23",115,5,3,1,3,76,-2,0,0,68,-1,-1,0,4,-1,8,-1,1,0
"7262","23",35,4,1,1,3,20,188,3,-1,144,183,3,-1,4,0,-124,5,0,0
"7263","23",31,9,1,0,0,68,84,4,4,-141,113,-4,-4,4,-5,209,-29,8,8
"7264","23",375,5,3,1,1,-2,0,0,0,-2,0,0,0,4,-1,0,0,0,0
"7265","23",241,5,4,1,2,188,137,2,0,188,166,2,0,4,-1,0,-29,0,0
"7266","23",314,1,4,1,1,-244,10,4,-4,-245,5,4,-4,4,3,1,5,0,0
"7267","23",310,7,4,1,2,145,-21,2,2,220,120,3,4,4,-3,-75,-141,-1,-2
"7268","23",186,5,2,1,2,-2,4,0,0,90,114,0,0,4,-1,-92,-110,0,0
"7269","23",60,8,1,1,3,209,0,3,3,237,-9,3,3,4,-4,-28,9,0,0
"7270","23",57,1,4,1,1,110,-133,-1,-4,151,-90,-4,-4,4,3,-41,-43,3,0
"7271","23",49,7,4,1,1,118,114,2,2,82,37,0,0,4,-3,36,77,2,2
"7272","23",474,1,1,1,0,-2,-93,-4,-4,0,-85,-4,-4,4,3,-2,-8,0,0
"7273","23",309,3,4,1,2,137,46,-1,-2,137,89,-1,-2,4,1,0,-43,0,0
"7274","23",426,6,4,1,3,0,-249,4,1,-4,244,4,3,4,-2,4,-493,0,-2
"7275","23",66,5,1,0,1,-162,2,1,0,139,-2,2,1,4,-1,-301,4,-1,-1
"7276","23",277,2,4,1,1,32,-89,4,-3,11,-6,3,-4,4,2,21,-83,1,1
"7277","23",123,3,4,1,2,-51,-28,-3,-2,29,-24,-2,-2,4,1,-80,-4,-1,0
"7278","23",185,5,4,1,2,47,-15,-1,0,113,-16,1,1,4,-1,-66,1,-2,-1
"7279","23",181,7,4,1,3,148,111,2,2,147,117,1,1,4,-3,1,-6,1,1
"7280","23",178,5,1,0,1,-3,4,0,0,0,-3,0,0,4,-1,-3,7,0,0
"7281","23",376,4,4,1,1,25,-130,-1,-1,-46,-124,-2,-2,4,0,71,-6,1,1
"7282","23",3,2,3,1,0,1,-5,-2,-3,0,0,-2,-2,4,2,1,-5,0,-1
"7283","23",250,6,1,0,3,57,27,1,1,85,26,1,1,4,-2,-28,1,0,0
"7284","23",247,4,3,0,0,-190,-10,-1,-1,212,-12,1,1,4,0,-402,2,-2,-2
"7285","23",118,5,3,1,1,-51,21,-2,0,-26,-17,-1,0,4,-1,-25,38,-1,0
"7286","23",251,2,3,1,1,-75,-79,2,-3,-3,-171,0,-2,4,2,-72,92,2,-1
"7287","23",248,8,4,1,3,46,229,3,3,52,223,3,3,4,-4,-6,6,0,0
"7288","23",103,6,2,1,3,55,0,1,1,13,-3,1,0,4,-2,42,3,0,1
"7289","23",62,9,2,1,3,215,205,4,4,228,212,2,4,4,-5,-13,-7,2,0
"7290","23",192,6,4,1,1,98,1,1,1,0,124,0,2,4,-2,98,-123,1,-1
"7291","23",427,3,4,1,1,89,13,2,-2,-210,-22,2,-2,4,1,299,35,0,0
"7292","23",350,5,4,1,1,-5,-246,3,0,245,0,3,1,4,-1,-250,-246,0,-1
"7293","23",278,1,4,1,1,72,191,4,-4,226,214,4,-4,4,3,-154,-23,0,0
"7294","23",124,6,1,0,3,208,4,2,1,-230,1,-3,-1,4,-2,438,3,5,2
"7295","23",242,3,4,1,2,70,31,1,-2,84,38,1,-2,4,1,-14,-7,0,0
"7296","23",315,9,3,1,3,238,29,4,4,247,27,4,4,4,-5,-9,2,0,0
"7297","23",311,1,2,1,2,144,7,3,-4,195,8,4,-4,4,3,-51,-1,-1,0
"7298","23",187,7,4,1,2,62,65,2,2,239,239,4,4,4,-3,-177,-174,-2,-2
"7299","23",61,1,1,0,3,245,3,4,-4,-95,2,4,-4,4,3,340,1,0,0
"7300","23",58,3,4,1,1,-246,-3,1,-2,247,0,4,4,4,1,-493,-3,-3,-6
"7301","23",5,6,2,1,2,71,26,1,1,10,33,1,1,4,-2,61,-7,0,0
"7302","23",475,5,3,1,3,95,-137,0,0,124,-154,1,0,4,-1,-29,17,-1,0
"7303","23",252,4,4,1,1,-129,-80,-2,-1,142,-91,1,1,4,0,-271,11,-3,-2
"7304","23",471,4,3,1,2,-184,146,2,-1,154,55,2,2,4,0,-338,91,0,-3
"7305","23",67,3,1,0,0,-27,20,-2,-2,134,-125,3,3,4,1,-161,145,-5,-5
"7306","23",63,4,4,1,1,-1,3,-1,-1,-1,3,0,0,4,0,0,0,-1,-1
"7307","23",193,1,1,0,0,-203,-44,-4,-4,-223,-35,-4,-4,4,3,20,-9,0,0
"7308","23",234,7,3,1,3,104,72,1,2,121,38,1,0,4,-3,-17,34,0,2
"7309","23",182,8,4,1,3,120,-31,2,3,1,-164,2,1,4,-4,119,133,0,2
"7310","23",179,5,1,1,1,-1,-3,0,0,-1,1,2,1,4,-1,0,-4,-2,-1
"7311","23",377,1,1,0,0,-244,8,-4,-4,-132,7,-4,-4,4,3,-112,1,0,0
"7312","23",30,7,2,1,2,139,-2,3,2,83,-2,3,3,4,-3,56,0,0,-1
"7313","23",45,1,3,1,0,52,-35,-1,-4,-126,114,-4,-4,4,3,178,-149,3,0
"7314","23",37,1,1,1,0,-212,24,-3,-4,-186,13,-3,-4,4,3,-26,11,0,0
"7315","23",244,4,4,1,2,42,-35,-1,-1,47,-40,1,1,4,0,-5,5,-2,-2
"7316","23",317,5,4,1,2,29,-27,0,0,2,-3,0,0,4,-1,27,-24,0,0
"7317","23",240,1,2,1,1,-219,31,2,-4,238,-227,-2,-2,4,3,-457,258,4,-2
"7318","23",189,3,1,0,1,-212,48,3,-2,-107,68,2,-3,4,1,-105,-20,1,1
"7319","23",233,7,2,1,2,47,38,2,2,150,105,2,2,4,-3,-103,-67,0,0
"7320","23",51,5,4,1,1,76,22,2,0,-172,137,0,1,4,-1,248,-115,2,-1
"7321","23",428,1,1,0,0,-239,-208,-4,-4,-228,-101,-4,-4,4,3,-11,-107,0,0
"7322","23",351,1,1,0,0,-218,-224,-4,-4,126,132,-4,-4,4,3,-344,-356,0,0
"7323","23",279,7,4,1,3,179,67,2,2,173,60,1,2,4,-3,6,7,1,0
"7324","23",125,5,4,1,0,-50,-27,-2,0,247,-244,-4,-3,4,-1,-297,217,2,3
"7325","23",243,4,2,1,2,235,103,2,-1,246,35,2,1,4,0,-11,68,0,-2
"7326","23",316,3,3,1,0,-165,-92,-2,-2,-212,-126,-2,-2,4,1,47,34,0,0
"7327","23",24,5,2,1,2,67,-1,0,0,242,-1,4,4,4,-1,-175,0,-4,-4
"7328","23",188,9,2,1,3,233,4,4,4,214,5,4,4,4,-5,19,-1,0,0
"7329","23",184,4,3,1,3,98,2,1,-1,98,2,3,1,4,0,0,0,-2,-2
"7330","23",180,8,2,1,2,63,-9,2,3,119,1,2,3,4,-4,-56,-10,0,0
"7331","23",50,3,2,1,1,46,-20,0,-2,199,-27,2,-2,4,1,-153,7,-2,0
"7332","23",476,4,3,1,0,-127,-169,-1,-1,182,181,-1,-1,4,0,-309,-350,0,0
"7333","23",253,8,3,0,3,241,-20,3,3,230,239,4,4,4,-4,11,-259,-1,-1
"7334","23",472,1,1,0,0,-228,46,-4,-4,-223,137,-4,-4,4,3,-5,-91,0,0
"7335","23",68,2,4,1,0,33,2,0,-3,162,-1,0,-2,4,2,-129,3,0,-1
"7336","23",64,9,1,0,1,217,-203,4,4,-222,1,4,4,4,-5,439,-204,0,0
"7337","23",194,8,1,0,0,-182,9,-4,3,-191,11,-4,3,4,-4,9,-2,0,0
"7338","23",235,9,3,1,0,249,0,4,4,-109,0,-1,-1,4,-5,358,0,5,5
"7339","23",183,4,4,1,1,34,48,1,-1,50,51,1,-1,4,0,-16,-3,0,0
"7340","23",18,5,3,0,1,-91,-41,1,0,52,25,1,0,4,-1,-143,-66,0,0
"7341","23",378,3,4,1,1,-90,-8,-2,-2,-163,-6,-3,-3,4,1,73,-2,1,1
"7342","23",300,2,1,0,0,-205,25,-2,-3,22,23,1,1,4,2,-227,2,-3,-4
"7343","23",450,6,4,0,3,149,3,1,1,-1,2,0,1,4,-2,150,1,1,0
"7344","23",370,1,1,0,3,-235,-14,-4,-4,47,62,0,-4,4,3,-282,-76,-4,0
"7345","23",321,1,1,1,0,-121,-110,-4,-4,-1,-2,0,0,4,3,-120,-108,-4,-4
"7346","23",318,5,2,1,2,-36,-183,-4,0,182,-187,-4,0,4,-1,-218,4,0,0
"7347","23",464,6,1,0,1,59,17,0,1,-1,57,0,1,4,-2,60,-40,0,0
"7348","23",19,5,2,1,2,108,66,1,0,97,-52,1,-1,4,-1,11,118,0,1
"7349","23",384,3,1,0,0,-50,0,-2,-2,1,66,-3,-3,4,1,-51,-66,1,1
"7350","23",52,2,3,1,0,-212,0,-3,-3,-2,-156,-2,-1,4,2,-210,156,-1,-2
"7351","23",429,1,2,1,0,0,0,0,-4,91,25,0,-4,4,3,-91,-25,0,0
"7352","23",352,4,2,1,1,11,-25,0,-1,13,-44,0,-1,4,0,-2,19,0,0
"7353","23",28,4,4,1,1,-26,-20,-1,-1,7,7,-1,-1,4,0,-33,-27,0,0
"7354","23",126,3,2,1,2,41,206,-1,-2,42,153,-1,-2,4,1,-1,53,0,0
"7355","23",7,7,1,0,3,92,65,1,2,-66,87,2,1,4,-3,158,-22,-1,1
"7356","23",2,5,4,1,1,-88,-54,-1,0,70,-91,1,0,4,-1,-158,37,-2,0
"7357","23",196,1,3,1,0,-142,-179,-3,-4,231,244,4,4,4,3,-373,-423,-7,-8
"7358","23",237,6,2,1,2,58,1,-1,1,179,1,-2,1,4,-2,-121,0,1,0
"7359","23",387,4,3,1,1,151,126,0,-1,131,135,2,1,4,0,20,-9,-2,-2
"7360","23",38,9,4,1,3,0,0,4,4,248,-29,4,4,4,-5,-248,29,0,0
"7361","23",261,7,1,1,3,-55,-42,2,2,162,189,4,4,4,-3,-217,-231,-2,-2
"7362","23",258,1,3,0,0,46,1,-4,-4,-103,1,-4,-4,4,3,149,0,0,0
"7363","23",254,4,2,1,3,96,-32,-3,-1,164,-167,-3,-1,4,0,-68,135,0,0
"7364","23",327,6,4,1,3,98,89,3,1,16,61,1,0,4,-2,82,28,2,1
"7365","23",69,6,4,1,1,53,230,2,1,175,41,1,1,4,-2,-122,189,1,0
"7366","23",65,7,1,0,3,-45,22,1,2,-80,25,2,2,4,-3,35,-3,-1,0
"7367","23",195,2,1,0,1,-174,163,3,-3,25,-21,2,0,4,2,-199,184,1,-3
"7368","23",236,5,1,0,1,30,-28,0,0,17,-22,0,0,4,-1,13,-6,0,0
"7369","23",232,1,1,0,0,-7,-52,-1,-4,-176,-32,0,-4,4,3,169,-20,-1,0
"7370","23",379,2,3,1,1,-66,37,1,-3,177,124,2,1,4,2,-243,-87,-1,-4
"7371","23",305,9,4,1,3,237,230,4,4,240,245,4,4,4,-5,-3,-15,0,0
"7372","23",301,4,4,1,1,-41,1,-1,-1,-68,-1,-1,-2,4,0,27,2,0,1
"7373","23",451,2,1,0,0,-161,-128,-3,-3,-138,-124,-2,-2,4,2,-23,-4,-1,-1
"7374","23",371,1,3,1,0,-186,-179,-1,-4,55,-161,-1,0,4,3,-241,-18,0,-4
"7375","23",322,6,4,1,3,32,-31,1,1,240,-235,3,3,4,-2,-208,204,-2,-2
"7376","23",319,6,1,0,1,5,-76,2,1,-117,-1,4,3,4,-2,122,-75,-2,-2
"7377","23",465,7,4,1,3,228,23,3,2,3,-229,2,2,4,-3,225,252,1,0
"7378","23",190,7,4,1,3,213,158,2,2,195,177,2,2,4,-3,18,-19,0,0
"7379","23",385,4,4,1,1,23,-38,1,-1,111,-111,1,1,4,0,-88,73,0,-2
"7380","23",53,7,4,1,3,-4,65,2,2,223,0,2,2,4,-3,-227,65,0,0
"7381","23",43,1,3,1,0,-250,11,-3,-4,44,-1,-1,-4,4,3,-294,12,-2,0
"7382","23",353,1,2,1,2,244,202,-4,-4,228,220,-4,-2,4,3,16,-18,0,-2
"7383","23",280,4,2,1,1,62,-57,-1,-1,-44,38,-1,1,4,0,106,-95,0,-2
"7384","23",127,3,1,1,0,-106,-1,-1,-2,-51,1,-2,-2,4,1,-55,-2,1,0
"7385","23",70,3,2,1,2,84,176,-1,-2,202,210,0,-1,4,1,-118,-34,-1,-1
"7386","23",20,9,3,1,0,-78,-67,-3,4,237,232,4,4,4,-5,-315,-299,-7,0
"7387","23",197,3,4,1,3,-239,82,4,-2,-239,-30,2,0,4,1,0,112,2,-2
"7388","23",238,2,3,1,1,3,4,-1,-3,-140,74,-4,-4,4,2,143,-70,3,1
"7389","23",388,1,4,0,0,-228,-1,-4,-4,-233,-2,-1,-1,4,3,5,1,-3,-3
"7390","23",380,1,4,1,1,54,-38,3,-4,-211,-50,3,-2,4,3,265,12,0,-2
"7391","23",262,7,4,1,3,32,41,1,2,71,49,1,1,4,-3,-39,-8,0,1
"7392","23",259,1,3,1,1,-169,55,4,-4,1,3,4,-4,4,3,-170,52,0,0
"7393","23",255,6,3,1,1,119,81,1,1,63,-111,0,0,4,-2,56,192,1,1
"7394","23",328,6,3,1,1,11,6,1,1,40,13,1,1,4,-2,-29,-7,0,0
"7395","23",324,2,2,1,0,54,6,-4,-3,96,1,-4,-4,4,2,-42,5,0,1
"7396","23",320,8,2,1,2,229,132,3,3,212,155,3,3,4,-4,17,-23,0,0
"7397","23",467,5,1,1,3,-34,28,4,0,57,-34,4,-3,4,-1,-91,62,0,3
"7398","23",463,9,4,1,3,237,16,2,4,-219,-9,1,0,4,-5,456,25,1,4
"7399","23",390,7,2,1,2,165,139,2,2,-12,-239,0,-4,4,-3,177,378,2,6
"7400","23",383,5,4,1,1,0,-1,0,0,0,2,0,0,4,-1,0,-3,0,0
"7401","23",306,4,3,1,3,94,91,1,-1,126,177,1,0,4,0,-32,-86,0,-1
"7402","23",302,3,1,1,0,-26,-20,-3,-2,208,64,-2,-2,4,1,-234,-84,-1,0
"7403","23",452,2,3,1,1,-146,4,-2,-3,9,-50,0,0,4,2,-155,54,-2,-3
"7404","23",372,1,3,1,0,-116,-91,0,-4,131,116,-1,-2,4,3,-247,-207,1,-2
"7405","23",323,5,4,1,1,-4,-229,0,0,235,0,4,-4,4,-1,-239,-229,-4,4
"7406","23",32,1,1,0,1,-176,-44,2,-4,150,-166,2,-2,4,3,-326,122,0,-2
"7407","23",466,4,3,0,0,-130,-105,-1,-1,82,-106,2,2,4,0,-212,1,-3,-3
"7408","23",191,3,1,0,0,-209,-35,-2,-2,-207,-29,-3,-3,4,1,-2,-6,1,1
"7409","23",386,2,1,0,0,-171,-41,-1,-3,218,218,4,3,4,2,-389,-259,-5,-6
"7410","23",54,1,4,1,1,-35,-1,-1,-4,113,38,-3,0,4,3,-148,-39,2,-4
"7411","23",430,5,2,1,1,54,-47,0,0,164,-81,1,-2,4,-1,-110,34,-1,2
"7412","23",354,3,1,1,0,-38,116,-1,-2,171,100,2,3,4,1,-209,16,-3,-5
"7413","23",281,1,4,1,2,0,0,-4,-4,-1,-243,-4,-4,4,3,1,243,0,0
"7414","23",128,6,1,0,3,99,34,1,1,134,-115,1,1,4,-2,-35,149,0,0
"7415","23",71,4,3,1,1,-85,15,-1,-1,30,31,-1,0,4,0,-115,-16,0,-1
"7416","23",200,2,3,1,0,-53,12,-3,-3,-226,-36,-4,-4,4,2,173,48,1,1
"7417","23",198,4,1,1,1,-74,56,0,-1,78,80,1,3,4,0,-152,-24,-1,-4
"7418","23",239,3,1,0,1,116,-138,1,-2,108,160,2,2,4,1,8,-298,-1,-4
"7419","23",389,1,3,1,2,231,4,-4,-4,-177,2,0,-1,4,3,408,2,-4,-3
"7420","23",381,7,2,1,2,204,192,2,2,198,210,3,3,4,-3,6,-18,-1,-1
"7421","23",263,3,4,1,0,-194,4,-2,-2,-150,-1,-2,-2,4,1,-44,5,0,0
"7422","23",26,1,1,0,0,-210,17,-4,-4,-174,31,-4,-4,4,3,-36,-14,0,0
"7423","23",256,5,3,0,1,-97,-1,0,0,120,107,1,1,4,-1,-217,-108,-1,-1
"7424","23",329,7,4,1,3,48,-56,1,2,-193,15,2,2,4,-3,241,-71,-1,0
"7425","23",325,8,1,1,1,-39,-29,0,3,-18,-17,0,4,4,-4,-21,-12,0,-1
"7426","23",1,5,1,0,1,-61,-16,-1,0,22,25,-1,-1,4,-1,-83,-41,0,1
"7427","23",468,6,1,0,3,112,-6,1,1,199,52,1,1,4,-2,-87,-58,0,0
"7428","23",391,5,2,1,3,146,151,0,0,129,151,0,-1,4,-1,17,0,0,1
"7429","23",44,4,2,1,2,212,169,0,-1,222,162,0,1,4,0,-10,7,0,-2
"7430","23",165,4,1,0,1,84,13,0,-1,73,50,1,1,4,0,11,-37,-1,-2
"7431","23",307,8,4,1,2,0,0,3,3,245,-165,3,3,4,-4,-245,165,0,0
"7432","23",303,4,3,1,2,13,-61,-1,-1,-17,-26,2,2,4,0,30,-35,-3,-3
"7433","23",453,7,4,1,2,184,-1,3,2,197,-2,3,3,4,-3,-13,1,0,-1
"7434","23",230,7,1,0,0,-182,68,-3,2,-112,51,-3,2,4,-3,-70,17,0,0
"7435","23",98,1,3,1,0,-80,58,-4,-4,225,225,4,4,4,3,-305,-167,-8,-8
"7436","23",366,7,4,1,3,159,-69,4,2,145,54,2,3,4,-3,14,-123,2,-1
"7437","23",362,3,4,1,3,-71,-89,4,-2,151,133,2,-1,4,1,-222,-222,2,-1
"7438","23",394,1,3,0,0,-100,-85,-4,-4,-248,249,-4,-4,4,3,148,-334,0,0
"7439","23",439,6,2,1,1,-10,-1,1,1,4,-3,0,0,4,-2,-14,2,1,1
"7440","23",87,7,4,1,3,-2,186,1,2,6,-194,1,1,4,-3,-8,380,0,1
"7441","23",431,5,3,1,0,17,20,0,0,-2,2,0,0,4,-1,19,18,0,0
"7442","23",355,4,2,1,2,27,51,-2,-1,-2,97,-2,-2,4,0,29,-46,0,1
"7443","23",282,9,3,1,3,105,-117,2,4,103,59,1,4,4,-5,2,-176,1,0
"7444","23",129,3,4,1,1,-116,-3,-2,-2,-229,0,-2,-2,4,1,113,-3,0,0
"7445","23",72,4,1,1,0,17,15,0,-1,152,170,2,2,4,0,-135,-155,-2,-3
"7446","23",201,1,3,1,1,-17,-2,1,-4,42,2,0,-3,4,3,-59,-4,1,-1
"7447","23",199,8,4,1,2,217,150,3,3,156,64,1,1,4,-4,61,86,2,2
"7448","23",462,9,3,0,3,-2,132,4,4,212,212,-4,-4,4,-5,-214,-80,8,8
"7449","23",39,3,3,0,1,-152,3,-1,-2,163,-191,3,0,4,1,-315,194,-4,-2
"7450","23",382,5,4,1,2,94,-14,0,0,94,-7,1,1,4,-1,0,-7,-1,-1
"7451","23",264,4,4,1,2,137,46,-1,-1,233,233,0,-1,4,0,-96,-187,-1,0
"7452","23",260,2,3,1,0,-210,-218,-3,-3,-218,-213,-2,-2,4,2,8,-5,-1,-1
"7453","23",257,1,1,0,0,130,-67,2,-4,116,93,2,-4,4,3,14,-160,0,0
"7454","23",33,5,3,1,1,-76,36,0,0,33,-52,0,2,4,-1,-109,88,0,-2
"7455","23",326,7,4,1,2,135,79,2,2,154,77,2,2,4,-3,-19,2,0,0
"7456","23",10,5,3,0,1,-23,-3,-1,0,-242,1,-3,-3,4,-1,219,-4,2,3
"7457","23",469,2,4,1,0,16,60,-3,-3,69,71,-3,-3,4,2,-53,-11,0,0
"7458","23",392,2,1,1,0,-222,193,-3,-3,-129,-105,-1,-1,4,2,-93,298,-2,-2
"7459","23",440,4,3,1,0,-18,1,-1,-1,-48,2,-3,-3,4,0,30,-1,2,2
"7460","23",166,2,4,1,2,198,191,-3,-3,182,171,-2,-2,4,2,16,20,-1,-1
"7461","23",308,1,4,1,0,-247,-247,-4,-4,246,247,4,4,4,3,-493,-494,-8,-8
"7462","23",304,6,2,1,2,-40,-37,1,1,54,-20,-1,-1,4,-2,-94,-17,2,2
"7463","23",454,7,4,1,3,178,1,2,2,178,1,2,2,4,-3,0,0,0,0
"7464","23",231,6,4,1,0,-2,0,-4,1,-97,-101,-4,2,4,-2,95,101,0,-1
"7465","23",99,7,4,1,3,217,-16,2,2,220,-18,2,2,4,-3,-3,2,0,0
"7466","23",367,4,3,1,1,-15,-13,2,-1,-210,-80,2,-1,4,0,195,67,0,0
"7467","23",363,8,3,1,3,249,1,3,3,-229,2,-3,-3,4,-4,478,-1,6,6
"7468","23",443,3,1,0,0,-84,-30,-2,-2,54,50,0,0,4,1,-138,-80,-2,-2
"7469","23",95,6,4,1,2,37,7,1,1,0,-100,1,1,4,-2,37,107,0,0
"7470","23",88,9,4,1,2,229,54,4,4,228,-223,4,4,4,-5,1,277,0,0
"7471","23",432,4,2,1,1,39,-32,-1,-1,56,-77,0,0,4,0,-17,45,-1,-1
"7472","23",356,5,4,1,1,41,1,1,0,63,1,1,1,4,-1,-22,0,0,-1
"7473","23",283,6,1,0,1,-122,-91,-3,1,-112,-103,-2,1,4,-2,-10,12,-1,0
"7474","23",13,2,4,1,1,45,-84,-1,-3,-43,-90,-1,-3,4,2,88,6,0,0
"7475","23",73,6,4,1,2,108,-123,-1,1,133,-92,-1,1,4,-2,-25,-31,0,0
"7476","23",202,4,1,0,1,-8,9,-2,-1,-20,56,-2,1,4,0,12,-47,0,-2
"7477","23",470,4,1,0,1,-66,13,-1,-1,85,14,1,-1,4,0,-151,-1,-2,0
"7478","23",442,6,4,1,1,-28,26,-1,1,23,24,1,1,4,-2,-51,2,-2,0
"7479","23",94,3,4,1,1,51,-91,-1,-2,139,139,-1,3,4,1,-88,-230,0,-5
"7480","23",90,1,4,0,0,-227,29,-4,-4,226,19,4,4,4,3,-453,10,-8,-8
"7481","23",435,4,4,1,1,155,-83,0,-1,-1,-6,0,0,4,0,156,-77,0,-1
"7482","23",46,3,1,0,0,-39,-243,-3,-2,-99,-240,-4,-3,4,1,60,-3,1,1
"7483","23",456,1,1,0,0,-205,-198,-2,-4,128,129,1,-3,4,3,-333,-327,-3,-1
"7484","23",160,6,2,1,0,-134,19,-4,1,-73,32,-4,2,4,-2,-61,-13,0,-1
"7485","23",157,1,3,1,2,-66,-54,-3,-4,174,75,-2,0,4,3,-240,-129,-1,-4
"7486","23",369,3,4,0,0,-22,1,-2,-2,161,0,2,1,4,1,-183,1,-4,-3
"7487","23",47,6,4,1,3,202,18,2,1,2,-2,1,2,4,-2,200,20,1,-1
"7488","23",393,1,1,0,0,-153,-77,-4,-4,114,-136,0,-4,4,3,-267,59,-4,0
"7489","23",441,9,4,1,2,32,-223,3,4,41,-228,3,3,4,-5,-9,5,0,1
"7490","23",9,4,4,1,2,19,14,1,-1,40,14,1,-1,4,0,-21,0,0,0
"7491","23",434,7,4,1,3,78,-39,2,2,80,-102,2,2,4,-3,-2,63,0,0
"7492","23",459,1,3,1,1,-141,-160,-1,-4,34,-34,2,-4,4,3,-175,-126,-3,0
"7493","23",455,3,2,1,2,-104,-3,-2,-2,240,4,3,3,4,1,-344,-7,-5,-5
"7494","23",16,2,1,0,0,-204,146,1,-3,64,17,1,-2,4,2,-268,129,0,-1
"7495","23",156,5,2,1,1,14,10,0,0,82,44,1,1,4,-1,-68,-34,-1,-1
"7496","23",368,1,3,0,3,-102,-112,-4,-4,-149,111,4,4,4,3,47,-223,-8,-8
"7497","23",364,5,3,1,1,-4,-78,0,0,-56,4,0,-1,4,-1,52,-82,0,1
"7498","23",444,5,2,1,2,9,1,1,0,169,-4,2,0,4,-1,-160,5,-1,0
"7499","23",96,4,1,0,0,-217,4,-3,-1,-17,-4,-1,-1,4,0,-200,8,-2,0
"7500","23",89,1,3,1,0,-244,0,-2,-4,-248,3,-4,-2,4,3,4,-3,2,-2
"7501","23",433,2,1,0,0,-149,-149,2,-3,189,172,3,-3,4,2,-338,-321,-1,0
"7502","23",357,6,4,1,2,132,43,1,1,132,112,1,1,4,-2,0,-69,0,0
"7503","23",284,1,3,1,1,173,125,-3,-4,62,69,0,1,4,3,111,56,-3,-5
"7504","23",130,9,1,0,3,166,32,4,4,120,61,4,4,4,-5,46,-29,0,0
"7505","23",74,3,3,1,0,-171,-53,-3,-2,-244,0,-4,-4,4,1,73,-53,1,2
"7506","23",203,9,4,1,3,238,15,4,4,231,10,4,4,4,-5,7,5,0,0
"7507","23",447,7,4,1,2,91,151,2,2,177,85,2,2,4,-3,-86,66,0,0
"7508","23",155,5,2,1,1,0,-6,0,0,46,-12,1,0,4,-1,-46,6,-1,0
"7509","23",359,9,4,1,3,237,12,4,4,234,12,4,4,4,-5,3,0,0,0
"7510","23",91,7,2,1,3,243,0,2,2,243,1,0,0,4,-3,0,-1,2,2
"7511","23",436,1,4,1,3,13,-20,-1,-4,-19,11,3,-2,4,3,32,-31,-4,-2
"7512","23",460,3,1,0,0,-149,9,-2,-2,210,55,-3,1,4,1,-359,-46,1,-3
"7513","23",457,2,3,1,1,-224,0,-4,-3,131,-198,1,0,4,2,-355,198,-5,-3
"7514","23",161,2,2,1,2,117,68,1,-3,97,74,1,-3,4,2,20,-6,0,0
"7515","23",158,4,3,1,0,-42,-19,-1,-1,-34,-22,1,0,4,0,-8,3,-2,-1
"7516","23",206,2,4,1,0,-78,31,-2,-3,170,135,1,1,4,2,-248,-104,-3,-4
"7517","23",446,5,4,1,1,90,30,0,0,20,31,0,0,4,-1,70,-1,0,0
"7518","23",154,5,4,1,3,29,-18,0,0,-44,-21,0,0,4,-1,73,3,0,0
"7519","23",358,1,4,1,2,247,234,0,-4,249,246,0,-4,4,3,-2,-12,0,0
"7520","23",150,5,3,1,1,164,5,-1,0,-3,-34,0,0,4,-1,167,39,-1,0
"7521","23",143,7,1,1,3,176,37,2,2,213,6,2,2,4,-3,-37,31,0,0
"7522","23",75,2,4,1,2,233,36,3,-3,239,27,2,-4,4,2,-6,9,1,1
"7523","23",286,6,1,0,3,81,5,1,1,44,0,1,1,4,-2,37,5,0,0
"7524","23",132,5,4,1,1,9,-219,-1,0,2,-36,2,1,4,-1,7,-183,-3,-1
"7525","23",76,5,4,1,3,17,1,0,0,8,1,0,0,4,-1,9,0,0,0
"7526","23",205,5,1,0,2,151,1,0,0,196,-4,4,4,4,-1,-45,5,-4,-4
"7527","23",365,1,3,1,1,-220,-2,0,-4,-249,6,0,-4,4,3,29,-8,0,0
"7528","23",445,6,4,1,3,101,-38,1,1,116,-77,1,1,4,-2,-15,39,0,0
"7529","23",97,2,1,1,1,-77,49,1,-3,208,182,3,1,4,2,-285,-133,-2,-4
"7530","23",93,6,1,0,1,-81,41,-2,1,-149,109,-2,0,4,-2,68,-68,0,1
"7531","23",438,7,4,1,3,146,1,1,2,190,-2,4,2,4,-3,-44,3,-3,0
"7532","23",159,2,3,1,2,-3,-218,-1,-3,225,1,3,3,4,2,-228,-219,-4,-6
"7533","23",285,6,2,1,1,-81,33,-2,1,72,30,1,1,4,-2,-153,3,-3,0
"7534","23",131,5,4,1,3,-101,60,4,0,121,-56,-1,3,4,-1,-222,116,5,-3
"7535","23",147,6,2,1,3,125,-168,2,1,136,132,2,0,4,-2,-11,-300,0,1
"7536","23",204,4,3,1,1,-106,-123,-1,-1,166,-223,0,0,4,0,-272,100,-1,-1
"7537","23",448,4,2,1,2,56,0,1,-1,242,-1,0,0,4,0,-186,1,1,-1
"7538","23",144,4,3,1,0,-132,4,3,-1,88,14,2,1,4,0,-220,-10,1,-2
"7539","23",36,3,3,1,3,-168,197,3,-2,-143,189,3,3,4,1,-25,8,0,-5
"7540","23",92,5,4,1,2,5,2,0,0,5,2,0,0,4,-1,0,0,0,0
"7541","23",437,3,1,0,0,-198,3,-2,-2,-112,-1,-2,-2,4,1,-86,4,0,0
"7542","23",461,4,4,0,2,146,32,1,-1,-33,26,-1,-1,4,0,179,6,2,0
"7543","23",458,2,1,0,1,-53,-42,-1,-3,77,74,-4,-2,4,2,-130,-116,3,-1
"7544","23",162,8,3,1,3,49,53,0,3,54,-56,2,4,4,-4,-5,109,-2,-1
"7545","23",146,2,2,0,0,-160,-170,-3,-3,-172,-157,-3,-3,4,2,12,-13,0,0
"7546","23",207,4,1,0,0,-241,42,-3,-1,-1,248,4,4,4,0,-240,-206,-7,-5
"7547","23",289,9,1,0,3,228,235,4,4,-239,-18,-4,-4,4,-5,467,253,8,8
"7548","23",163,7,3,1,1,-206,-7,1,2,91,40,2,2,4,-3,-297,-47,-1,0
"7549","23",293,1,4,1,0,-205,19,-4,-4,-215,28,-4,-4,4,3,10,-9,0,0
"7550","23",151,1,2,1,1,-14,10,0,-4,-25,12,0,-4,4,3,11,-2,0,0
"7551","23",164,7,2,1,2,160,221,2,2,171,230,2,2,4,-3,-11,-9,0,0
"7552","23",8,6,3,1,1,-14,-10,-1,1,-123,48,-3,0,4,-2,109,-58,2,1
"7553","23",287,7,4,1,3,195,6,2,2,136,-2,2,2,4,-3,59,8,0,0
"7554","23",133,1,2,1,1,111,-67,0,-4,211,42,4,0,4,3,-100,-109,-4,-4
"7555","23",77,4,3,1,1,-76,5,1,-1,-210,5,-1,-1,4,0,134,0,2,0
"7556","23",21,4,4,1,2,78,75,1,-1,66,63,2,1,4,0,12,12,-1,-2
"7557","23",153,6,1,0,3,15,11,2,1,-49,20,-1,1,4,-2,64,-9,3,0
"7558","23",134,6,2,1,2,30,0,1,1,80,9,2,1,4,-2,-50,-9,-1,0
"7559","23",361,1,1,0,0,-248,2,3,-4,1,-249,3,-1,4,3,-249,251,0,-3
"7560","23",210,8,4,1,2,215,213,3,3,220,221,4,4,4,-4,-5,-8,-1,-1
"7561","23",292,7,3,0,1,238,-7,2,2,-67,-5,-1,-4,4,-3,305,-2,3,6
"7562","23",79,5,4,1,2,24,-10,0,0,158,-8,1,1,4,-1,-134,-2,-1,-1
"7563","23",29,1,4,1,0,-192,197,-3,-4,-235,216,-4,-4,4,3,43,-19,1,0
"7564","23",22,3,3,1,1,-148,-27,-2,-2,229,17,1,1,4,1,-377,-44,-3,-3
"7565","23",148,1,1,0,1,-185,-1,3,-4,-247,-36,1,-4,4,3,62,35,2,0
"7566","23",209,6,4,1,3,185,-5,3,1,203,-12,2,2,4,-2,-18,7,1,-1
"7567","23",449,6,4,1,3,50,81,1,1,81,85,1,1,4,-2,-31,-4,0,0
"7568","23",145,6,1,0,1,43,57,1,1,95,131,0,-1,4,-2,-52,-74,1,2
"7569","23",360,1,3,1,0,-85,-76,-2,-4,80,99,1,-4,4,3,-165,-175,-3,0
"7570","23",288,6,2,0,2,26,36,0,1,101,-65,2,1,4,-2,-75,101,-2,0
"7571","23",291,5,4,1,2,212,120,0,0,-61,-96,-2,-1,4,-1,273,216,2,1
"7572","23",78,2,4,1,0,-199,9,-3,-3,-188,-12,-2,-2,4,2,-11,21,-1,-1
"7573","23",296,6,1,0,3,154,7,1,1,203,9,2,2,4,-2,-49,-2,-1,-1
"7574","23",214,9,1,1,3,209,-4,3,4,212,4,3,4,4,-5,-3,-8,0,0
"7575","23",135,1,1,1,1,-229,206,-4,-4,-230,122,-3,-3,4,3,1,84,-1,-1
"7576","23",208,6,4,1,2,-100,-4,1,1,-53,2,-4,1,4,-2,-47,-6,5,0
"7577","23",211,4,3,1,1,-43,-32,-4,-1,145,170,-2,2,4,0,-188,-202,-2,-3
"7578","23",136,1,1,0,0,-249,246,-4,-4,78,-56,-4,-3,4,3,-327,302,0,-1
"7579","23",294,7,1,0,3,191,0,2,2,157,0,2,2,4,-3,34,0,0,0
"7580","23",152,2,1,0,0,-145,-5,-1,-3,233,3,0,-3,4,2,-378,-8,-1,0
"7581","23",137,3,1,0,1,-188,66,-3,-2,-205,-80,-2,0,4,1,17,146,-1,-2
"7582","23",80,2,4,1,3,70,2,3,-3,247,0,3,-2,4,2,-177,2,0,-1
"7583","23",213,6,2,1,1,5,96,0,1,83,3,-1,0,4,-2,-78,93,1,1
"7584","23",217,4,4,1,2,69,36,1,-1,66,37,1,-1,4,0,3,-1,0,0
"7585","23",15,6,4,1,3,30,21,2,1,-88,66,-1,-2,4,-2,118,-45,3,3
"7586","23",81,1,1,0,0,-130,46,-4,-4,-80,51,-3,-3,4,3,-50,-5,-1,-1
"7587","23",226,2,1,0,0,-82,0,-1,-3,221,4,3,-2,4,2,-303,-4,-4,-1
"7588","23",222,2,1,0,0,-124,1,-2,-3,-239,1,-3,-3,4,2,115,0,1,0
"7589","23",223,5,1,0,1,-2,-1,0,0,173,-1,-1,0,4,-1,-175,0,1,0
"7590","23",227,6,3,1,3,29,17,1,1,7,-5,2,1,4,-2,22,22,-1,0
"7591","23",215,2,1,0,0,-130,25,-2,-3,-26,28,-2,-3,4,2,-104,-3,0,0
"7592","23",83,6,1,1,3,110,-129,2,1,136,-129,2,1,4,-2,-26,0,0,0
"7593","23",290,1,1,0,1,-106,22,-4,-4,90,137,-4,-4,4,3,-196,-115,0,0
"7594","23",220,2,4,1,2,88,102,-3,-3,176,159,-3,-3,4,2,-88,-57,0,0
"7595","23",149,6,3,1,1,-1,-1,-3,1,245,2,-3,1,4,-2,-246,-3,0,0
"7596","23",295,5,1,0,1,5,-3,0,0,-3,1,0,0,4,-1,8,-4,0,0
"7597","23",225,5,2,0,2,44,72,0,0,19,194,3,0,4,-1,25,-122,-3,0
"7598","23",138,4,3,1,1,122,-25,-1,-1,154,-42,1,1,4,0,-32,17,-2,-2
"7599","23",141,2,1,0,0,-24,17,-4,-3,-242,10,-4,-4,4,2,218,7,0,1
"7600","23",85,7,2,1,2,88,84,1,2,128,135,4,3,4,-3,-40,-51,-3,-1
"7601","23",218,8,4,1,3,48,10,4,3,34,16,4,3,4,-4,14,-6,0,0
"7602","23",82,3,4,1,2,-18,-27,2,-2,11,245,4,4,4,1,-29,-272,-2,-6
"7603","23",86,6,4,1,3,65,-2,1,1,129,3,1,-1,4,-2,-64,-5,0,2
"7604","23",140,4,1,0,1,-29,32,0,-1,-34,42,-1,-2,4,0,5,-10,1,1
"7605","23",14,2,3,1,1,3,0,-2,-3,48,-10,0,0,4,2,-45,10,-2,-3
"7606","23",212,1,1,1,1,-221,30,0,-4,-98,48,0,0,4,3,-123,-18,0,-4
"7607","23",216,5,3,1,1,-9,-1,0,0,-182,-12,-3,-2,4,-1,173,11,3,2
"7608","23",142,5,2,1,2,53,-17,-1,0,124,52,1,0,4,-1,-71,-69,-2,0
"7609","23",84,8,4,1,3,197,-1,3,3,201,0,2,2,4,-4,-4,-1,1,1
"7610","23",23,9,1,0,3,211,211,4,4,216,206,4,4,4,-5,-5,5,0,0
"7611","23",221,5,4,0,1,-10,-5,0,0,8,4,1,0,4,-1,-18,-9,-1,0
"7612","23",228,7,4,1,2,-5,7,1,2,39,113,3,4,4,-3,-44,-106,-2,-2
"7613","23",219,5,4,1,3,247,0,4,0,249,1,4,0,4,-1,-2,-1,0,0
"7614","23",139,9,4,1,2,0,0,4,4,241,-1,-1,4,4,-5,-241,1,5,0
"7615","23",229,2,1,1,1,-234,-64,-3,-3,-237,231,0,-4,4,2,3,-295,-3,1
"7616","23",224,7,2,1,2,161,114,2,2,182,91,2,1,4,-3,-21,23,0,1
"7617","24",331,2,1,1,0,67,67,-4,-3,17,-106,-4,-3,4,2,50,173,0,0
"7618","24",42,2,3,1,1,8,8,2,-3,-2,2,2,-2,4,2,10,6,0,-1
"7619","24",330,6,2,1,2,81,67,1,1,209,208,3,1,4,-2,-128,-141,-2,0
"7620","24",332,1,1,0,0,-248,9,-3,-4,-246,60,-2,-2,4,3,-2,-51,-1,-2
"7621","24",333,6,4,1,1,48,7,1,1,-56,77,2,2,4,-2,104,-70,-1,-1
"7622","24",341,9,1,0,3,0,0,4,4,241,-26,1,4,4,-5,-241,26,3,0
"7623","24",338,1,3,1,2,12,-18,-4,-4,78,43,-4,-4,4,3,-66,-61,0,0
"7624","24",342,2,3,0,1,-151,12,-1,-3,-46,9,-1,-2,4,2,-105,3,0,-1
"7625","24",111,2,1,0,0,-223,-210,-4,-3,-88,137,0,1,4,2,-135,-347,-4,-4
"7626","24",339,4,3,1,1,96,82,-1,-1,59,43,-3,-3,4,0,37,39,2,2
"7627","24",335,4,2,1,1,-4,19,0,-1,-26,15,0,-1,4,0,22,4,0,0
"7628","24",12,9,4,1,3,0,2,4,4,-1,2,4,4,4,-5,1,0,0,0
"7629","24",34,6,4,1,2,135,-75,1,1,113,-71,1,1,4,-2,22,-4,0,0
"7630","24",396,1,1,0,1,-242,239,4,-4,235,-239,-4,4,4,3,-477,478,8,-8
"7631","24",336,3,4,1,3,207,144,2,-2,-144,148,2,-2,4,1,351,-4,0,0
"7632","24",120,2,3,1,1,-169,-51,-3,-3,-235,-92,-3,-3,4,2,66,41,0,0
"7633","24",340,4,1,1,1,-20,-10,0,-1,90,42,0,0,4,0,-110,-52,0,-1
"7634","24",420,7,4,1,3,0,0,1,2,3,-2,2,1,4,-3,-3,2,-1,1
"7635","24",337,9,2,1,3,245,239,4,4,242,-21,4,4,4,-5,3,260,0,0
"7636","24",345,5,1,0,0,-174,44,-3,0,-17,-33,-1,-3,4,-1,-157,77,-2,3
"7637","24",334,1,4,1,0,-247,129,-4,-4,-242,117,-4,-4,4,3,-5,12,0,0
"7638","24",119,5,3,1,3,81,137,1,0,58,-102,1,1,4,-1,23,239,0,-1
"7639","24",395,4,3,1,1,-149,59,-2,-1,215,38,3,3,4,0,-364,21,-5,-4
"7640","24",419,6,4,1,3,144,133,1,1,139,127,0,1,4,-2,5,6,1,0
"7641","24",321,5,1,0,0,-33,-29,0,0,-33,-29,0,0,4,-1,0,0,0,0
"7642","24",343,6,2,1,2,101,-1,1,1,84,4,1,1,4,-2,17,-5,0,0
"7643","24",116,6,2,1,3,112,-15,1,1,110,-7,2,1,4,-2,2,-8,-1,0
"7644","24",322,6,4,1,3,109,-104,1,1,236,-229,3,3,4,-2,-127,125,-2,-2
"7645","24",100,5,4,1,3,233,8,1,0,246,4,4,4,4,-1,-13,4,-3,-4
"7646","24",344,6,4,1,3,127,-49,2,1,97,82,2,3,4,-2,30,-131,0,-2
"7647","24",327,7,4,1,3,242,0,4,2,157,33,2,1,4,-3,85,-33,2,1
"7648","24",323,5,4,1,1,-5,-220,0,0,229,-1,0,0,4,-1,-234,-219,0,0
"7649","24",114,2,4,1,1,6,4,0,-3,85,96,1,-3,4,2,-79,-92,-1,0
"7650","24",418,7,2,1,2,182,16,2,2,203,75,-1,0,4,-3,-21,-59,3,2
"7651","24",421,5,3,1,1,-10,22,-2,0,112,69,0,2,4,-1,-122,-47,-2,-2
"7652","24",115,6,3,0,3,1,-1,0,1,1,-4,0,0,4,-2,0,3,0,1
"7653","24",410,1,1,0,0,-224,-13,-2,-4,-37,-8,-1,-4,4,3,-187,-5,-1,0
"7654","24",387,3,3,0,1,113,112,-3,-2,105,100,2,3,4,1,8,12,-5,-5
"7655","24",112,8,4,1,3,239,7,-4,3,11,242,3,-3,4,-4,228,-235,-7,6
"7656","24",55,4,4,1,1,-7,-13,0,-1,20,-17,0,0,4,0,-27,4,0,-1
"7657","24",411,9,2,1,2,231,227,4,4,231,239,4,4,4,-5,0,-12,0,0
"7658","24",423,5,1,0,3,43,-8,-3,0,-18,33,3,0,4,-1,61,-41,-6,0
"7659","24",113,6,2,1,2,101,48,1,1,-153,-58,0,0,4,-2,254,106,1,1
"7660","24",117,2,4,1,2,-88,10,-2,-3,78,27,-2,-3,4,2,-166,-17,0,0
"7661","24",412,9,1,0,0,-243,90,-3,4,242,4,4,4,4,-5,-485,86,-7,0
"7662","24",121,1,1,0,0,-66,15,-4,-4,239,-106,-1,-4,4,3,-305,121,-3,0
"7663","24",328,4,3,1,1,-28,8,-1,-1,5,8,1,1,4,0,-33,0,-2,-2
"7664","24",386,1,1,0,0,-248,125,-2,-4,11,8,0,-1,4,3,-259,117,-2,-3
"7665","24",122,1,1,0,0,-128,-140,-4,-4,-52,-44,1,0,4,3,-76,-96,-5,-4
"7666","24",346,7,3,0,0,-249,1,0,2,207,1,0,3,4,-3,-456,0,0,-1
"7667","24",329,7,4,1,3,16,25,-2,2,233,214,-2,2,4,-3,-217,-189,0,0
"7668","24",318,5,2,1,2,32,-190,-4,0,172,-170,-4,0,4,-1,-140,-20,0,0
"7669","24",123,3,4,1,2,-24,-22,-2,-2,-46,-22,-2,-2,4,1,22,0,0,0
"7670","24",347,9,1,0,3,-118,-127,2,4,145,110,0,1,4,-5,-263,-237,2,3
"7671","24",388,2,4,1,0,-157,10,-4,-3,-229,8,-1,-1,4,2,72,2,-3,-2
"7672","24",319,4,1,0,1,59,1,-2,-1,76,1,-2,1,4,0,-17,0,0,-2
"7673","24",56,3,3,1,1,36,-133,-2,-2,38,-127,-2,-2,4,1,-2,-6,0,0
"7674","24",105,1,1,0,0,-235,-52,-4,-4,-195,-25,-4,-4,4,3,-40,-27,0,0
"7675","24",101,1,3,1,0,-242,242,-4,-4,227,229,-3,-3,4,3,-469,13,-1,-1
"7676","24",39,5,3,1,1,48,72,0,0,178,205,3,4,4,-1,-130,-133,-3,-4
"7677","24",30,5,2,1,2,139,-10,1,0,239,7,3,2,4,-1,-100,-17,-2,-2
"7678","24",324,2,2,1,0,37,-2,-3,-3,-2,2,-4,-4,4,2,39,-4,1,1
"7679","24",390,9,2,1,2,211,229,3,4,216,216,4,4,4,-5,-5,13,-1,0
"7680","24",66,4,1,0,1,-77,0,1,-1,169,0,1,2,4,0,-246,0,0,-3
"7681","24",422,1,3,0,1,-137,-102,3,-4,-99,-236,2,-2,4,3,-38,134,1,-2
"7682","24",407,6,2,1,2,32,-75,1,1,171,11,4,3,4,-2,-139,-86,-3,-2
"7683","24",391,6,2,1,3,158,145,0,1,184,180,0,0,4,-2,-26,-35,0,1
"7684","24",104,1,1,0,0,-235,-2,-3,-4,239,-3,2,-4,4,3,-474,1,-5,0
"7685","24",403,2,1,1,0,-105,-25,0,-3,17,-5,1,0,4,2,-122,-20,-1,-3
"7686","24",397,6,4,1,3,-171,-84,0,1,-106,131,1,1,4,-2,-65,-215,-1,0
"7687","24",348,3,3,0,1,-132,3,0,-2,79,57,0,-2,4,1,-211,-54,0,0
"7688","24",424,6,2,1,2,45,43,1,1,101,140,1,1,4,-2,-56,-97,0,0
"7689","24",398,9,4,1,2,245,247,4,4,243,247,4,4,4,-5,2,0,0,0
"7690","24",118,5,3,1,1,-65,20,-2,0,122,39,1,1,4,-1,-187,-19,-3,-1
"7691","24",413,7,1,0,1,-195,3,-1,2,-221,2,-2,-2,4,-3,26,1,1,4
"7692","24",320,8,2,1,2,197,132,2,3,225,137,3,3,4,-4,-28,-5,-1,0
"7693","24",58,7,4,1,1,-236,-1,-2,2,-9,239,4,4,4,-3,-227,-240,-6,-2
"7694","24",414,2,1,0,0,-179,-175,-3,-3,3,4,0,0,4,2,-182,-179,-3,-3
"7695","24",103,5,2,1,3,-4,-3,0,0,-4,-3,1,0,4,-1,0,0,-1,0
"7696","24",59,3,1,0,0,-35,48,-2,-2,76,-82,2,2,4,1,-111,130,-4,-4
"7697","24",33,5,3,1,1,-93,48,0,0,58,-114,0,0,4,-1,-151,162,0,0
"7698","24",326,7,4,1,2,144,86,2,2,164,97,2,2,4,-3,-20,-11,0,0
"7699","24",124,8,1,0,3,232,-6,3,3,243,6,2,2,4,-4,-11,-12,1,1
"7700","24",392,3,1,0,0,-59,91,-2,-2,-125,107,-2,-2,4,1,66,-16,0,0
"7701","24",389,1,3,1,2,-243,6,-4,-4,38,-30,0,0,4,3,-281,36,-4,-4
"7702","24",32,5,1,0,1,2,6,0,0,185,-159,2,-4,4,-1,-183,165,-2,4
"7703","24",57,1,4,1,1,43,-228,-1,-4,112,-127,-2,-4,4,3,-69,-101,1,0
"7704","24",106,5,2,1,1,30,25,0,0,19,34,0,0,4,-1,11,-9,0,0
"7705","24",102,7,4,1,3,98,-100,3,2,-70,37,1,4,4,-3,168,-137,2,-2
"7706","24",399,6,4,1,3,92,17,1,1,184,-8,2,2,4,-2,-92,25,-1,-1
"7707","24",300,2,1,0,0,-202,37,-2,-3,24,46,1,2,4,2,-226,-9,-3,-5
"7708","24",325,8,1,0,1,-15,-12,-1,3,14,16,2,4,4,-4,-29,-28,-3,-1
"7709","24",1,7,1,1,1,17,14,1,2,19,15,1,2,4,-3,-2,-1,0,0
"7710","24",67,1,1,0,0,-21,26,-4,-4,123,-150,1,1,4,3,-144,176,-5,-5
"7711","24",415,6,2,1,2,65,57,0,1,157,190,0,4,4,-2,-92,-133,0,-3
"7712","24",408,4,1,1,0,-135,-7,-1,-1,-157,12,-1,-2,4,0,22,-19,0,1
"7713","24",6,6,4,1,2,124,0,1,1,124,0,1,1,4,-2,0,0,0,0
"7714","24",109,1,1,0,1,43,-229,3,-4,1,-204,2,-4,4,3,42,-25,1,0
"7715","24",404,5,1,1,1,58,-61,1,0,49,-45,1,0,4,-1,9,-16,0,0
"7716","24",373,1,3,1,0,-236,-36,0,-4,-224,-22,0,-4,4,3,-12,-14,0,0
"7717","24",349,2,4,1,1,-47,-58,-2,-3,-63,82,1,0,4,2,16,-140,-3,-3
"7718","24",425,5,4,1,2,1,27,0,0,13,71,1,1,4,-1,-12,-44,-1,-1
"7719","24",126,4,2,0,2,38,195,-1,-1,29,198,-1,-1,4,0,9,-3,0,0
"7720","24",394,1,3,0,0,-246,245,-4,-4,-248,246,-4,-4,4,3,2,-1,0,0
"7721","24",317,5,4,0,2,5,-3,0,0,-20,29,-1,-1,4,-1,25,-32,1,1
"7722","24",62,9,2,0,3,197,86,4,4,215,210,2,4,4,-5,-18,-124,2,0
"7723","24",31,4,1,0,0,-182,-190,-1,-1,-216,104,-4,-4,4,0,34,-294,3,3
"7724","24",108,9,2,1,3,227,163,4,4,221,213,4,4,4,-5,6,-50,0,0
"7725","24",38,9,4,1,3,0,0,4,4,100,27,4,4,4,-5,-100,-27,0,0
"7726","24",40,4,1,0,2,144,82,2,-1,-63,58,2,2,4,0,207,24,0,-3
"7727","24",185,5,4,1,2,59,-8,-1,0,44,-12,-1,1,4,-1,15,4,0,-1
"7728","24",181,3,4,1,3,200,113,-2,-2,-49,93,0,0,4,1,249,20,-2,-2
"7729","24",125,4,4,1,0,-118,-22,-4,-1,244,-243,-4,-2,4,0,-362,221,0,1
"7730","24",393,1,1,0,0,-130,-175,-4,-4,130,-116,2,-3,4,3,-260,-59,-6,-1
"7731","24",316,2,3,1,0,-164,-77,-3,-3,-133,-103,-3,-3,4,2,-31,26,0,0
"7732","24",41,6,2,1,3,70,86,3,1,50,93,3,1,4,-2,20,-7,0,0
"7733","24",309,4,4,1,2,140,29,-1,-1,224,143,-1,-3,4,0,-84,-114,0,2
"7734","24",107,3,2,1,3,-137,36,2,-2,202,186,0,4,4,1,-339,-150,2,-6
"7735","24",379,3,3,0,1,-44,-39,1,-2,-4,-8,1,0,4,1,-40,-31,0,-2
"7736","24",4,5,3,1,1,2,0,0,0,227,221,2,2,4,-1,-225,-221,-2,-2
"7737","24",301,6,4,1,1,72,0,2,1,-84,2,-1,-2,4,-2,156,-2,3,3
"7738","24",299,3,4,0,1,-161,-150,-1,-2,30,221,3,4,4,1,-191,-371,-4,-6
"7739","24",10,5,3,0,1,-1,221,-2,0,-202,-6,-2,-2,4,-1,201,227,0,2
"7740","24",68,2,4,1,0,132,5,0,-3,191,4,-2,-3,4,2,-59,1,2,0
"7741","24",416,1,4,1,0,-238,229,-4,-4,-202,223,-4,-4,4,3,-36,6,0,0
"7742","24",409,6,4,1,2,80,81,1,1,121,128,2,2,4,-2,-41,-47,-1,-1
"7743","24",60,8,1,0,3,217,-1,3,3,222,1,3,3,4,-4,-5,-2,0,0
"7744","24",11,6,4,1,1,-78,-123,0,1,-105,97,1,-1,4,-2,27,-220,-1,2
"7745","24",405,5,4,1,1,19,6,2,0,88,50,-2,-2,4,-1,-69,-44,4,2
"7746","24",374,7,4,1,2,123,9,2,2,163,64,2,2,4,-3,-40,-55,0,0
"7747","24",35,3,1,0,3,106,163,3,-2,151,174,3,-2,4,1,-45,-11,0,0
"7748","24",426,8,4,1,3,248,4,4,3,-4,-248,4,3,4,-4,252,252,0,0
"7749","24",127,2,1,0,0,-189,-75,-3,-3,-107,-1,-2,-3,4,2,-82,-74,-1,0
"7750","24",471,6,3,1,2,34,-43,1,1,103,-142,2,2,4,-2,-69,99,-1,-1
"7751","24",172,6,2,1,3,0,97,-1,1,101,104,2,2,4,-2,-101,-7,-3,-1
"7752","24",63,4,4,1,1,2,4,-1,-1,-4,6,0,0,4,0,6,-2,-1,-1
"7753","24",310,4,4,1,2,90,24,1,-1,208,103,3,3,4,0,-118,-79,-2,-4
"7754","24",384,3,1,1,0,11,63,-2,-2,0,109,-2,-2,4,1,11,-46,0,0
"7755","24",380,1,4,1,1,224,-57,3,-4,-141,-41,3,-4,4,3,365,-16,0,0
"7756","24",400,4,4,1,2,138,-143,-1,-1,82,-156,-1,-1,4,0,56,13,0,0
"7757","24",186,5,2,1,2,-1,-1,0,0,0,10,0,0,4,-1,-1,-11,0,0
"7758","24",182,9,4,1,3,60,-28,4,4,-4,-215,1,2,4,-5,64,187,3,2
"7759","24",179,5,1,0,1,-1,-1,2,0,2,-1,0,1,4,-1,-3,0,2,-1
"7760","24",7,6,1,0,3,149,118,2,1,72,68,1,2,4,-2,77,50,1,-1
"7761","24",276,8,4,1,3,217,3,3,3,182,-1,3,3,4,-4,35,4,0,0
"7762","24",313,4,3,1,0,-45,-46,-1,-1,85,87,2,2,4,0,-130,-133,-3,-3
"7763","24",269,6,4,1,2,169,0,0,1,247,124,1,1,4,-2,-78,-124,-1,0
"7764","24",265,8,1,0,3,112,1,2,3,1,-3,0,0,4,-4,111,4,2,3
"7765","24",189,3,1,0,1,-224,46,3,-2,-47,59,2,-3,4,1,-177,-13,1,1
"7766","24",376,4,4,1,1,20,-140,-1,-1,47,-134,-1,-1,4,0,-27,-6,0,0
"7767","24",302,3,1,0,0,-177,-27,-3,-2,216,50,-2,-2,4,1,-393,-77,-1,0
"7768","24",3,3,3,1,0,129,3,2,-2,-2,1,-2,-3,4,1,131,2,4,1
"7769","24",178,5,1,0,1,-1,6,0,0,161,7,2,2,4,-1,-162,-1,-2,-2
"7770","24",69,3,4,0,1,43,30,-1,-2,52,37,2,1,4,1,-9,-7,-3,-3
"7771","24",417,7,2,1,2,161,191,2,2,117,106,2,2,4,-3,44,85,0,0
"7772","24",312,5,4,1,1,79,-82,0,0,-107,-103,0,0,4,-1,186,21,0,0
"7773","24",61,1,1,0,3,222,-25,4,-4,1,3,4,-4,4,3,221,-28,0,0
"7774","24",110,6,1,0,1,-119,61,-3,1,76,69,3,-1,4,-2,-195,-8,-6,2
"7775","24",406,8,2,1,2,192,89,1,3,165,104,2,1,4,-4,27,-15,-1,2
"7776","24",375,5,3,1,1,1,-1,0,0,0,1,0,0,4,-1,1,-2,0,0
"7777","24",350,5,4,1,1,-249,0,1,0,247,-1,2,1,4,-1,-496,1,-1,-1
"7778","24",427,3,4,1,1,-131,-17,2,-2,-206,-22,2,-2,4,1,75,5,0,0
"7779","24",128,5,1,0,3,51,-100,0,0,131,-189,2,2,4,-1,-80,89,-2,-2
"7780","24",472,1,1,0,0,-237,179,-4,-4,-231,35,-4,-4,4,3,-6,144,0,0
"7781","24",173,6,4,1,3,173,16,1,1,209,5,2,0,4,-2,-36,11,-1,1
"7782","24",64,9,1,0,1,229,-75,4,4,228,-64,4,4,4,-5,1,-11,0,0
"7783","24",311,1,2,1,2,198,6,4,-4,225,17,4,-4,4,3,-27,-11,0,0
"7784","24",385,6,4,1,1,106,-135,1,1,215,62,2,1,4,-2,-109,-197,-1,0
"7785","24",381,7,2,1,2,229,216,2,2,112,192,2,2,4,-3,117,24,0,0
"7786","24",401,6,2,1,1,94,16,-1,1,-12,14,1,1,4,-2,106,2,-2,0
"7787","24",187,6,4,1,2,54,114,2,1,188,175,3,3,4,-2,-134,-61,-1,-2
"7788","24",183,5,4,1,1,38,25,0,0,32,43,0,1,4,-1,6,-18,0,-1
"7789","24",18,4,3,0,1,-82,-100,1,-1,21,16,1,0,4,0,-103,-116,0,-1
"7790","24",70,2,2,1,2,81,172,-1,-3,173,192,1,-3,4,2,-92,-20,-2,0
"7791","24",277,1,4,1,1,8,-94,4,-4,0,-78,3,-3,4,3,8,-16,1,-1
"7792","24",314,1,4,0,1,-242,10,4,-4,-241,4,4,-4,4,3,-1,6,0,0
"7793","24",27,6,2,1,2,119,122,1,1,75,76,1,1,4,-2,44,46,0,0
"7794","24",266,5,1,0,1,3,-9,0,0,0,0,0,0,4,-1,3,-9,0,0
"7795","24",19,5,2,0,2,118,-127,0,0,104,-47,1,1,4,-1,14,-80,-1,-1
"7796","24",377,1,1,0,0,-248,8,-4,-4,-246,6,-4,-4,4,3,-2,2,0,0
"7797","24",303,4,3,1,2,97,-40,-1,-1,10,-76,2,2,4,0,87,36,-3,-3
"7798","24",158,6,3,1,0,131,-31,1,1,-45,-22,0,-2,4,-2,176,-9,1,3
"7799","24",297,2,3,1,2,194,119,3,-3,216,100,4,-3,4,2,-22,19,-1,0
"7800","24",474,1,1,0,0,2,-85,-4,-4,3,-90,-2,-4,4,3,-1,5,-2,0
"7801","24",175,5,4,1,1,-182,-33,-2,0,6,10,-1,-2,4,-1,-188,-43,-1,2
"7802","24",272,5,4,1,2,134,-33,0,0,125,60,1,1,4,-1,9,-93,-1,-1
"7803","24",168,7,1,0,3,176,-116,2,2,122,-23,2,2,4,-3,54,-93,0,0
"7804","24",463,9,4,1,3,249,-5,4,4,232,-17,4,4,4,-5,17,12,0,0
"7805","24",383,5,4,1,1,0,1,0,0,0,1,0,0,4,-1,0,0,0,0
"7806","24",306,5,3,1,3,104,101,1,0,142,159,1,0,4,-1,-38,-58,0,0
"7807","24",351,1,1,0,0,-246,-241,-4,-4,136,123,-4,-4,4,3,-382,-364,0,0
"7808","24",428,1,1,0,0,-232,-211,-4,-4,-228,-203,-4,-4,4,3,-4,-8,0,0
"7809","24",129,3,4,1,1,-172,-2,-2,-2,-188,-3,-2,-2,4,1,16,1,0,0
"7810","24",473,4,3,1,0,-172,-10,1,-1,-151,-47,0,0,4,0,-21,37,1,-1
"7811","24",174,6,4,1,3,140,47,0,1,157,92,0,1,4,-2,-17,-45,0,0
"7812","24",65,7,1,0,3,-73,86,1,2,-117,26,1,2,4,-3,44,60,0,0
"7813","24",167,3,1,0,3,-129,61,0,-2,-148,103,-2,-2,4,1,19,-42,2,0
"7814","24",462,9,3,0,3,0,88,4,4,190,202,-4,-4,4,-5,-190,-114,8,8
"7815","24",382,6,4,1,2,66,1,2,1,56,-5,1,2,4,-2,10,6,1,-1
"7816","24",402,1,3,1,0,-245,-1,-4,-4,188,1,1,1,4,3,-433,-2,-5,-5
"7817","24",188,8,2,1,3,220,4,3,3,224,-2,3,3,4,-4,-4,6,0,0
"7818","24",184,6,3,0,3,59,-5,1,1,63,-2,1,1,4,-2,-4,-3,0,0
"7819","24",180,9,2,1,2,169,4,4,4,124,0,2,3,4,-5,45,4,2,1
"7820","24",71,4,3,1,1,-66,14,-1,-1,34,16,0,0,4,0,-100,-2,-1,-1
"7821","24",278,1,4,1,1,75,65,4,-4,121,137,4,-4,4,3,-46,-72,0,0
"7822","24",315,9,3,0,3,238,22,4,4,242,18,4,4,4,-5,-4,4,0,0
"7823","24",270,5,3,0,1,1,-2,0,0,2,1,0,0,4,-1,-1,-3,0,0
"7824","24",267,4,3,1,1,-75,3,-1,-1,82,-14,1,1,4,0,-157,17,-2,-2
"7825","24",190,7,4,1,3,207,232,2,2,180,128,2,2,4,-3,27,104,0,0
"7826","24",378,3,4,1,1,-159,-2,-2,-2,-174,-4,3,-2,4,1,15,2,-5,0
"7827","24",304,3,2,1,2,-34,-30,-2,-2,30,-30,1,1,4,1,-64,0,-3,-3
"7828","24",159,2,3,1,2,-141,2,-3,-3,211,2,4,4,4,2,-352,0,-7,-7
"7829","24",298,2,1,0,0,-246,12,-1,-3,-123,12,-1,-2,4,2,-123,0,0,-1
"7830","24",475,5,3,0,3,79,-61,0,0,45,-159,0,0,4,-1,34,98,0,0
"7831","24",176,8,1,0,1,-144,-25,-1,3,212,50,0,1,4,-4,-356,-75,-1,2
"7832","24",273,1,1,0,0,-228,5,-3,-4,215,152,3,2,4,3,-443,-147,-6,-6
"7833","24",169,1,3,0,0,-242,224,-4,-4,-144,80,-4,-4,4,3,-98,144,0,0
"7834","24",464,6,1,0,1,68,29,1,1,74,12,1,1,4,-2,-6,17,0,0
"7835","24",241,5,4,1,2,186,162,2,0,190,156,2,0,4,-1,-4,6,0,0
"7836","24",307,2,4,1,2,75,59,-3,-3,240,-89,2,3,4,2,-165,148,-5,-6
"7837","24",352,4,2,1,1,11,-80,0,-1,3,-46,0,-1,4,0,8,-34,0,0
"7838","24",429,1,2,1,0,-49,36,-1,-4,62,16,0,-4,4,3,-111,20,-1,0
"7839","24",13,3,4,1,1,116,-80,1,-2,22,-114,0,-2,4,1,94,34,1,0
"7840","24",73,4,4,1,2,-154,-130,-1,-1,160,-169,1,-1,4,0,-314,39,-2,0
"7841","24",28,4,4,1,1,-46,-41,-1,-1,7,4,-1,-1,4,0,-53,-45,0,0
"7842","24",171,5,1,1,1,10,12,0,0,21,12,0,0,4,-1,-11,0,0,0
"7843","24",2,7,4,1,1,-118,-28,-1,2,-211,-99,-2,-1,4,-3,93,71,1,3
"7844","24",196,2,3,0,0,-211,-25,-3,-3,227,243,4,4,4,2,-438,-268,-7,-7
"7845","24",192,7,4,1,1,136,5,2,2,2,111,1,2,4,-3,134,-106,1,0
"7846","24",143,6,1,0,3,-9,12,4,1,61,-102,2,2,4,-2,-70,114,2,-1
"7847","24",164,8,2,1,2,177,184,3,3,-5,202,1,1,4,-4,182,-18,2,2
"7848","24",160,7,2,0,0,-205,57,-4,2,-34,13,-4,2,4,-3,-171,44,0,0
"7849","24",51,4,4,1,1,24,-39,1,-1,-17,-52,2,3,4,0,41,13,-1,-4
"7850","24",72,2,1,0,0,-179,-74,-2,-3,136,138,2,2,4,2,-315,-212,-4,-5
"7851","24",279,8,4,1,3,174,96,1,3,166,83,2,2,4,-4,8,13,-1,1
"7852","24",170,2,2,1,0,64,59,-3,-3,100,80,0,0,4,2,-36,-21,-3,-3
"7853","24",271,6,3,1,1,9,0,1,1,243,-2,4,4,4,-2,-234,2,-3,-3
"7854","24",268,8,4,1,3,129,-135,2,3,99,134,2,2,4,-4,30,-269,0,1
"7855","24",191,2,1,0,0,-206,-30,-2,-3,-183,-54,-2,-3,4,2,-23,24,0,0
"7856","24",305,9,4,1,3,231,228,4,4,239,239,4,4,4,-5,-8,-11,0,0
"7857","24",163,4,3,0,1,-201,15,-2,-1,89,-9,2,1,4,0,-290,24,-4,-2
"7858","24",16,1,1,0,0,-224,17,0,-4,98,17,2,-2,4,3,-322,0,-2,-2
"7859","24",156,5,2,0,1,58,-25,0,0,56,37,1,1,4,-1,2,-62,-1,-1
"7860","24",476,4,3,1,0,-197,-182,-1,-1,-72,-100,0,0,4,0,-125,-82,-1,-1
"7861","24",177,1,4,1,1,61,199,-3,-4,126,117,-3,-3,4,3,-65,82,0,-1
"7862","24",274,7,4,1,2,143,119,2,2,161,92,2,2,4,-3,-18,27,0,0
"7863","24",17,1,3,1,0,13,0,-1,-4,134,79,0,-4,4,3,-121,-79,-1,0
"7864","24",465,6,4,1,3,215,9,1,1,13,-235,1,1,4,-2,202,244,0,0
"7865","24",242,3,4,1,2,25,17,1,-2,93,3,3,-2,4,1,-68,14,-2,0
"7866","24",308,2,4,1,0,-250,-244,-4,-3,129,127,0,2,4,2,-379,-371,-4,-5
"7867","24",353,7,2,1,2,236,43,1,2,229,220,-4,-2,4,-3,7,-177,5,4
"7868","24",43,1,3,1,0,-48,4,-3,-4,70,6,-3,-4,4,3,-118,-2,0,0
"7869","24",130,9,1,0,3,162,41,4,4,163,24,4,4,4,-5,-1,17,0,0
"7870","24",74,1,3,0,0,-213,-68,-4,-4,-41,-28,-1,0,4,3,-172,-40,-3,-4
"7871","24",280,4,2,1,1,229,-133,2,-1,54,74,1,0,4,0,175,-207,1,-1
"7872","24",252,5,4,0,1,-91,-126,-2,0,104,153,0,1,4,-1,-195,-279,-2,-1
"7873","24",20,9,3,1,0,-216,-212,-4,4,-222,-223,-4,4,4,-5,6,11,0,0
"7874","24",197,3,4,1,3,-245,-1,4,-2,-237,11,4,-4,4,1,-8,-12,0,2
"7875","24",193,1,1,0,0,-221,-63,-4,-4,191,-38,1,1,4,3,-412,-25,-5,-5
"7876","24",144,3,3,1,0,-238,3,1,-2,123,-111,2,0,4,1,-361,114,-1,-2
"7877","24",165,3,1,0,1,-110,17,-2,-2,70,63,1,1,4,1,-180,-46,-3,-3
"7878","24",161,3,2,1,2,103,72,1,-2,97,61,1,-2,4,1,6,11,0,0
"7879","24",52,5,3,0,0,-223,3,-2,0,70,4,2,-1,4,-1,-293,-1,-4,1
"7880","24",49,7,4,1,1,86,42,2,2,113,50,1,1,4,-3,-27,-8,1,1
"7881","24",255,1,3,0,1,-80,-131,-4,-4,166,135,1,1,4,3,-246,-266,-5,-5
"7882","24",202,4,1,0,1,-83,42,-2,-1,82,-43,-2,0,4,0,-165,85,0,-1
"7883","24",470,4,1,1,1,-54,2,-1,-1,11,46,-1,-1,4,0,-65,-44,0,0
"7884","24",467,9,1,0,3,-39,-36,4,4,126,161,4,0,4,-5,-165,-197,0,4
"7885","24",244,6,4,1,2,78,-106,1,1,68,-55,1,2,4,-2,10,-51,0,-1
"7886","24",147,5,2,1,3,-82,-126,2,0,119,68,2,0,4,-1,-201,-194,0,0
"7887","24",355,4,2,1,2,2,-22,-2,-1,0,-18,-2,-1,4,0,2,-4,0,0
"7888","24",431,3,3,1,0,-215,22,-3,-2,4,9,0,0,4,1,-219,13,-3,-2
"7889","24",157,9,3,0,2,194,203,4,4,161,104,-2,0,4,-5,33,99,6,4
"7890","24",48,1,3,1,0,11,-11,-4,-4,89,-83,-4,-4,4,3,-78,72,0,0
"7891","24",254,4,2,1,3,203,-150,-2,-1,192,-33,4,2,4,0,11,-117,-6,-3
"7892","24",275,4,4,1,2,223,-13,2,-1,0,225,3,2,4,0,223,-238,-1,-3
"7893","24",47,8,4,1,3,153,-104,2,3,121,1,1,2,4,-4,32,-105,1,1
"7894","24",466,3,3,0,0,-135,-99,-2,-2,-96,-106,-1,-1,4,1,-39,7,-1,-1
"7895","24",243,8,2,1,2,249,-54,2,3,121,247,2,1,4,-4,128,-301,0,2
"7896","24",146,2,2,1,0,-181,-180,-3,-3,-137,-127,-3,-3,4,2,-44,-53,0,0
"7897","24",354,3,1,0,0,-234,226,-2,-2,22,22,1,1,4,1,-256,204,-3,-3
"7898","24",430,5,2,1,1,163,-93,0,0,201,-112,1,1,4,-1,-38,19,-1,-1
"7899","24",131,8,4,1,3,127,-64,0,3,144,-85,-1,3,4,-4,-17,21,1,0
"7900","24",75,1,4,1,2,-8,23,1,-4,177,35,3,-3,4,3,-185,-12,-2,-1
"7901","24",281,1,4,1,2,-6,-238,0,-4,0,-245,-4,-4,4,3,-6,7,4,0
"7902","24",253,9,3,0,3,211,230,4,4,227,227,4,4,4,-5,-16,3,0,0
"7903","24",200,1,3,1,0,-201,-25,-4,-4,-153,-36,-4,-4,4,3,-48,11,0,0
"7904","24",198,6,1,0,1,147,-150,1,1,69,99,2,1,4,-2,78,-249,-1,0
"7905","24",194,8,1,1,0,-23,33,-3,3,-207,11,-4,3,4,-4,184,22,1,0
"7906","24",145,4,1,0,1,-116,-5,-1,-1,-192,-113,0,1,4,0,76,108,-1,-2
"7907","24",166,2,4,1,2,187,180,-2,-3,178,184,-1,-2,4,2,9,-4,-1,-1
"7908","24",162,9,3,1,3,124,153,-2,4,75,64,2,3,4,-5,49,89,-4,1
"7909","24",53,7,4,1,3,201,0,2,2,68,8,2,2,4,-3,133,-8,0,0
"7910","24",5,6,2,1,2,101,33,2,1,66,55,2,2,4,-2,35,-22,0,-1
"7911","24",256,5,3,0,1,-118,-2,0,0,125,92,1,1,4,-1,-243,-94,-1,-1
"7912","24",203,9,4,1,3,244,6,4,4,235,20,4,4,4,-5,9,-14,0,0
"7913","24",367,4,3,1,1,-88,-72,2,-1,-58,-47,2,-2,4,0,-30,-25,0,1
"7914","24",468,8,1,0,3,37,22,1,3,-124,-56,1,1,4,-4,161,78,0,2
"7915","24",245,1,1,0,0,-221,144,-4,-4,-223,4,-3,-4,4,3,2,140,-1,0
"7916","24",148,1,1,0,1,-232,-72,3,-4,-235,-43,2,-4,4,3,3,-29,1,0
"7917","24",356,6,4,1,1,40,4,0,1,221,-1,1,3,4,-2,-181,5,-1,-2
"7918","24",432,4,2,0,1,62,-67,-1,-1,28,-27,0,0,4,0,34,-40,-1,-1
"7919","24",457,7,3,0,1,76,-48,2,2,-130,-135,1,0,4,-3,206,87,1,2
"7920","24",98,1,3,0,0,-182,43,-4,-4,100,-148,1,1,4,3,-282,191,-5,-5
"7921","24",45,1,3,1,0,-72,-33,-2,-4,35,53,1,-1,4,3,-107,-86,-3,-3
"7922","24",206,9,4,1,0,47,34,-1,4,116,42,-1,1,4,-5,-69,-8,0,3
"7923","24",366,9,4,1,3,184,-77,3,4,181,46,3,2,4,-5,3,-123,0,2
"7924","24",362,6,4,1,3,156,-109,2,1,105,-77,3,3,4,-2,51,-32,-1,-2
"7925","24",439,5,2,1,1,7,3,0,0,0,-1,1,1,4,-1,7,4,-1,-1
"7926","24",54,1,4,1,1,97,26,-2,-4,84,41,-4,-4,4,3,13,-15,2,0
"7927","24",359,9,4,1,3,236,12,4,4,233,14,4,4,4,-5,3,-2,0,0
"7928","24",240,5,2,1,1,15,-15,0,0,246,13,-3,-3,4,-1,-231,-28,3,3
"7929","24",132,7,4,1,1,21,-127,1,2,-12,56,0,1,4,-3,33,-183,1,1
"7930","24",76,5,4,1,3,0,-3,2,0,0,-3,0,0,4,-1,0,0,2,0
"7931","24",282,8,3,1,3,51,-116,0,3,174,17,1,4,4,-4,-123,-133,-1,-1
"7932","24",205,6,1,0,2,26,-2,2,1,230,11,3,3,4,-2,-204,-13,-1,-2
"7933","24",201,4,3,1,1,62,-2,-2,-1,5,0,-1,-4,4,0,57,-2,-1,3
"7934","24",199,6,4,1,2,207,114,2,1,166,31,1,1,4,-2,41,83,1,0
"7935","24",195,1,1,0,1,-213,210,4,-4,161,-131,3,-2,4,3,-374,341,1,-2
"7936","24",15,7,4,1,3,-51,50,2,2,21,17,1,2,4,-3,-72,33,1,0
"7937","24",358,1,4,1,2,236,203,0,-4,249,236,0,-4,4,3,-13,-33,0,0
"7938","24",24,5,2,1,2,71,6,0,0,238,1,4,4,4,-1,-167,5,-4,-4
"7939","24",207,5,1,0,0,-249,0,-4,0,-249,4,1,-3,4,-1,0,-4,-5,3
"7940","24",50,3,2,1,1,34,-7,1,-2,139,-42,1,-2,4,1,-105,35,0,0
"7941","24",257,2,1,1,0,217,33,2,-3,171,55,2,-4,4,2,46,-22,0,1
"7942","24",204,5,3,1,1,28,-16,0,0,114,-85,0,0,4,-1,-86,69,0,0
"7943","24",368,9,3,1,3,-145,140,4,4,-119,102,4,4,4,-5,-26,38,0,0
"7944","24",469,1,4,1,0,5,81,-3,-4,83,65,-3,-3,4,3,-78,16,0,-1
"7945","24",246,7,4,1,3,189,-5,3,2,222,4,3,2,4,-3,-33,-9,0,0
"7946","24",149,6,3,1,1,196,-9,-3,1,247,6,-3,2,4,-2,-51,-15,0,-1
"7947","24",357,5,4,1,2,-33,13,0,0,107,64,-1,-1,4,-1,-140,-51,1,1
"7948","24",433,1,1,0,0,-186,-236,-4,-4,198,187,4,-3,4,3,-384,-423,-8,-1
"7949","24",458,3,1,0,1,-73,-62,-1,-2,76,83,-2,-2,4,1,-149,-145,1,0
"7950","24",99,9,4,1,3,52,-36,4,4,228,-20,2,2,4,-5,-176,-16,2,2
"7951","24",450,4,4,1,3,-1,103,-1,-1,-2,7,0,-1,4,0,1,96,-1,0
"7952","24",248,5,4,1,3,30,172,1,0,74,80,3,2,4,-1,-44,92,-2,-2
"7953","24",370,1,1,1,3,-229,-11,-4,-4,-222,-18,0,0,4,3,-7,7,-4,-4
"7954","24",363,8,3,1,3,250,-8,3,3,248,-1,3,3,4,-4,2,-7,0,0
"7955","24",44,1,2,1,2,-76,32,-2,-4,206,-182,0,-2,4,3,-282,214,-2,-2
"7956","24",46,2,1,0,0,-10,-247,-4,-3,-18,-241,-3,-3,4,2,8,-6,-1,0
"7957","24",36,8,3,1,3,160,120,3,3,163,122,2,3,4,-4,-3,-2,1,0
"7958","24",436,5,4,1,3,58,-197,2,0,14,-237,2,-1,4,-1,44,40,0,1
"7959","24",133,1,2,1,1,-86,-204,0,-4,60,-209,1,-1,4,3,-146,5,-1,-3
"7960","24",77,5,3,0,1,-109,17,-1,0,-115,1,-1,-1,4,-1,6,16,0,1
"7961","24",283,6,1,0,1,-110,35,-3,1,-72,-121,-2,1,4,-2,-38,156,-1,0
"7962","24",154,5,4,1,3,-1,15,0,0,-45,105,0,0,4,-1,44,-90,0,0
"7963","24",37,3,1,0,0,-164,-23,-3,-2,-174,-14,-3,-3,4,1,10,-9,0,1
"7964","24",251,2,3,1,1,200,27,2,-3,9,10,2,-2,4,2,191,17,0,-1
"7965","24",434,8,4,0,3,212,-12,3,3,212,-12,2,2,4,-4,0,0,1,1
"7966","24",459,1,3,1,1,-35,44,1,-4,-197,-219,-1,-4,4,3,162,263,2,0
"7967","24",90,6,4,0,0,-235,18,-4,1,114,17,3,4,4,-2,-349,1,-7,-3
"7968","24",435,4,4,1,1,-1,-1,-1,-1,224,3,-1,0,4,0,-225,-4,0,-1
"7969","24",208,2,4,1,2,-141,-18,-3,-3,-51,-2,-4,-4,4,2,-90,-16,1,1
"7970","24",261,9,1,1,3,-88,-113,4,4,110,101,4,4,4,-5,-198,-214,0,0
"7971","24",258,2,3,1,0,-126,3,-3,-3,-127,3,1,-3,4,2,1,0,-4,0
"7972","24",209,6,4,1,3,110,-1,3,1,11,201,1,1,4,-2,99,-202,2,0
"7973","24",369,2,4,1,0,-145,-1,-1,-3,118,0,1,1,4,2,-263,-1,-2,-4
"7974","24",250,6,1,0,3,77,20,1,1,86,25,1,1,4,-2,-9,-5,0,0
"7975","24",247,3,3,1,0,-233,-11,-2,-2,130,-8,1,1,4,1,-363,-3,-3,-3
"7976","24",134,6,2,1,2,34,1,1,1,52,3,1,1,4,-2,-18,-2,0,0
"7977","24",361,1,1,0,0,-249,1,-3,-4,249,-15,4,4,4,3,-498,16,-7,-8
"7978","24",284,5,3,0,1,83,113,0,0,92,44,0,-3,4,-1,-9,69,0,3
"7979","24",155,5,2,1,1,-39,-5,0,0,33,-7,0,0,4,-1,-72,2,0,0
"7980","24",455,3,2,1,2,-52,1,-2,-2,-217,-1,-2,-2,4,1,165,2,0,0
"7981","24",451,1,1,0,0,-207,-161,-4,-4,-141,-132,-2,-2,4,3,-66,-29,-2,-2
"7982","24",249,1,3,1,0,-230,-231,-4,-4,51,-45,1,-4,4,3,-281,-186,-5,0
"7983","24",371,2,3,0,0,-199,79,-4,-3,154,-98,-2,-2,4,2,-353,177,-2,-1
"7984","24",364,5,3,1,1,-12,33,0,0,1,69,-2,0,4,-1,-13,-36,2,0
"7985","24",440,2,3,1,0,-130,2,-3,-3,-12,0,-2,-2,4,2,-118,2,-1,-1
"7986","24",460,4,1,0,0,-157,8,-3,-1,137,24,-2,1,4,0,-294,-16,-1,-2
"7987","24",360,1,3,1,0,-163,-156,-4,-4,24,17,0,-4,4,3,-187,-173,-4,0
"7988","24",437,3,1,0,0,-216,0,-2,-2,-195,-3,-2,-2,4,1,-21,3,0,0
"7989","24",21,4,4,1,2,44,45,1,-1,55,36,1,-1,4,0,-11,9,0,0
"7990","24",78,3,4,1,0,-187,3,-2,-2,-187,3,-2,-2,4,1,0,0,0,0
"7991","24",446,5,4,1,1,16,11,0,0,225,15,-1,0,4,-1,-209,-4,1,0
"7992","24",442,6,4,1,1,27,27,1,1,25,26,1,1,4,-2,2,1,0,0
"7993","24",135,2,1,0,1,-206,154,-3,-3,-160,96,-3,-3,4,2,-46,58,0,0
"7994","24",447,7,4,1,2,162,116,2,2,78,178,2,2,4,-3,84,-62,0,0
"7995","24",87,5,4,1,3,5,-11,0,0,0,-97,1,-1,4,-1,5,86,-1,1
"7996","24",136,1,1,0,0,0,0,-4,-4,0,-1,-3,-3,4,3,0,1,-1,-1
"7997","24",91,4,2,1,3,61,5,1,-1,243,1,2,2,4,0,-182,4,-1,-3
"7998","24",88,9,4,1,2,215,-159,4,4,233,-180,3,4,4,-5,-18,21,1,0
"7999","24",212,1,1,1,1,-237,31,0,-4,-237,35,0,-3,4,3,0,-4,0,-1
"8000","24",262,6,4,1,3,108,-2,1,1,76,70,1,1,4,-2,32,-72,0,0
"8001","24",259,1,3,1,1,-58,22,4,-4,-91,33,4,-4,4,3,33,-11,0,0
"8002","24",441,9,4,1,2,42,-73,4,4,36,-169,3,4,4,-5,6,96,1,0
"8003","24",461,5,4,1,2,162,33,0,0,109,22,-1,-1,4,-1,53,11,1,1
"8004","24",93,5,1,0,1,-122,69,-2,0,-151,94,-2,0,4,-1,29,-25,0,0
"8005","24",438,6,4,1,3,140,-1,4,1,97,-3,4,2,4,-2,43,2,0,-1
"8006","24",210,3,4,1,2,140,124,2,-2,38,29,1,-1,4,1,102,95,1,-1
"8007","24",94,6,4,1,1,54,-72,1,1,104,-69,1,1,4,-2,-50,-3,0,0
"8008","24",285,6,2,1,1,-77,38,-2,1,-85,66,-3,-1,4,-2,8,-28,1,2
"8009","24",211,7,3,0,1,-24,-20,-1,2,112,151,-2,1,4,-3,-136,-171,1,1
"8010","24",456,2,1,1,0,-193,94,-1,-3,157,161,2,-1,4,2,-350,-67,-3,-2
"8011","24",452,2,3,1,1,-169,2,-3,-3,-6,-37,0,0,4,2,-163,39,-3,-3
"8012","24",25,4,4,1,2,-24,-16,-1,-1,-14,-17,-1,-1,4,0,-10,1,0,0
"8013","24",372,1,3,0,0,-179,-231,-4,-4,100,102,0,-1,4,3,-279,-333,-4,-3
"8014","24",365,5,3,1,1,-196,-5,0,0,-233,3,-4,-4,4,-1,37,-8,4,4
"8015","24",89,1,3,1,0,-126,-1,-4,-4,-172,2,-4,-1,4,3,46,-3,0,-3
"8016","24",213,7,2,1,1,4,74,1,2,58,1,1,1,4,-3,-54,73,0,1
"8017","24",263,2,4,1,0,-205,-12,-3,-3,-221,-5,-2,-3,4,2,16,-7,-1,0
"8018","24",26,1,1,0,0,-227,-57,-4,-4,132,133,-3,-4,4,3,-359,-190,-1,0
"8019","24",150,5,3,1,1,-4,-1,0,0,53,1,0,0,4,-1,-57,-2,0,0
"8020","24",79,5,4,0,2,-13,-10,0,0,166,-8,2,2,4,-1,-179,-2,-2,-2
"8021","24",231,1,4,1,0,-46,-42,0,-4,-121,-116,-4,1,4,3,75,74,4,-5
"8022","24",443,4,1,0,0,-61,-13,-1,-1,50,58,1,1,4,0,-111,-71,-2,-2
"8023","24",14,5,3,0,1,-47,-3,0,0,210,-29,2,2,4,-1,-257,26,-2,-2
"8024","24",448,4,2,1,2,7,-1,0,-1,17,0,1,1,4,0,-10,-1,-1,-2
"8025","24",228,8,4,1,2,-93,87,2,3,24,70,1,2,4,-4,-117,17,1,1
"8026","24",137,4,1,0,1,-208,-208,-3,-1,146,146,1,-1,4,0,-354,-354,-4,0
"8027","24",92,5,4,1,2,0,6,0,0,0,-4,0,0,4,-1,0,10,0,0
"8028","24",453,7,4,1,2,202,-2,2,2,189,9,3,3,4,-3,13,-11,-1,-1
"8029","24",445,6,4,1,3,99,-20,1,1,103,-69,1,1,4,-2,-4,49,0,0
"8030","24",138,6,3,0,1,132,-24,1,1,68,-46,1,1,4,-2,64,22,0,0
"8031","24",230,7,1,1,0,-101,-13,-2,2,-216,27,-3,2,4,-3,115,-40,1,0
"8032","24",9,5,4,1,2,80,24,1,0,33,29,1,-1,4,-1,47,-5,0,1
"8033","24",139,9,4,1,2,124,-2,4,4,246,5,4,4,4,-5,-122,-7,0,0
"8034","24",264,4,4,1,2,119,47,0,-1,49,40,0,-1,4,0,70,7,0,0
"8035","24",227,7,3,0,3,-88,-9,3,2,-12,43,1,1,4,-3,-76,-52,2,1
"8036","24",215,2,1,0,0,-172,31,-2,-3,55,25,-2,-3,4,2,-227,6,0,0
"8037","24",95,5,4,1,2,-2,6,0,0,0,-33,1,1,4,-1,-2,39,-1,-1
"8038","24",286,6,1,0,3,95,-1,1,1,64,-3,0,1,4,-2,31,2,1,0
"8039","24",216,4,3,1,1,33,-7,0,-1,-76,-9,0,1,4,0,109,2,0,-2
"8040","24",234,5,3,1,3,120,28,1,0,84,83,0,1,4,-1,36,-55,1,-1
"8041","24",449,6,4,1,3,87,90,1,1,42,54,1,2,4,-2,45,36,0,-1
"8042","24",229,2,1,0,1,-234,74,-3,-3,-230,-92,-3,-3,4,2,-4,166,0,0
"8043","24",217,3,4,1,2,75,37,1,-2,67,38,1,-1,4,1,8,-1,0,-1
"8044","24",97,2,1,0,1,-239,29,3,-3,65,25,3,-2,4,2,-304,4,0,-1
"8045","24",454,8,4,0,3,201,3,3,3,218,2,3,4,4,-4,-17,1,0,-1
"8046","24",214,9,1,0,3,129,2,4,4,127,-1,3,4,4,-5,2,3,1,0
"8047","24",142,5,2,1,2,84,-9,1,0,106,68,-1,0,4,-1,-22,-77,2,0
"8048","24",260,3,3,0,0,-223,-224,-2,-2,-212,-203,-2,-2,4,1,-11,-21,0,0
"8049","24",151,1,2,1,1,-22,6,0,-4,-20,13,0,-4,4,3,-2,-7,0,0
"8050","24",8,5,3,1,1,44,19,0,0,20,233,1,2,4,-1,24,-214,-1,-2
"8051","24",237,5,2,1,2,62,1,-1,0,64,1,-1,0,4,-1,-2,0,0,0
"8052","24",444,5,2,1,2,4,-1,0,0,46,0,1,0,4,-1,-42,-1,-1,0
"8053","24",140,6,1,0,1,11,-38,1,1,6,54,-1,-1,4,-2,5,-92,2,2
"8054","24",96,4,1,0,0,-27,3,-1,-1,-8,1,-3,-2,4,0,-19,2,2,1
"8055","24",287,7,4,1,3,180,-6,2,2,20,-3,4,4,4,-3,160,-3,-2,-2
"8056","24",153,6,1,0,3,-3,4,1,1,-27,23,1,2,4,-2,24,-19,0,-1
"8057","24",235,1,3,0,0,-249,5,-4,-4,170,-3,2,2,4,3,-419,8,-6,-6
"8058","24",81,3,1,0,0,-59,36,-2,-2,-98,83,-3,-3,4,1,39,-47,1,1
"8059","24",23,9,1,0,3,213,215,4,4,200,205,4,4,4,-5,13,10,0,0
"8060","24",218,8,4,1,3,98,48,4,3,93,33,4,3,4,-4,5,15,0,0
"8061","24",236,5,1,0,1,-25,-16,0,0,20,-21,0,0,4,-1,-45,5,0,0
"8062","24",232,1,1,0,0,-133,-19,-2,-4,-229,-4,-2,-4,4,3,96,-15,0,0
"8063","24",223,5,1,0,1,-3,-1,0,0,114,-38,-1,0,4,-1,-117,37,1,0
"8064","24",292,5,3,0,1,-4,-56,0,0,217,-1,0,0,4,-1,-221,-55,0,0
"8065","24",233,6,2,1,2,13,26,1,1,46,47,1,1,4,-2,-33,-21,0,0
"8066","24",152,1,1,0,0,-129,0,-1,-4,-27,-1,0,-3,4,3,-102,1,-1,-1
"8067","24",80,7,4,1,3,213,5,3,2,226,1,3,-2,4,-3,-13,4,0,4
"8068","24",238,5,3,0,1,-148,-2,2,0,68,-23,0,-2,4,-1,-216,21,2,2
"8069","24",290,4,1,1,1,36,-52,0,-1,136,-153,0,-2,4,0,-100,101,0,1
"8070","24",141,1,1,0,0,-12,-16,-4,-4,77,12,1,1,4,3,-89,-28,-5,-5
"8071","24",225,8,2,1,2,55,117,1,3,195,-44,1,1,4,-4,-140,161,0,2
"8072","24",288,5,2,1,2,-17,1,-1,0,55,-110,2,1,4,-1,-72,111,-3,-1
"8073","24",291,5,4,1,2,33,-4,-1,0,133,186,2,3,4,-1,-100,-190,-3,-3
"8074","24",226,2,1,0,0,-42,1,-1,-3,132,0,2,-2,4,2,-174,1,-3,-1
"8075","24",82,9,4,1,2,-229,-20,4,4,18,238,4,4,4,-5,-247,-258,0,0
"8076","24",219,5,4,1,3,249,1,4,0,249,1,4,0,4,-1,0,0,0,0
"8077","24",222,2,1,0,0,-233,5,-3,-3,-228,-1,-3,-3,4,2,-5,6,0,0
"8078","24",83,6,1,0,3,93,-134,2,1,125,-133,2,1,4,-2,-32,-1,0,0
"8079","24",29,1,4,1,0,-169,191,-4,-4,155,118,-2,-1,4,3,-324,73,-2,-3
"8080","24",224,7,2,1,2,91,111,2,2,183,68,2,1,4,-3,-92,43,0,1
"8081","24",239,3,1,1,1,-80,-31,-2,-2,92,163,1,1,4,1,-172,-194,-3,-3
"8082","24",84,8,4,1,3,191,4,3,3,194,1,2,2,4,-4,-3,3,1,1
"8083","24",294,7,1,0,3,67,0,2,2,0,3,0,2,4,-3,67,-3,2,0
"8084","24",22,5,3,0,1,136,17,0,0,112,20,2,2,4,-1,24,-3,-2,-2
"8085","24",289,8,1,0,3,194,175,3,3,214,211,2,3,4,-4,-20,-36,1,0
"8086","24",85,6,2,1,2,97,143,3,1,125,127,3,4,4,-2,-28,16,0,-3
"8087","24",295,5,1,0,1,5,-1,0,0,1,9,0,0,4,-1,4,-10,0,0
"8088","24",220,2,4,1,2,105,98,-3,-3,118,107,-2,-2,4,2,-13,-9,-1,-1
"8089","24",293,1,4,1,0,-237,4,-4,-4,-171,12,-4,-4,4,3,-66,-8,0,0
"8090","24",86,7,4,1,3,172,8,2,2,123,-125,2,3,4,-3,49,133,0,-1
"8091","24",296,7,1,0,3,185,-6,1,2,160,1,2,2,4,-3,25,-7,-1,0
"8092","24",221,2,4,1,1,-214,3,-4,-3,6,11,1,2,4,2,-220,-8,-5,-5
"8093","25",341,9,1,0,3,241,-44,4,4,248,-29,3,4,5,-4,-7,-15,1,0
"8094","25",332,1,1,0,0,-249,129,-4,-4,-246,55,-3,-3,5,4,-3,74,-1,-1
"8095","25",330,6,2,1,2,209,195,1,1,196,194,1,1,5,-1,13,1,0,0
"8096","25",395,8,3,0,1,-184,67,-2,3,225,30,-2,4,5,-3,-409,37,0,-1
"8097","25",463,5,4,1,3,232,2,1,0,-20,-226,3,1,5,0,252,228,-2,-1
"8098","25",462,9,3,0,3,-30,25,4,4,217,207,2,-4,5,-4,-247,-182,2,8
"8099","25",331,2,1,0,0,-17,-175,-4,-3,-29,-196,-4,-3,5,3,12,21,0,0
"8100","25",396,1,1,0,1,-245,245,4,-4,12,-17,2,2,5,4,-257,262,2,-6
"8101","25",464,6,1,0,1,90,8,1,1,68,25,1,1,5,-1,22,-17,0,0
"8102","25",342,4,3,1,1,7,18,0,-1,-114,24,-2,-3,5,1,121,-6,2,2
"8103","25",68,2,4,1,0,69,1,0,-3,179,1,0,-2,5,3,-110,0,0,-1
"8104","25",336,3,4,1,3,180,184,3,-2,182,151,-2,3,5,2,-2,33,5,-5
"8105","25",100,9,4,1,3,246,1,3,4,225,4,3,3,5,-4,21,-3,0,1
"8106","25",333,7,4,1,1,135,-26,2,2,73,-65,1,2,5,-2,62,39,1,0
"8107","25",69,7,4,1,1,32,34,1,2,-72,28,1,1,5,-2,104,6,0,1
"8108","25",101,1,3,0,0,-245,245,-4,-4,228,234,-3,-3,5,4,-473,11,-1,-1
"8109","25",334,3,4,1,0,-145,203,-4,-2,-246,137,-4,-4,5,2,101,66,0,2
"8110","25",66,4,1,1,1,80,2,1,-1,-160,4,-1,0,5,1,240,-2,2,-1
"8111","25",338,1,3,1,2,30,24,-4,-4,42,-40,-4,-4,5,4,-12,64,0,0
"8112","25",410,1,1,0,0,-49,-5,-3,-4,-16,-19,-1,-3,5,4,-33,14,-2,-1
"8113","25",335,5,2,1,1,-35,12,0,0,-32,11,-1,0,5,0,-3,1,1,0
"8114","25",407,9,2,1,2,213,18,4,4,23,-74,2,2,5,-4,190,92,2,2
"8115","25",343,6,2,1,2,113,0,1,1,109,3,1,1,5,-1,4,-3,0,0
"8116","25",411,9,2,1,2,246,235,4,4,229,227,4,4,5,-4,17,8,0,0
"8117","25",408,3,1,0,0,-146,-11,-3,-2,11,-4,1,0,5,2,-157,-7,-4,-2
"8118","25",465,7,4,1,3,12,10,3,2,-7,-225,2,1,5,-2,19,235,1,1
"8119","25",344,7,4,1,3,99,72,3,2,-80,-44,-1,0,5,-2,179,116,4,2
"8120","25",412,9,1,0,0,-244,1,-2,4,245,1,4,4,5,-4,-489,0,-6,0
"8121","25",337,9,2,1,3,241,237,4,4,244,-16,4,4,5,-4,-3,253,0,0
"8122","25",345,8,1,0,0,-231,239,-4,3,10,-12,0,0,5,-3,-241,251,-4,3
"8123","25",413,4,1,1,1,-194,-1,-1,-1,-219,-6,-3,-3,5,1,25,5,2,2
"8124","25",418,6,2,1,2,169,-97,0,1,192,-33,2,1,5,-1,-23,-64,-2,0
"8125","25",102,9,4,1,3,110,56,3,4,-84,58,2,3,5,-4,194,-2,1,1
"8126","25",67,2,1,0,0,-239,17,-4,-3,67,-102,1,1,5,3,-306,119,-5,-4
"8127","25",1,4,1,0,1,-96,-75,-1,-1,23,26,1,2,5,1,-119,-101,-2,-3
"8128","25",339,3,3,0,1,86,62,-2,-2,52,71,-2,-2,5,2,34,-9,0,0
"8129","25",103,6,2,1,3,135,-1,2,1,201,1,2,2,5,-1,-66,-2,0,-1
"8130","25",10,6,3,0,1,-63,-2,1,1,-205,-1,0,-1,5,-1,142,-1,1,2
"8131","25",397,6,4,0,3,64,-89,-3,1,-101,-132,1,3,5,-1,165,43,-4,-2
"8132","25",34,7,4,1,2,105,-82,1,2,86,-51,3,2,5,-2,19,-31,-2,0
"8133","25",104,1,1,0,0,-229,4,3,-4,-227,2,-1,-3,5,4,-2,2,4,-1
"8134","25",409,7,4,1,2,113,120,2,2,124,125,2,2,5,-2,-11,-5,0,0
"8135","25",466,2,3,0,0,-97,-100,-3,-3,-111,-111,-2,-2,5,3,14,11,-1,-1
"8136","25",105,1,1,0,0,-244,93,-4,-4,-233,-39,-4,-4,5,4,-11,132,0,0
"8137","25",7,6,1,0,3,31,138,2,1,149,106,1,2,5,-1,-118,32,1,-1
"8138","25",467,5,1,0,3,-83,-92,4,0,20,79,4,0,5,0,-103,-171,0,0
"8139","25",414,2,1,0,0,-165,-162,-3,-3,38,37,0,0,5,3,-203,-199,-3,-3
"8140","25",390,9,2,1,2,227,240,4,4,187,143,2,4,5,-4,40,97,2,0
"8141","25",419,6,4,1,3,201,116,1,1,181,110,0,0,5,-1,20,6,1,1
"8142","25",468,7,1,0,3,178,43,3,2,-57,-86,1,1,5,-2,235,129,2,1
"8143","25",415,9,2,1,2,190,221,0,4,164,195,0,1,5,-4,26,26,0,3
"8144","25",266,3,1,0,1,1,1,-2,-2,2,0,0,0,5,2,-1,1,-2,-2
"8145","25",40,7,1,0,2,-171,70,-3,2,186,134,2,1,5,-2,-357,-64,-5,1
"8146","25",469,2,4,1,0,69,50,-2,-3,86,83,-3,-4,5,3,-17,-33,1,1
"8147","25",48,1,3,0,0,-3,1,-4,-4,64,-63,-4,-4,5,4,-67,64,0,0
"8148","25",398,9,4,1,2,241,239,4,4,242,247,4,4,5,-4,-1,-8,0,0
"8149","25",340,4,1,0,1,-71,-24,0,-1,34,22,0,0,5,1,-105,-46,0,-1
"8150","25",39,5,3,0,1,-191,-2,-2,0,150,-187,3,0,5,0,-341,185,-5,0
"8151","25",421,5,3,0,1,-169,-242,0,0,0,-1,0,0,5,0,-169,-241,0,0
"8152","25",346,7,3,0,0,-249,-73,0,2,248,17,1,3,5,-2,-497,-90,-1,-1
"8153","25",106,6,2,1,1,56,20,1,1,82,17,1,1,5,-1,-26,3,0,0
"8154","25",265,9,1,0,3,161,1,3,4,-3,0,0,0,5,-4,164,1,3,4
"8155","25",111,5,1,0,0,-230,-229,-2,0,59,215,2,2,5,0,-289,-444,-4,-2
"8156","25",347,9,1,1,3,-197,199,4,4,-155,150,2,4,5,-4,-42,49,2,0
"8157","25",71,4,3,0,1,-110,14,-1,-1,21,17,0,0,5,1,-131,-3,-1,-1
"8158","25",42,2,3,0,1,-13,-28,2,-3,7,13,2,-2,5,3,-20,-41,0,-1
"8159","25",112,7,4,1,3,241,4,-4,2,245,2,-3,-3,5,-2,-4,2,-1,5
"8160","25",416,1,4,1,0,-220,234,-4,-4,-240,242,-4,-4,5,4,20,-8,0,0
"8161","25",420,8,4,1,3,-1,48,2,3,-28,2,0,0,5,-3,27,46,2,3
"8162","25",400,6,4,1,2,152,41,1,1,109,-77,-1,-1,5,-1,43,118,2,2
"8163","25",380,1,4,1,1,-211,-43,3,-4,170,-61,3,-3,5,4,-381,18,0,-1
"8164","25",41,6,2,1,3,100,100,3,1,89,92,3,1,5,-1,11,8,0,0
"8165","25",122,5,1,0,0,7,-73,0,0,194,189,-1,0,5,0,-187,-262,1,0
"8166","25",470,4,1,0,1,-133,-76,-1,-1,-47,31,1,1,5,1,-86,-107,-2,-2
"8167","25",70,5,2,1,2,229,201,1,0,7,168,-1,-4,5,0,222,33,2,4
"8168","25",4,5,3,0,1,-3,-1,0,0,219,127,1,3,5,0,-222,-128,-1,-3
"8169","25",123,3,4,1,2,53,-26,-2,-2,-31,-23,-2,-2,5,2,84,-3,0,0
"8170","25",391,7,2,1,3,162,225,4,2,154,141,0,0,5,-2,8,84,4,2
"8171","25",388,4,4,1,0,-249,9,-4,-1,-246,6,-2,-1,5,1,-3,3,-2,0
"8172","25",403,4,1,0,0,-147,-19,0,-1,-1,-34,2,1,5,1,-146,15,-2,-2
"8173","25",348,3,3,0,1,95,73,0,-2,84,63,0,-2,5,2,11,10,0,0
"8174","25",267,4,3,0,1,100,1,-1,-1,100,2,1,1,5,1,0,-1,-2,-2
"8175","25",473,4,3,0,0,-97,-21,-1,-1,-121,-33,-1,-1,5,1,24,12,0,0
"8176","25",47,8,4,1,3,106,-85,1,3,97,2,1,2,5,-3,9,-87,0,1
"8177","25",49,7,4,1,1,201,105,2,2,100,118,2,2,5,-2,101,-13,0,0
"8178","25",399,6,4,1,3,112,16,1,1,102,2,1,1,5,-1,10,14,0,0
"8179","25",114,2,4,1,1,-7,-15,0,-3,112,148,1,-3,5,3,-119,-163,-1,0
"8180","25",272,6,4,1,2,100,74,1,1,110,-31,0,1,5,-1,-10,105,1,0
"8181","25",422,2,3,0,1,-5,-85,2,-3,-102,-89,3,-3,5,3,97,4,-1,0
"8182","25",115,6,3,0,3,3,2,1,1,59,1,0,0,5,-1,-56,1,1,1
"8183","25",107,2,2,0,3,-18,158,1,-3,-2,99,-2,3,5,3,-16,59,3,-6
"8184","25",50,3,2,1,1,103,-137,1,-2,149,-37,2,-2,5,2,-46,-100,-1,0
"8185","25",423,8,1,0,3,-140,-19,3,3,-57,85,-1,-1,5,-3,-83,-104,4,4
"8186","25",124,7,1,0,3,229,-4,3,2,205,-93,1,2,5,-2,24,89,2,0
"8187","25",72,2,1,0,0,-199,66,-2,-3,163,157,2,2,5,3,-362,-91,-4,-5
"8188","25",389,5,3,0,2,-226,-4,4,0,-2,-1,0,0,5,0,-224,-3,4,0
"8189","25",113,7,2,1,2,207,204,2,2,56,29,0,0,5,-2,151,175,2,2
"8190","25",417,7,2,1,2,6,-3,2,2,64,62,1,1,5,-2,-58,-65,1,1
"8191","25",474,1,1,0,0,0,-52,0,-4,0,-87,0,-4,5,4,0,35,0,0
"8192","25",401,7,2,1,1,140,13,1,2,103,13,-1,1,5,-2,37,0,2,1
"8193","25",381,8,2,1,2,165,207,3,3,230,198,3,3,5,-3,-65,9,0,0
"8194","25",269,6,4,1,2,145,2,0,1,183,3,0,1,5,-1,-38,-1,0,0
"8195","25",402,1,3,0,0,-246,1,3,-4,56,-1,-1,1,5,4,-302,2,4,-5
"8196","25",471,4,3,0,2,-129,128,4,-1,-212,26,-2,0,5,1,83,102,6,-1
"8197","25",273,1,1,0,0,-209,-225,-3,-4,157,59,1,0,5,4,-366,-284,-4,-4
"8198","25",27,5,2,1,2,118,84,1,0,91,101,1,1,5,0,27,-17,0,-1
"8199","25",116,6,2,1,3,76,-16,1,1,36,-15,1,1,5,-1,40,-1,0,0
"8200","25",392,3,1,0,0,-151,109,-2,-2,-137,9,0,-2,5,2,-14,100,-2,0
"8201","25",56,4,3,0,1,48,-126,-2,-1,67,-103,-2,0,5,1,-19,-23,0,-1
"8202","25",404,5,1,0,1,55,-47,1,0,54,-47,1,0,5,0,1,0,0,0
"8203","25",349,8,4,0,1,-97,30,1,3,74,-82,1,1,5,-3,-171,112,0,2
"8204","25",268,8,4,1,3,120,90,3,3,119,-114,3,3,5,-3,1,204,0,0
"8205","25",425,7,4,1,2,18,91,2,2,1,16,0,0,5,-2,17,75,2,2
"8206","25",126,4,2,1,2,123,203,-1,-1,27,186,-1,-1,5,1,96,17,0,0
"8207","25",5,8,2,1,2,118,77,2,3,120,106,3,3,5,-3,-2,-29,-1,0
"8208","25",475,4,3,0,3,160,114,-1,-1,77,-74,0,0,5,1,83,188,-1,-1
"8209","25",387,1,3,0,1,124,78,-3,-4,165,164,2,3,5,4,-41,-86,-5,-7
"8210","25",59,1,1,0,0,-194,195,-4,-4,124,102,2,2,5,4,-318,93,-6,-6
"8211","25",55,5,4,1,1,-8,7,0,0,-31,-7,0,0,5,0,23,14,0,0
"8212","25",233,6,2,1,2,10,-43,1,1,19,27,0,0,5,-1,-9,-70,1,1
"8213","25",108,9,2,1,3,208,219,4,4,230,218,4,4,5,-4,-22,1,0,0
"8214","25",51,7,4,1,1,-32,146,1,2,77,-61,1,-1,5,-2,-109,207,0,3
"8215","25",424,6,2,1,2,46,50,1,1,70,107,1,1,5,-1,-24,-57,0,0
"8216","25",125,5,4,1,0,-178,-30,-3,0,236,-239,-4,-2,5,0,-414,209,1,2
"8217","25",73,4,4,1,2,-96,-87,1,-1,-125,-123,-1,1,5,1,29,36,2,-2
"8218","25",243,6,2,1,2,247,-66,2,1,247,-55,2,2,5,-1,0,-11,0,-1
"8219","25",386,1,1,0,0,-248,176,-4,-4,12,14,1,1,5,4,-260,162,-5,-5
"8220","25",394,1,3,0,0,-247,246,-4,-4,-233,240,-4,-4,5,4,-14,6,0,0
"8221","25",244,3,4,1,2,27,-35,0,-2,228,236,3,1,5,2,-201,-271,-3,-3
"8222","25",232,1,1,0,0,-247,-245,-4,-4,-161,-57,-1,-4,5,4,-86,-188,-3,0
"8223","25",382,6,4,1,2,93,-1,2,1,63,-6,1,1,5,-1,30,5,1,0
"8224","25",379,5,3,1,1,63,-52,-2,0,-19,-38,1,-1,5,0,82,-14,-3,1
"8225","25",476,2,3,0,0,-234,-224,-3,-3,-174,-161,-1,-1,5,3,-60,-63,-2,-2
"8226","25",472,1,1,0,0,-237,242,-4,-4,-223,24,-4,-4,5,4,-14,218,0,0
"8227","25",274,7,4,1,2,171,119,2,2,113,126,2,2,5,-2,58,-7,0,0
"8228","25",270,5,3,1,1,0,2,0,0,-3,246,4,4,5,0,3,-244,-4,-4
"8229","25",117,3,4,1,2,78,49,-1,-2,38,-3,-2,-3,5,2,40,52,1,1
"8230","25",393,1,1,0,0,-199,-174,-4,-4,24,-77,-4,-4,5,4,-223,-97,0,0
"8231","25",57,1,4,1,1,162,-231,2,-4,111,-140,0,-4,5,4,51,-91,2,0
"8232","25",405,5,4,1,1,177,-125,2,0,91,2,1,0,5,0,86,-127,1,0
"8233","25",35,4,1,0,3,38,169,0,-1,129,166,2,-1,5,1,-91,3,-2,0
"8234","25",74,1,3,0,0,-148,-45,-4,-4,-194,-54,-3,-4,5,4,46,9,-1,0
"8235","25",426,7,4,1,3,236,0,4,2,242,0,3,2,5,-2,-6,0,1,0
"8236","25",127,1,1,0,0,-226,6,-4,-4,122,1,1,-3,5,4,-348,5,-5,-1
"8237","25",249,1,3,0,0,-222,-211,-3,-4,23,-30,1,-4,5,4,-245,-181,-4,0
"8238","25",245,1,1,0,0,-248,91,-4,-4,-196,-5,-3,-4,5,4,-52,96,-1,0
"8239","25",169,1,3,0,0,-247,221,-4,-4,-229,213,-4,-4,5,4,-18,8,0,0
"8240","25",6,7,4,1,2,157,-2,2,2,157,-2,2,2,5,-2,0,0,0,0
"8241","25",384,2,1,0,0,-123,1,-3,-3,1,102,-2,-2,5,3,-124,-101,-1,-1
"8242","25",234,4,3,1,3,83,58,0,-1,37,115,0,1,5,1,46,-57,0,-2
"8243","25",109,1,1,0,1,-1,-201,2,-4,-4,-211,3,-4,5,4,3,10,-1,0
"8244","25",52,2,3,0,0,-96,5,2,-3,3,182,2,-1,5,3,-99,-177,0,-2
"8245","25",259,1,3,0,1,-118,34,4,-4,0,1,4,-4,5,4,-118,33,0,0
"8246","25",255,5,3,0,1,-79,-75,0,0,-60,-162,1,0,5,0,-19,87,-1,0
"8247","25",276,7,4,1,3,176,-1,2,2,181,8,3,2,5,-2,-5,-9,-1,0
"8248","25",2,7,4,1,1,157,-77,3,2,76,-73,1,2,5,-2,81,-4,2,0
"8249","25",119,5,3,0,3,-78,95,0,0,-209,-87,-2,-2,5,0,131,182,2,2
"8250","25",62,9,2,1,3,95,93,3,4,214,202,2,4,5,-4,-119,-109,1,0
"8251","25",196,1,3,0,0,-242,3,-4,-4,134,166,2,2,5,4,-376,-163,-6,-6
"8252","25",192,7,4,0,1,-1,-80,1,2,-72,0,-1,0,5,-2,71,-80,2,2
"8253","25",383,5,4,1,1,0,-5,0,0,0,-1,0,0,5,0,0,-4,0,0
"8254","25",38,9,4,1,3,231,-46,4,4,48,39,4,4,5,-4,183,-85,0,0
"8255","25",258,3,3,0,0,-51,1,-2,-2,-25,-1,-2,-4,5,2,-26,2,0,2
"8256","25",254,4,2,1,3,231,-221,-3,-1,212,-112,-1,-1,5,1,19,-109,-2,0
"8257","25",275,9,4,1,2,-2,249,4,4,214,1,1,1,5,-4,-216,248,3,3
"8258","25",271,4,3,0,1,-119,-3,-1,-1,227,4,4,4,5,1,-346,-7,-5,-5
"8259","25",118,5,3,0,1,-92,38,-2,0,-53,64,-2,-1,5,0,-39,-26,0,1
"8260","25",61,1,1,0,3,249,-5,4,-4,164,-2,4,-4,5,4,85,-3,0,0
"8261","25",58,9,4,1,1,-246,1,-4,4,2,246,4,4,5,-4,-248,-245,-8,0
"8262","25",406,8,2,1,2,159,146,1,3,194,-51,-1,1,5,-3,-35,197,2,2
"8263","25",350,6,4,1,1,7,-244,2,1,2,-245,2,-1,5,-1,5,1,0,2
"8264","25",75,3,4,1,2,236,34,2,-2,240,37,2,-4,5,2,-4,-3,0,2
"8265","25",427,3,4,1,1,247,58,2,-2,-199,-33,2,-2,5,2,446,91,0,0
"8266","25",128,7,1,0,3,202,2,2,2,202,2,2,2,5,-2,0,0,0,0
"8267","25",25,4,4,1,2,0,7,0,-1,4,1,-1,-1,5,1,-4,6,1,0
"8268","25",246,8,4,1,3,217,0,4,3,156,3,3,3,5,-3,61,-3,1,0
"8269","25",17,1,3,0,0,-28,56,-2,-4,144,104,-2,-4,5,4,-172,-48,0,0
"8270","25",60,8,1,0,3,222,4,3,3,234,2,2,3,5,-3,-12,2,1,0
"8271","25",385,4,4,1,1,88,80,1,-1,172,80,2,-2,5,1,-84,0,-1,1
"8272","25",235,1,3,1,0,-233,-1,-4,-4,242,3,3,3,5,4,-475,-4,-7,-7
"8273","25",11,7,4,1,1,4,-5,0,2,-156,87,-1,1,5,-2,160,-92,1,1
"8274","25",53,7,4,1,3,213,-3,2,2,201,-1,2,1,5,-2,12,-2,0,1
"8275","25",26,1,1,0,0,-243,0,-4,-4,-1,-63,-1,-4,5,4,-242,63,-3,0
"8276","25",256,5,3,0,1,-127,-1,0,0,105,94,0,0,5,0,-232,-95,0,0
"8277","25",277,5,4,1,1,96,-105,2,0,23,-125,0,0,5,0,73,20,2,0
"8278","25",20,1,3,0,0,-209,-221,4,-4,68,58,2,4,5,4,-277,-279,2,-8
"8279","25",12,9,4,1,3,-1,-1,4,4,1,0,4,4,5,-4,-2,-1,0,0
"8280","25",63,5,4,0,1,-1,3,0,0,-2,4,-1,-1,5,0,1,-1,1,1
"8281","25",197,1,4,1,3,-228,-195,4,-4,-233,-1,4,-2,5,4,5,-194,0,-2
"8282","25",193,1,1,0,0,-223,-151,-4,-4,140,-67,1,1,5,4,-363,-84,-5,-5
"8283","25",460,4,1,0,0,-226,42,-4,-1,146,14,-2,1,5,1,-372,28,-2,-2
"8284","25",307,5,4,1,2,25,24,0,0,240,98,3,3,5,0,-215,-74,-3,-3
"8285","25",98,1,3,0,0,-232,30,-4,-4,-102,-129,-1,-1,5,4,-130,159,-3,-3
"8286","25",373,1,3,0,0,-226,-35,0,-4,-214,-70,0,-4,5,4,-12,35,0,0
"8287","25",251,2,3,0,1,-165,-11,-3,-3,180,35,3,-3,5,3,-345,-46,-6,0
"8288","25",248,5,4,1,3,157,2,1,0,1,81,1,-1,5,0,156,-79,0,1
"8289","25",171,5,1,0,1,33,14,0,0,33,31,0,0,5,0,0,-17,0,0
"8290","25",168,4,1,1,3,69,-153,1,-1,84,-72,1,2,5,1,-15,-81,0,-3
"8291","25",240,1,2,1,1,-235,14,-4,-4,211,-6,1,-2,5,4,-446,20,-5,-2
"8292","25",237,7,2,1,2,166,56,0,2,87,40,0,1,5,-2,79,16,0,1
"8293","25",351,1,1,0,0,-246,-245,-4,-4,136,117,-4,-4,5,4,-382,-362,0,0
"8294","25",76,5,4,1,3,3,1,3,0,8,5,0,0,5,0,-5,-4,3,0
"8295","25",428,1,1,0,0,-245,-245,-4,-4,-247,-249,-4,-4,5,4,2,4,0,0
"8296","25",129,3,4,1,1,-211,2,-2,-2,-225,-115,-2,-2,5,2,14,117,0,0
"8297","25",250,6,1,0,3,88,20,1,1,91,22,1,1,5,-1,-3,-2,0,0
"8298","25",247,3,3,0,0,-238,-6,-2,-2,159,-3,1,1,5,2,-397,-3,-3,-3
"8299","25",170,2,2,1,0,109,103,-3,-3,81,77,0,0,5,3,28,26,-3,-3
"8300","25",167,3,1,0,3,-101,101,-2,-2,-95,96,-2,-2,5,2,-6,5,0,0
"8301","25",24,7,2,1,2,156,-3,1,2,228,-6,3,3,5,-2,-72,3,-2,-1
"8302","25",236,5,1,0,1,-72,-25,0,0,29,-23,-1,0,5,0,-101,-2,1,0
"8303","25",110,2,1,0,1,-98,56,3,-3,109,-113,-3,1,5,3,-207,169,6,-4
"8304","25",54,2,4,1,1,50,14,1,-3,55,37,0,0,5,3,-5,-23,1,-3
"8305","25",260,2,3,0,0,-245,-247,-3,-3,-212,-213,-2,-2,5,3,-33,-34,-1,-1
"8306","25",257,1,1,0,0,130,53,2,-4,176,147,2,-4,5,4,-46,-94,0,0
"8307","25",278,1,4,1,1,230,-67,4,-4,222,51,4,-4,5,4,8,-118,0,0
"8308","25",200,1,3,1,0,-209,-50,-4,-4,-189,-54,-3,-4,5,4,-20,4,-1,0
"8309","25",120,8,3,0,1,95,-54,3,3,95,-135,0,0,5,-3,0,81,3,3
"8310","25",64,9,1,0,1,239,-4,4,4,215,-55,4,4,5,-4,24,51,0,0
"8311","25",198,2,1,1,1,-220,-178,-2,-3,18,-80,0,0,5,3,-238,-98,-2,-3
"8312","25",194,8,1,0,0,-182,9,-4,3,-125,11,-4,3,5,-3,-57,-2,0,0
"8313","25",461,5,4,1,2,103,34,1,0,111,47,1,1,5,0,-8,-13,0,-1
"8314","25",308,1,4,1,0,-247,-246,-4,-4,4,1,0,1,5,4,-251,-247,-4,-5
"8315","25",99,8,4,1,3,244,-49,4,3,232,-33,2,3,5,-3,12,-16,2,0
"8316","25",374,8,4,1,2,166,107,3,3,180,74,2,2,5,-3,-14,33,1,1
"8317","25",252,4,4,1,1,-83,-188,-1,-1,-180,-116,0,0,5,1,97,-72,-1,-1
"8318","25",176,8,1,0,1,-88,-30,-2,3,123,1,1,2,5,-3,-211,-31,-3,1
"8319","25",172,4,2,1,3,42,41,-1,-1,106,86,4,2,5,1,-64,-45,-5,-3
"8320","25",318,7,2,1,2,177,-196,-4,2,189,-200,-4,0,5,-2,-12,4,0,2
"8321","25",241,6,4,1,2,209,199,3,1,213,187,2,0,5,-1,-4,12,1,1
"8322","25",238,2,3,0,1,-169,0,3,-3,106,30,2,2,5,3,-275,-30,1,-5
"8323","25",352,4,2,1,1,17,-144,0,-1,21,-123,0,-1,5,1,-4,-21,0,0
"8324","25",77,5,3,1,1,-131,-1,-1,0,-216,4,-2,-2,5,0,85,-5,1,2
"8325","25",429,1,2,1,0,-2,1,0,-4,42,17,0,-4,5,4,-44,-16,0,0
"8326","25",13,5,4,1,1,56,-104,2,0,60,-60,1,-2,5,0,-4,-44,1,2
"8327","25",28,4,4,1,1,-38,-43,-1,-1,13,-25,-1,-1,5,1,-51,-18,0,0
"8328","25",202,7,1,0,1,112,-23,3,2,57,-65,2,1,5,-2,55,42,1,1
"8329","25",175,3,4,1,1,-119,136,0,-2,184,130,1,3,5,2,-303,6,-1,-5
"8330","25",320,8,2,1,2,190,101,2,3,174,131,2,3,5,-3,16,-30,0,0
"8331","25",362,7,4,1,3,137,79,2,2,64,176,4,1,5,-2,73,-97,-2,1
"8332","25",317,4,4,1,2,-48,48,-1,-1,30,-24,0,0,5,1,-78,72,-1,-1
"8333","25",313,1,3,0,0,-237,-238,-4,-4,27,28,-2,-2,5,4,-264,-266,-2,-2
"8334","25",189,1,1,0,1,112,-60,3,-4,-55,55,2,-2,5,4,167,-115,1,-2
"8335","25",261,9,1,0,3,57,58,4,4,156,204,4,4,5,-4,-99,-146,0,0
"8336","25",185,7,4,1,2,64,-6,-1,2,85,-20,-1,0,5,-2,-21,14,0,2
"8337","25",279,6,4,1,3,160,140,1,1,155,121,1,3,5,-1,5,19,0,-2
"8338","25",201,9,3,0,1,183,0,4,4,69,-2,1,-3,5,-4,114,2,3,7
"8339","25",121,1,1,0,0,-207,-27,-4,-4,245,-103,-1,-4,5,4,-452,76,-3,0
"8340","25",65,7,1,0,3,18,80,1,2,-80,59,1,2,5,-2,98,21,0,0
"8341","25",199,8,4,1,2,236,219,3,3,198,88,2,2,5,-3,38,131,1,1
"8342","25",195,1,1,0,1,-216,213,4,-4,30,-22,2,0,5,4,-246,235,2,-4
"8343","25",312,5,4,1,1,-64,48,0,0,157,89,3,0,5,0,-221,-41,-3,0
"8344","25",309,3,4,1,2,208,84,-1,-2,184,44,-1,-1,5,2,24,40,0,-1
"8345","25",163,6,3,0,1,-169,4,-1,1,111,-36,3,1,5,-1,-280,40,-4,0
"8346","25",375,5,3,0,1,13,-1,0,0,0,-1,0,0,5,0,13,0,0,0
"8347","25",253,9,3,0,3,194,229,4,4,220,229,4,4,5,-4,-26,0,0,0
"8348","25",177,1,4,1,1,-107,127,-4,-4,-160,158,-4,-4,5,4,53,-31,0,0
"8349","25",173,6,4,1,3,101,-2,1,1,75,12,1,1,5,-1,26,-14,0,0
"8350","25",319,4,1,0,1,-133,-1,-2,-1,48,-4,1,2,5,1,-181,3,-3,-3
"8351","25",242,4,4,1,2,70,28,2,-1,119,69,2,-1,5,1,-49,-41,0,0
"8352","25",239,6,1,0,1,91,-67,1,1,60,60,-3,1,5,-1,31,-127,4,0
"8353","25",353,4,2,1,2,238,162,-2,-1,246,57,1,1,5,1,-8,105,-3,-2
"8354","25",78,3,4,1,0,-200,-1,-2,-2,-192,4,-2,-2,5,2,-8,-5,0,0
"8355","25",43,1,3,0,0,-240,5,-4,-4,75,7,-1,-3,5,4,-315,-2,-3,-1
"8356","25",130,9,1,0,3,181,40,4,4,193,40,4,4,5,-4,-12,0,0,0
"8357","25",280,6,2,1,1,234,-17,2,1,69,102,2,-1,5,-1,165,-119,0,2
"8358","25",203,9,4,1,3,215,10,4,4,211,15,4,4,5,-4,4,-5,0,0
"8359","25",325,8,1,0,1,-55,-38,-3,3,16,21,0,3,5,-3,-71,-59,-3,0
"8360","25",321,4,1,0,0,-136,-132,-1,-1,-128,-109,0,0,5,1,-8,-23,-1,-1
"8361","25",363,2,3,0,3,-247,1,4,-3,1,-248,3,3,5,3,-248,249,1,-6
"8362","25",36,6,3,0,3,-187,218,2,1,144,177,3,3,5,-1,-331,41,-1,-2
"8363","25",314,1,4,1,1,-246,10,4,-4,-241,12,4,-4,5,4,-5,-2,0,0
"8364","25",19,3,2,1,2,107,132,1,-2,114,92,2,2,5,2,-7,40,-1,-4
"8365","25",262,6,4,1,3,114,67,1,1,114,79,1,1,5,-1,0,-12,0,0
"8366","25",186,5,2,1,2,1,3,1,0,-1,1,1,0,5,0,2,2,0,0
"8367","25",182,6,4,1,3,-8,-165,3,1,-5,-196,4,4,5,-1,-3,31,-1,-3
"8368","25",179,3,1,0,1,18,-2,4,-2,235,3,0,4,5,2,-217,-5,4,-6
"8369","25",37,1,1,0,0,-215,14,-3,-4,-48,-12,-3,-1,5,4,-167,26,0,-3
"8370","25",366,9,4,1,3,166,-45,3,4,103,-57,2,3,5,-4,63,12,1,1
"8371","25",94,6,4,1,1,71,-94,1,1,226,228,4,4,5,-1,-155,-322,-3,-3
"8372","25",359,9,4,1,3,237,14,4,4,233,16,4,4,5,-4,4,-2,0,0
"8373","25",355,3,2,1,2,138,153,-2,-2,90,93,-3,-2,5,2,48,60,1,0
"8374","25",31,3,1,0,0,-152,-87,-2,-2,-113,-106,-1,-1,5,2,-39,19,-1,-1
"8375","25",164,7,2,1,2,161,198,2,2,170,0,2,2,5,-2,-9,198,0,0
"8376","25",376,4,4,1,1,-53,-145,-1,-1,38,-134,-1,-1,5,1,-91,-11,0,0
"8377","25",181,5,4,1,3,141,204,0,0,144,154,1,-2,5,0,-3,50,-1,2
"8378","25",178,4,1,0,1,-33,-3,-1,-1,248,3,3,3,5,1,-281,-6,-4,-4
"8379","25",174,5,4,1,3,184,94,-2,0,167,140,1,1,5,0,17,-46,-3,-1
"8380","25",32,5,1,0,1,-7,0,0,0,185,-173,3,-4,5,0,-192,173,-3,4
"8381","25",365,1,3,0,1,-10,-5,-4,-4,-184,-11,0,-4,5,4,174,6,-4,0
"8382","25",316,2,3,0,0,-72,-89,-3,-3,-112,-102,-3,-3,5,3,40,13,0,0
"8383","25",354,1,1,0,0,-222,232,-3,-4,147,111,2,1,5,4,-369,121,-5,-5
"8384","25",79,5,4,1,2,-14,-7,0,0,-9,-9,0,0,5,0,-5,2,0,0
"8385","25",430,5,2,1,1,50,-41,0,0,201,-121,1,-2,5,0,-151,80,-1,2
"8386","25",131,8,4,1,3,144,23,-2,3,103,-46,-1,3,5,-3,41,69,-1,0
"8387","25",281,1,4,1,2,-3,-249,0,-4,6,-240,0,-4,5,4,-9,-9,0,0
"8388","25",204,5,3,0,1,84,-109,0,0,153,-65,1,1,5,0,-69,-44,-1,-1
"8389","25",326,7,4,1,2,163,66,2,2,157,97,2,2,5,-2,6,-31,0,0
"8390","25",322,4,4,1,3,-43,22,-1,-1,225,-226,3,3,5,1,-268,248,-4,-4
"8391","25",364,6,3,1,1,-2,38,0,1,-46,-2,0,0,5,-1,44,40,0,1
"8392","25",360,1,3,1,0,-147,-152,-4,-4,192,197,2,-4,5,4,-339,-349,-6,0
"8393","25",315,9,3,0,3,249,7,4,4,233,13,4,4,5,-4,16,-6,0,0
"8394","25",190,7,4,1,3,211,98,2,2,199,183,2,2,5,-2,12,-85,0,0
"8395","25",263,1,4,1,0,-238,-1,-4,-4,-207,0,-4,-4,5,4,-31,-1,0,0
"8396","25",187,6,4,1,2,137,124,2,1,194,183,3,3,5,-1,-57,-59,-1,-2
"8397","25",183,3,4,1,1,49,67,1,-2,72,163,1,-3,5,2,-23,-96,0,1
"8398","25",18,3,3,0,1,-71,-61,0,-2,65,25,1,0,5,2,-136,-86,-1,-2
"8399","25",370,9,1,0,3,240,13,4,4,-5,-11,-3,-3,5,-4,245,24,7,7
"8400","25",367,4,3,0,1,-184,-106,2,-1,-46,-35,2,-1,5,1,-138,-71,0,0
"8401","25",95,6,4,1,2,-4,-94,1,1,0,-5,0,0,5,-1,-4,-89,1,1
"8402","25",91,5,2,1,3,143,3,1,0,213,68,2,2,5,0,-70,-65,-1,-2
"8403","25",356,3,4,1,1,-113,-8,-2,-2,243,-1,4,4,5,2,-356,-7,-6,-6
"8404","25",310,6,4,1,2,122,33,1,1,129,66,2,2,5,-1,-7,-33,-1,-1
"8405","25",165,5,1,0,1,148,60,0,0,120,88,1,1,5,0,28,-28,-1,-1
"8406","25",377,1,1,0,0,-238,13,0,-4,-245,7,-4,-4,5,4,7,6,4,0
"8407","25",230,6,1,0,0,-207,25,-3,1,-150,-22,-2,2,5,-1,-57,47,-1,-1
"8408","25",154,4,4,1,3,-86,-9,-1,-1,-91,35,-1,-1,5,1,5,-44,0,0
"8409","25",328,4,3,0,1,-21,11,-1,-1,12,5,1,1,5,1,-33,6,-2,-2
"8410","25",324,1,2,1,0,1,2,-4,-4,-1,-2,-4,-4,5,4,2,4,0,0
"8411","25",453,8,4,1,2,188,-3,3,3,184,-2,3,3,5,-3,4,-1,0,0
"8412","25",90,1,4,1,0,-222,22,-4,-4,231,17,4,4,5,4,-453,5,-8,-8
"8413","25",87,6,4,1,3,106,19,2,1,0,48,1,1,5,-1,106,-29,1,0
"8414","25",8,8,3,0,1,172,-15,-2,3,-90,51,-2,2,5,-3,262,-66,0,1
"8415","25",431,2,3,0,0,-212,39,-3,-3,22,32,-1,-1,5,3,-234,7,-2,-2
"8416","25",132,5,4,1,1,48,-124,1,0,28,137,1,2,5,0,20,-261,0,-2
"8417","25",282,9,3,0,3,48,-112,1,4,164,23,0,4,5,-4,-116,-135,1,0
"8418","25",205,7,1,0,2,-77,9,3,2,214,9,4,4,5,-2,-291,0,-1,-2
"8419","25",327,6,4,1,3,198,2,3,1,180,5,1,0,5,-1,18,-3,2,1
"8420","25",323,5,4,1,1,213,-3,0,0,128,-1,1,-4,5,0,85,-2,-1,4
"8421","25",97,2,1,0,1,-242,-48,4,-3,29,19,2,-2,5,3,-271,-67,2,-1
"8422","25",361,1,1,0,0,-248,0,-3,-4,246,2,4,4,5,4,-494,-2,-7,-8
"8423","25",358,1,4,1,2,249,243,0,-4,226,176,0,-4,5,4,23,67,0,0
"8424","25",191,3,1,0,0,-219,-28,-2,-2,-203,-36,-2,-2,5,2,-16,8,0,0
"8425","25",264,5,4,1,2,225,241,-4,0,24,21,0,-1,5,0,201,220,-4,1
"8426","25",188,9,2,1,3,231,3,3,4,222,2,4,4,5,-4,9,1,-1,0
"8427","25",184,6,3,0,3,114,-1,1,1,117,-1,1,1,5,-1,-3,0,0,0
"8428","25",180,8,2,1,2,225,6,2,3,233,-1,4,3,5,-3,-8,7,-2,0
"8429","25",371,1,3,0,0,-217,133,-4,-4,72,-171,-2,2,5,4,-289,304,-2,-6
"8430","25",368,1,3,0,3,-101,-169,-4,-4,-134,140,4,4,5,4,33,-309,-8,-8
"8431","25",96,3,1,0,0,-153,-8,-2,-2,-46,-2,-2,-2,5,2,-107,-6,0,0
"8432","25",92,5,4,1,2,-1,1,-2,0,-1,1,0,0,5,0,0,0,-2,0
"8433","25",357,6,4,1,2,142,17,1,1,170,85,1,1,5,-1,-28,-68,0,0
"8434","25",311,1,2,1,2,231,6,4,-4,185,38,4,-4,5,4,46,-32,0,0
"8435","25",166,3,4,1,2,203,204,-3,-2,185,174,-2,-2,5,2,18,30,-1,0
"8436","25",378,3,4,1,1,-179,1,-1,-2,-138,-1,-2,-2,5,2,-41,2,1,0
"8437","25",231,6,4,1,0,-153,-140,-4,1,28,21,-4,3,5,-1,-181,-161,0,-2
"8438","25",155,6,2,1,1,0,-2,-1,1,242,242,2,2,5,-1,-242,-244,-3,-1
"8439","25",329,6,4,1,3,196,190,1,1,-1,-1,0,0,5,-1,197,191,1,1
"8440","25",298,2,1,0,0,-239,14,-1,-3,9,-229,-1,0,5,3,-248,243,0,-3
"8441","25",454,8,4,0,3,221,4,3,3,216,4,3,3,5,-3,5,0,0,0
"8442","25",450,6,4,1,3,-3,116,4,1,96,4,0,-1,5,-1,-99,112,4,2
"8443","25",88,9,4,1,2,220,224,4,4,219,-229,3,4,5,-4,1,453,1,0
"8444","25",80,8,4,1,3,-110,-1,3,3,234,3,4,-3,5,-3,-344,-4,-1,6
"8445","25",432,4,2,1,1,192,77,-1,-1,51,-44,0,0,5,1,141,121,-1,-1
"8446","25",133,5,2,1,1,-142,-213,1,0,70,46,2,-1,5,0,-212,-259,-1,1
"8447","25",283,4,1,0,1,-102,41,-3,-1,-84,-119,-2,1,5,1,-18,160,-1,-2
"8448","25",206,2,4,1,0,-63,18,-3,-3,93,67,0,2,5,3,-156,-49,-3,-5
"8449","25",30,5,2,1,2,126,4,1,0,192,1,3,1,5,0,-66,3,-2,-1
"8450","25",297,3,3,0,2,204,39,2,-2,193,36,2,-2,5,2,11,3,0,0
"8451","25",82,9,4,1,2,15,227,4,4,12,243,4,4,5,-4,3,-16,0,0
"8452","25",45,4,3,0,0,-118,-103,-2,-1,29,-114,2,1,5,1,-147,11,-4,-2
"8453","25",446,4,4,0,1,-95,26,-1,-1,8,3,0,0,5,1,-103,23,-1,-1
"8454","25",83,6,1,0,3,122,-118,2,1,149,-134,1,2,5,-1,-27,16,1,-1
"8455","25",435,3,4,1,1,-216,7,-2,-2,0,-63,0,0,5,2,-216,70,-2,-2
"8456","25",136,1,1,0,0,-249,245,-4,-4,-35,37,-4,-4,5,4,-214,208,0,0
"8457","25",160,7,2,1,0,60,12,-4,2,-17,-3,-4,2,5,-2,77,15,0,0
"8458","25",157,9,3,0,2,177,182,4,4,109,85,-2,0,5,-4,68,97,6,4
"8459","25",372,1,3,0,0,-245,-239,-4,-4,60,57,0,-4,5,4,-305,-296,-4,0
"8460","25",369,2,4,1,0,-203,2,-1,-3,141,2,1,0,5,3,-344,0,-2,-3
"8461","25",456,1,1,0,0,-245,181,-2,-4,198,133,2,-2,5,4,-443,48,-4,-2
"8462","25",93,5,1,0,1,-155,112,-2,0,-115,60,-2,0,5,0,-40,52,0,0
"8463","25",9,4,4,1,2,18,11,1,-1,30,18,1,-1,5,1,-12,-7,0,0
"8464","25",284,1,3,0,1,-141,-168,0,-4,-181,-185,0,-3,5,4,40,17,0,-1
"8465","25",434,6,4,1,3,106,-10,1,1,144,-15,1,1,5,-1,-38,5,0,0
"8466","25",135,5,1,0,1,-241,172,-3,0,-115,30,-2,-2,5,0,-126,142,-1,2
"8467","25",16,1,1,0,0,-239,236,0,-4,57,-19,1,-3,5,4,-296,255,-1,-1
"8468","25",156,5,2,1,1,1,-1,0,0,68,39,1,1,5,0,-67,-40,-1,-1
"8469","25",33,8,3,0,1,49,-84,-3,3,-45,58,0,0,5,-3,94,-142,-3,3
"8470","25",299,7,4,0,1,210,29,2,2,33,206,4,4,5,-2,177,-177,-2,-2
"8471","25",455,6,2,1,2,-2,56,2,1,167,-1,3,2,5,-1,-169,57,-1,-1
"8472","25",451,2,1,0,0,-185,-185,-3,-3,-194,-157,-3,-4,5,3,9,-28,0,1
"8473","25",89,2,3,0,0,-1,3,-4,-3,-244,1,-3,-3,5,3,243,2,-1,0
"8474","25",81,3,1,0,0,-229,168,2,-2,21,45,1,-3,5,2,-250,123,1,1
"8475","25",433,2,1,0,0,194,225,-3,-3,202,165,4,-3,5,3,-8,60,-7,0
"8476","25",134,6,2,1,2,85,5,2,1,96,9,2,0,5,-1,-11,-4,0,1
"8477","25",457,7,3,0,1,152,0,2,2,130,-124,3,3,5,-2,22,124,-1,-1
"8478","25",207,1,1,0,0,-249,-4,-4,-4,245,0,4,4,5,4,-494,-4,-8,-8
"8479","25",300,2,1,0,0,-222,29,-2,-3,-33,92,-1,-2,5,3,-189,-63,-1,-1
"8480","25",458,2,1,0,1,-92,-80,0,-3,76,77,-1,-2,5,3,-168,-157,1,-1
"8481","25",442,6,4,1,1,-31,27,-1,1,28,29,1,1,5,-1,-59,-2,-2,0
"8482","25",439,6,2,1,1,7,4,1,1,-8,-1,1,1,5,-1,15,5,0,0
"8483","25",447,7,4,1,2,153,139,-1,2,139,126,2,1,5,-2,14,13,-3,1
"8484","25",84,8,4,1,3,196,2,3,3,199,2,3,3,5,-3,-3,0,0,0
"8485","25",436,5,4,1,3,20,-147,4,0,125,-171,3,-1,5,0,-105,24,1,1
"8486","25",137,4,1,0,1,-237,-235,-4,-1,25,14,-2,0,5,1,-262,-249,-2,-1
"8487","25",161,3,2,1,2,149,167,-1,-2,94,64,1,-2,5,2,55,103,-2,0
"8488","25",158,4,3,0,0,-157,-24,-3,-1,54,-22,0,0,5,1,-211,-2,-3,-1
"8489","25",303,6,3,1,2,63,-24,2,1,21,-74,1,1,5,-1,42,50,1,0
"8490","25",449,6,4,1,3,104,78,1,1,86,66,1,1,5,-1,18,12,0,0
"8491","25",86,5,4,1,3,113,10,1,0,161,13,-1,4,5,0,-48,-3,2,-4
"8492","25",438,7,4,1,3,204,-3,4,2,121,-5,4,2,5,-2,83,2,0,0
"8493","25",139,9,4,1,2,0,0,4,4,244,16,4,4,5,-4,-244,-16,0,0
"8494","25",285,4,2,1,1,-145,129,-4,-1,-28,38,-2,1,5,1,-117,91,-2,-2
"8495","25",208,5,4,1,2,31,2,0,0,-99,-1,-4,-4,5,0,130,3,4,4
"8496","25",14,5,3,0,1,9,6,0,0,215,-92,2,3,5,0,-206,98,-2,-3
"8497","25",286,6,1,0,3,65,12,1,1,57,5,1,1,5,-1,8,7,0,0
"8498","25",209,7,4,1,3,145,1,3,2,152,-3,2,2,5,-2,-7,4,1,0
"8499","25",302,3,1,0,0,-237,25,-4,-2,196,51,-2,-2,5,2,-433,-26,-2,0
"8500","25",3,2,3,0,0,-130,1,-3,-3,-3,2,2,-2,5,3,-127,-1,-5,-1
"8501","25",85,6,2,1,2,114,143,2,1,148,130,3,1,5,-1,-34,13,-1,0
"8502","25",452,5,3,0,1,1,-2,0,0,-70,2,-1,-1,5,0,71,-4,1,1
"8503","25",138,5,3,0,1,103,-93,0,0,95,-46,1,1,5,0,8,-47,-1,-1
"8504","25",162,7,3,0,3,25,34,-1,2,187,158,4,4,5,-2,-162,-124,-5,-2
"8505","25",159,2,3,0,2,242,5,-3,-3,244,7,4,4,5,3,-2,-2,-7,-7
"8506","25",304,8,2,1,2,218,-139,3,3,46,-31,-1,-1,5,-3,172,-108,4,4
"8507","25",142,5,2,1,2,228,-234,-1,0,-3,1,-1,0,5,0,231,-235,0,0
"8508","25",150,5,3,1,1,1,-2,0,0,2,-2,0,0,5,0,-1,0,0,0
"8509","25",301,3,4,1,1,-33,1,-1,-2,78,-2,1,2,5,2,-111,3,-2,-4
"8510","25",459,1,3,0,1,-91,-217,2,-4,-48,-141,2,-4,5,4,-43,-76,0,0
"8511","25",443,1,1,0,0,-231,-213,-4,-4,49,35,1,0,5,4,-280,-248,-5,-4
"8512","25",44,6,2,1,2,160,-213,0,1,226,-232,0,-4,5,-1,-66,19,0,5
"8513","25",448,5,2,1,2,130,-1,-2,0,-1,35,0,-2,5,0,131,-36,-2,2
"8514","25",287,9,4,1,3,212,-3,2,4,138,-15,1,1,5,-4,74,12,1,3
"8515","25",437,3,1,0,0,-197,2,-2,-2,-164,3,-2,-2,5,2,-33,-1,0,0
"8516","25",440,2,3,0,0,-184,-95,-3,-3,-31,3,-3,-3,5,3,-153,-98,0,0
"8517","25",141,1,1,0,0,-237,-193,-4,-4,-243,-109,-1,-3,5,4,6,-84,-3,-1
"8518","25",445,6,4,1,3,57,-25,1,1,110,-62,0,0,5,-1,-53,37,1,1
"8519","25",441,9,4,1,2,35,0,3,4,38,-35,4,4,5,-4,-3,35,-1,0
"8520","25",15,4,4,1,3,-30,39,-1,-1,52,24,2,1,5,1,-82,15,-3,-2
"8521","25",289,8,1,1,3,-247,-20,3,3,170,180,3,2,5,-3,-417,-200,0,1
"8522","25",147,7,2,1,3,54,15,1,2,111,153,2,0,5,-2,-57,-138,-1,2
"8523","25",143,4,1,0,3,232,-12,-4,-1,133,-84,3,3,5,1,99,72,-7,-4
"8524","25",29,1,4,1,0,-242,242,-4,-4,209,180,-2,-1,5,4,-451,62,-2,-3
"8525","25",306,5,3,0,3,138,120,1,0,121,130,1,0,5,0,17,-10,0,0
"8526","25",140,5,1,0,1,-33,-17,-1,0,30,-48,1,1,5,0,-63,31,-2,-1
"8527","25",46,1,1,0,0,-202,-243,0,-4,-8,-245,-4,-4,5,4,-194,2,4,0
"8528","25",21,6,4,1,2,51,20,1,1,28,19,1,-1,5,-1,23,1,0,2
"8529","25",213,4,2,1,1,-23,-2,1,-1,1,-11,-1,0,5,1,-24,9,2,-1
"8530","25",149,5,3,1,1,-201,-7,-4,0,244,4,-3,1,5,0,-445,-11,-1,-1
"8531","25",288,6,2,1,2,-2,-4,0,1,155,-24,2,1,5,-1,-157,20,-2,0
"8532","25",210,3,4,1,2,30,144,2,-2,152,163,1,-1,5,2,-122,-19,1,-1
"8533","25",214,9,1,0,3,142,1,4,4,151,1,4,4,5,-4,-9,0,0,0
"8534","25",146,2,2,1,0,-198,-172,-3,-3,-175,-143,-3,-3,5,3,-23,-29,0,0
"8535","25",305,9,4,1,3,231,247,4,4,242,242,4,4,5,-4,-11,5,0,0
"8536","25",211,6,3,0,1,-88,-88,-3,1,131,153,2,4,5,-1,-219,-241,-5,-3
"8537","25",227,8,3,0,3,-189,-13,2,3,-66,-21,1,2,5,-3,-123,8,1,1
"8538","25",151,1,2,1,1,9,7,0,-4,-18,10,0,-4,5,4,27,-3,0,0
"8539","25",148,1,1,0,1,-244,-63,3,-4,-245,-56,3,-4,5,4,1,-7,0,0
"8540","25",144,3,3,0,0,-229,4,-4,-2,-3,7,1,0,5,2,-226,-3,-5,-2
"8541","25",444,6,2,1,2,67,15,1,1,6,-2,0,0,5,-1,61,17,1,1
"8542","25",152,1,1,0,0,-161,-6,-2,-4,-140,1,-1,-4,5,4,-21,-7,-1,0
"8543","25",217,4,4,1,2,61,35,1,-1,65,38,1,-2,5,1,-4,-3,0,1
"8544","25",145,2,1,0,1,-231,-221,-4,-3,-227,-245,-2,-2,5,3,-4,24,-2,-1
"8545","25",153,6,1,0,3,-144,-92,3,1,-13,-24,0,1,5,-1,-131,-68,3,0
"8546","25",295,5,1,0,1,-1,-2,0,0,1,-3,0,0,5,0,-2,1,0,0
"8547","25",218,8,4,1,3,132,26,4,3,94,47,4,3,5,-3,38,-21,0,0
"8548","25",292,5,3,0,1,-1,-81,0,0,-233,0,-2,-2,5,0,232,-81,2,2
"8549","25",296,7,1,0,3,157,3,1,2,201,-9,2,2,5,-2,-44,12,-1,0
"8550","25",215,1,1,0,0,-208,54,-2,-4,-175,26,-2,-3,5,4,-33,28,0,-1
"8551","25",293,1,4,1,0,-250,11,-4,-4,-192,15,-4,-4,5,4,-58,-4,0,0
"8552","25",212,1,1,0,1,-213,21,0,-4,-229,27,0,-4,5,4,16,-6,0,0
"8553","25",216,5,3,0,1,31,-18,1,0,-101,-145,1,1,5,0,132,127,0,-1
"8554","25",290,2,1,0,1,-116,-90,-2,-3,51,-106,-2,-2,5,3,-167,16,0,-1
"8555","25",294,7,1,0,3,102,-1,2,2,49,1,3,3,5,-2,53,-2,-1,-1
"8556","25",224,7,2,1,2,147,68,2,2,160,73,2,2,5,-2,-13,-5,0,0
"8557","25",220,2,4,1,2,155,156,-3,-3,157,156,-2,-2,5,3,-2,0,-1,-1
"8558","25",291,6,4,1,2,163,34,0,1,-170,109,-3,-3,5,-1,333,-75,3,4
"8559","25",226,2,1,0,0,-62,0,-2,-3,122,2,2,-2,5,3,-184,-2,-4,-1
"8560","25",225,9,2,1,2,49,-20,4,4,76,-81,1,1,5,-4,-27,61,3,3
"8561","25",23,9,1,0,3,217,222,4,4,185,169,4,4,5,-4,32,53,0,0
"8562","25",221,7,4,0,1,83,-3,1,2,-9,-4,0,1,5,-2,92,1,1,1
"8563","25",228,9,4,1,2,47,135,3,4,-20,93,1,1,5,-4,67,42,2,3
"8564","25",219,5,4,1,3,249,1,4,0,-1,248,4,0,5,0,250,-247,0,0
"8565","25",223,5,1,0,1,0,0,0,0,0,-1,0,0,5,0,0,1,0,0
"8566","25",222,2,1,0,0,-241,6,-3,-3,-227,1,-3,-3,5,3,-14,5,0,0
"8567","25",229,6,1,0,1,14,-25,1,1,-234,214,-3,-3,5,-1,248,-239,4,4
"8568","25",22,5,3,0,1,22,-8,0,0,139,15,2,2,5,0,-117,-23,-2,-2
"8569","26",467,5,1,1,3,-74,36,4,0,72,185,4,0,4,-1,-146,-149,0,0
"8570","26",331,2,1,0,0,20,-200,-4,-3,2,-191,-4,-3,4,2,18,-9,0,0
"8571","26",339,2,3,1,1,-46,-69,-3,-3,92,91,-3,-2,4,2,-138,-160,0,-1
"8572","26",338,1,3,1,2,68,58,1,-4,69,44,-4,-4,4,3,-1,14,5,0
"8573","26",335,4,2,1,1,-19,20,0,-1,-7,-33,0,0,4,0,-12,53,0,-1
"8574","26",466,4,3,1,0,-37,-98,-1,-1,-135,-98,-2,-2,4,0,98,0,1,1
"8575","26",68,2,4,1,0,89,-7,0,-3,183,8,-1,-3,4,2,-94,-15,1,0
"8576","26",342,4,3,1,1,2,5,0,-1,22,43,-1,0,4,0,-20,-38,1,-1
"8577","26",336,2,4,1,3,128,167,2,-3,86,148,3,-2,4,2,42,19,-1,-1
"8578","26",334,1,4,1,0,-227,176,-4,-4,-178,170,-4,-2,4,3,-49,6,0,-2
"8579","26",332,2,1,0,0,-249,145,-2,-3,-249,99,-3,-3,4,2,0,46,1,0
"8580","26",34,7,4,1,2,124,-71,2,2,95,-81,2,1,4,-3,29,10,0,1
"8581","26",66,6,1,0,1,110,0,2,1,136,3,-1,1,4,-2,-26,-3,3,0
"8582","26",341,9,1,0,3,247,-30,4,4,246,-28,3,4,4,-5,1,-2,1,0
"8583","26",2,5,4,1,1,-63,-45,-1,0,-79,-171,2,0,4,-1,16,126,-3,0
"8584","26",330,6,2,1,2,100,29,1,1,189,179,1,1,4,-2,-89,-150,0,0
"8585","26",414,2,1,1,0,-148,-159,-3,-3,9,12,0,0,4,2,-157,-171,-3,-3
"8586","26",468,4,1,0,3,131,63,2,-1,69,-64,1,2,4,0,62,127,1,-3
"8587","26",464,6,1,0,1,17,21,1,1,92,23,1,1,4,-2,-75,-2,0,0
"8588","26",419,6,4,1,3,147,114,1,1,154,117,1,1,4,-2,-7,-3,0,0
"8589","26",343,6,2,1,2,108,0,1,1,112,-6,1,1,4,-2,-4,6,0,0
"8590","26",469,1,4,1,0,8,72,-3,-4,99,92,-3,-3,4,3,-91,-20,0,-1
"8591","26",69,2,4,0,1,20,31,-1,-3,-43,22,-1,1,4,2,63,9,0,-4
"8592","26",72,4,1,1,0,89,100,0,-1,164,169,2,3,4,0,-75,-69,-2,-4
"8593","26",340,4,1,0,1,-29,-16,0,-1,39,14,0,0,4,0,-68,-30,0,-1
"8594","26",337,9,2,1,3,241,241,4,4,243,-19,4,4,4,-5,-2,260,0,0
"8595","26",333,6,4,1,1,27,7,0,1,17,-72,1,1,4,-2,10,79,-1,0
"8596","26",345,2,1,1,0,-136,30,-3,-3,-219,106,-4,-3,4,2,83,-76,1,0
"8597","26",418,6,2,1,2,180,-103,1,1,170,-213,2,1,4,-2,10,110,-1,0
"8598","26",67,6,1,1,0,85,-89,1,1,155,-132,2,2,4,-2,-70,43,-1,-1
"8599","26",346,7,3,1,0,-250,-70,-3,2,250,2,2,2,4,-3,-500,-72,-5,0
"8600","26",20,4,3,1,0,-100,-89,-2,-1,191,191,4,4,4,0,-291,-280,-6,-5
"8601","26",407,7,2,1,2,23,-69,2,2,213,22,3,3,4,-3,-190,-91,-1,-1
"8602","26",415,4,2,1,2,-17,-12,0,-1,189,205,0,2,4,0,-206,-217,0,-3
"8603","26",347,7,1,1,3,-200,-145,1,2,155,-180,2,-2,4,-3,-355,35,-1,4
"8604","26",465,7,4,1,3,8,-233,3,2,12,-226,0,3,4,-3,-4,-7,3,-1
"8605","26",42,3,3,1,1,3,-33,2,-2,-2,12,2,-2,4,1,5,-45,0,0
"8606","26",344,7,4,0,3,157,-61,1,2,61,-129,2,3,4,-3,96,68,-1,-1
"8607","26",47,6,4,1,3,177,-1,1,1,39,0,0,1,4,-2,138,-1,1,0
"8608","26",7,6,1,0,3,91,63,2,1,140,55,2,1,4,-2,-49,8,0,0
"8609","26",462,9,3,1,3,-48,100,4,4,202,196,-4,-4,4,-5,-250,-96,8,8
"8610","26",470,4,1,0,1,-63,24,-1,-1,-50,10,0,-1,4,0,-13,14,-1,0
"8611","26",320,8,2,1,2,184,102,2,3,192,124,2,3,4,-4,-8,-22,0,0
"8612","26",463,5,4,1,3,14,-6,0,0,-246,-9,-1,0,4,-1,260,3,1,0
"8613","26",410,1,1,1,0,-163,-21,-2,-4,-190,-21,0,-2,4,3,27,0,-2,-2
"8614","26",1,6,1,0,1,-18,-22,-1,1,-10,12,-1,1,4,-2,-8,-34,0,0
"8615","26",71,5,3,1,1,-90,14,0,0,37,19,1,0,4,-1,-127,-5,-1,0
"8616","26",245,1,1,0,0,-245,87,-4,-4,-218,6,-4,-4,4,3,-27,81,0,0
"8617","26",200,1,3,1,0,116,-24,-3,-4,-223,-49,-4,-4,4,3,339,25,1,0
"8618","26",408,2,1,0,0,-75,-3,-1,-3,-171,3,-2,-2,4,2,96,-6,1,-1
"8619","26",416,1,4,1,0,-202,103,-4,-4,-199,202,-4,-4,4,3,-3,-99,0,0
"8620","26",348,3,3,1,1,50,45,-1,-2,61,47,0,-2,4,1,-11,-2,-1,0
"8621","26",32,5,1,0,1,7,0,0,0,179,-168,4,3,4,-1,-172,168,-4,-3
"8622","26",73,5,4,1,2,-91,-119,0,0,-109,-130,0,0,4,-1,18,11,0,0
"8623","26",349,6,4,1,1,67,-116,2,1,-106,93,0,1,4,-2,173,-209,2,0
"8624","26",202,6,1,0,1,53,-18,2,1,79,-20,2,1,4,-2,-26,2,0,0
"8625","26",70,2,2,1,2,39,78,-1,-3,237,214,0,-3,4,2,-198,-136,-1,0
"8626","26",471,4,3,1,2,-81,115,1,-1,-97,70,0,2,4,0,16,45,1,-3
"8627","26",240,2,2,1,1,-76,25,-3,-3,13,-7,0,-2,4,2,-89,32,-3,-1
"8628","26",321,4,1,0,0,-149,-143,0,-1,-111,-74,-1,-1,4,0,-38,-69,1,0
"8629","26",403,2,1,0,0,-81,-27,1,-3,24,-52,2,1,4,2,-105,25,-1,-4
"8630","26",411,9,2,1,2,236,231,4,4,230,242,4,4,4,-5,6,-11,0,0
"8631","26",10,7,3,0,1,119,3,1,2,172,-1,2,2,4,-3,-53,4,-1,0
"8632","26",48,1,3,1,0,61,-64,-4,-4,76,-60,-4,-4,4,3,-15,-4,0,0
"8633","26",246,8,4,1,3,242,-2,3,3,246,-3,4,3,4,-4,-4,1,-1,0
"8634","26",201,1,3,1,1,40,-1,2,-4,59,-1,1,-3,4,3,-19,0,1,-1
"8635","26",420,5,4,1,3,-58,-1,-1,0,2,31,2,1,4,-1,-60,-32,-3,-1
"8636","26",417,7,2,0,2,84,76,2,2,7,3,1,1,4,-3,77,73,1,1
"8637","26",24,7,2,1,2,133,4,3,2,232,-1,3,4,4,-3,-99,5,0,-2
"8638","26",421,7,3,1,1,37,27,0,2,30,21,1,4,4,-3,7,6,-1,-2
"8639","26",272,6,4,1,2,110,86,0,1,169,-56,1,1,4,-2,-59,142,-1,0
"8640","26",35,2,1,1,3,30,157,0,-3,124,167,3,-2,4,2,-94,-10,-3,-1
"8641","26",237,5,2,1,2,53,-1,-1,0,108,41,-1,1,4,-1,-55,-42,0,-1
"8642","26",75,3,4,1,2,234,17,3,-2,237,43,2,-2,4,1,-3,-26,1,0
"8643","26",472,1,1,1,0,-236,173,-4,-4,-235,200,-4,-4,4,3,-1,-27,0,0
"8644","26",241,5,4,1,2,206,164,2,0,197,159,2,0,4,-1,9,5,0,0
"8645","26",322,5,4,1,3,25,-28,0,0,232,-235,3,3,4,-1,-207,207,-3,-3
"8646","26",404,4,1,1,1,55,-53,1,-1,59,-61,1,0,4,0,-4,8,0,-1
"8647","26",412,9,1,0,0,-244,1,-4,4,241,1,4,4,4,-5,-485,0,-8,0
"8648","26",409,6,4,1,2,48,70,1,1,119,125,2,2,4,-2,-71,-55,-1,-1
"8649","26",49,5,4,1,1,42,118,0,0,129,32,2,0,4,-1,-87,86,-2,0
"8650","26",474,1,1,1,0,2,-67,0,-4,1,-81,0,-4,4,3,1,14,0,0
"8651","26",236,5,1,0,1,-1,-4,0,0,-42,-34,0,0,4,-1,41,30,0,0
"8652","26",74,3,3,1,0,-126,71,-3,-2,-188,-77,-4,-4,4,1,62,148,1,2
"8653","26",248,4,4,1,3,14,48,1,-1,25,89,2,0,4,0,-11,-41,-1,-1
"8654","26",203,9,4,0,3,228,14,4,4,238,13,4,4,4,-5,-10,1,0,0
"8655","26",422,1,3,1,1,-98,-123,1,-4,-92,-108,3,-2,4,3,-6,-15,-2,-2
"8656","26",273,5,1,1,0,-1,1,0,0,175,66,1,0,4,-1,-176,-65,-1,0
"8657","26",40,8,1,0,2,-134,104,-3,3,117,77,-2,1,4,-4,-251,27,-1,2
"8658","26",238,6,3,1,1,-90,21,1,1,117,-1,1,1,4,-2,-207,22,0,0
"8659","26",76,5,4,1,3,19,2,2,0,3,-1,2,0,4,-1,16,3,0,0
"8660","26",473,3,3,0,0,-34,-26,-1,-2,-177,-18,0,-2,4,1,143,-8,-1,0
"8661","26",100,8,4,1,3,249,-5,3,3,218,2,4,2,4,-4,31,-7,-1,1
"8662","26",323,1,4,1,1,153,-5,2,-4,235,0,0,-4,4,3,-82,-5,2,0
"8663","26",247,5,3,1,0,-22,-6,0,0,217,-3,0,0,4,-1,-239,-3,0,0
"8664","26",101,2,3,1,0,-132,130,-3,-3,227,234,-3,-3,4,2,-359,-104,0,0
"8665","26",324,2,2,1,0,9,-1,-3,-3,4,-4,-4,-4,4,2,5,3,1,1
"8666","26",232,1,1,0,0,-239,-50,-1,-4,-229,-43,-4,-4,4,3,-10,-7,3,0
"8667","26",269,6,4,1,2,98,1,0,1,166,1,1,1,4,-2,-68,0,-1,0
"8668","26",265,4,1,1,3,-20,-1,-2,-1,0,0,0,0,4,0,-20,-1,-2,-1
"8669","26",233,6,2,1,2,40,25,1,1,23,-47,1,1,4,-2,17,72,0,0
"8670","26",350,6,4,1,1,244,7,3,1,246,-4,1,1,4,-2,-2,11,2,0
"8671","26",204,6,3,1,1,106,-54,1,1,-132,-202,0,0,4,-2,238,148,1,1
"8672","26",423,5,1,0,3,-4,-35,4,0,100,-150,-2,-1,4,-1,-104,115,6,1
"8673","26",274,7,4,1,2,145,114,2,2,162,103,2,2,4,-3,-17,11,0,0
"8674","26",242,3,4,1,2,50,35,1,-2,188,216,2,3,4,1,-138,-181,-1,-5
"8675","26",239,1,1,0,1,-214,-162,-4,-4,97,107,3,-2,4,3,-311,-269,-7,-2
"8676","26",405,4,4,1,1,113,0,-1,-1,94,2,-1,-1,4,0,19,-2,0,0
"8677","26",413,8,1,0,1,228,2,4,3,-117,6,-2,-2,4,-4,345,-4,6,5
"8678","26",41,6,2,1,3,79,90,3,1,81,92,3,1,4,-2,-2,-2,0,0
"8679","26",5,6,2,1,2,146,117,2,1,161,110,3,3,4,-2,-15,7,-1,-2
"8680","26",475,4,3,1,3,38,-6,0,-1,83,-55,0,0,4,0,-45,49,0,-1
"8681","26",102,6,4,1,3,86,-90,2,1,-49,13,0,4,4,-2,135,-103,2,-3
"8682","26",50,3,2,1,1,50,-18,0,-2,120,-64,1,-2,4,1,-70,46,-1,0
"8683","26",249,1,3,1,0,-103,-108,-3,-4,25,-27,1,-4,4,3,-128,-81,-4,0
"8684","26",27,5,2,1,2,94,78,1,0,76,95,0,1,4,-1,18,-17,1,-1
"8685","26",266,5,1,0,1,0,1,0,0,-2,-1,0,0,4,-1,2,2,0,0
"8686","26",234,4,3,1,3,135,37,0,-1,132,50,1,-1,4,0,3,-13,-1,0
"8687","26",400,6,4,1,2,94,-39,1,1,106,-75,1,1,4,-2,-12,36,0,0
"8688","26",398,9,4,1,2,248,242,4,4,244,243,4,4,4,-5,4,-1,0,0
"8689","26",77,4,3,1,1,-67,2,-1,-1,-4,22,-1,-1,4,0,-63,-20,0,0
"8690","26",352,4,2,1,1,11,-105,0,-1,22,-119,0,-1,4,0,-11,14,0,0
"8691","26",206,3,4,1,0,-96,22,-2,-2,-48,18,-1,2,4,1,-48,4,-1,-4
"8692","26",425,5,4,1,2,-19,30,0,0,10,44,1,1,4,-1,-29,-14,-1,-1
"8693","26",276,7,4,1,3,185,3,2,2,184,4,2,2,4,-3,1,-1,0,0
"8694","26",244,4,4,1,2,-66,-39,-1,-1,57,-57,1,1,4,0,-123,18,-2,-2
"8695","26",325,9,1,1,1,-31,-41,0,4,-62,-53,-1,3,4,-5,31,12,1,1
"8696","26",59,3,1,1,0,-159,36,-2,-2,-120,48,-2,-2,4,1,-39,-12,0,0
"8697","26",55,5,4,1,1,-93,4,0,0,-92,-48,0,0,4,-1,-1,52,0,0
"8698","26",397,6,4,1,3,97,-9,1,1,119,-76,1,1,4,-2,-22,67,0,0
"8699","26",111,6,1,0,0,-145,83,-1,1,67,168,1,-1,4,-2,-212,-85,-2,2
"8700","26",351,1,1,0,0,-219,-194,-4,-4,121,125,-4,-4,4,3,-340,-319,0,0
"8701","26",205,5,1,0,2,-6,1,0,0,211,0,3,3,4,-1,-217,1,-3,-3
"8702","26",424,6,2,1,2,54,63,1,1,85,134,1,1,4,-2,-31,-71,0,0
"8703","26",275,8,4,1,2,232,7,3,3,-4,243,2,3,4,-4,236,-236,1,0
"8704","26",243,5,2,0,2,-247,-80,-1,0,249,43,1,2,4,-1,-496,-123,-2,-2
"8705","26",167,3,1,0,3,-105,30,-2,-2,142,38,2,-1,4,1,-247,-8,-4,-1
"8706","26",406,6,2,1,2,208,148,1,1,237,104,2,0,4,-2,-29,44,-1,1
"8707","26",402,6,3,1,0,49,-2,2,1,243,0,4,-1,4,-2,-194,-2,-2,2
"8708","26",168,7,1,0,3,78,-115,1,2,133,-58,1,2,4,-3,-55,-57,0,0
"8709","26",386,2,1,0,0,-136,-4,-1,-3,11,16,0,-1,4,2,-147,-20,-1,-2
"8710","26",476,4,3,1,0,-57,-56,-1,-1,-117,-205,0,0,4,0,60,149,-1,-1
"8711","26",103,5,2,1,3,8,-4,1,0,3,-63,1,1,4,-1,5,59,0,-1
"8712","26",326,7,4,1,2,162,57,2,2,170,85,2,2,4,-3,-8,-28,0,0
"8713","26",25,4,4,1,2,-32,-51,-1,-1,-1,4,0,0,4,0,-31,-55,-1,-1
"8714","26",270,5,3,1,1,55,3,1,0,62,7,1,-1,4,-1,-7,-4,0,1
"8715","26",267,4,3,0,1,6,0,-1,-1,38,-16,1,0,4,0,-32,16,-2,-1
"8716","26",235,8,3,1,0,159,-3,3,3,0,-1,0,0,4,-4,159,-2,3,3
"8717","26",401,6,2,1,1,77,16,0,1,117,12,1,1,4,-2,-40,4,-1,0
"8718","26",399,6,4,1,3,99,-8,1,1,131,-108,1,1,4,-2,-32,100,0,0
"8719","26",78,3,4,1,0,-171,-4,-2,-2,-179,-12,-2,-2,4,1,8,8,0,0
"8720","26",353,7,2,1,2,227,52,0,2,238,124,-4,-4,4,-3,-11,-72,4,6
"8721","26",207,5,1,0,0,-247,2,-1,0,25,1,0,1,4,-1,-272,1,-1,-1
"8722","26",426,7,4,1,3,5,-248,4,2,247,-4,3,2,4,-3,-242,-244,1,0
"8723","26",277,2,4,1,1,11,-72,3,-3,62,-68,2,0,4,2,-51,-4,1,-3
"8724","26",172,6,2,1,3,63,93,0,1,69,69,1,1,4,-2,-6,24,-1,0
"8725","26",169,4,3,1,0,-77,118,-2,-1,-223,213,-4,-4,4,0,146,-95,2,3
"8726","26",6,7,4,1,2,195,0,2,2,195,0,0,2,4,-3,0,0,2,0
"8727","26",56,4,3,1,1,43,-118,-1,-1,46,-114,-2,0,4,0,-3,-4,1,-1
"8728","26",52,2,3,1,0,-97,-2,-2,-3,0,-65,1,-2,4,2,-97,63,-3,-1
"8729","26",112,1,4,1,3,242,2,-4,-4,233,9,-4,2,4,3,9,-7,0,-6
"8730","26",109,1,1,0,1,-2,-212,0,-4,-69,-1,3,-4,4,3,67,-211,-3,0
"8731","26",105,2,1,0,0,-187,-4,-3,-3,-248,2,-4,-3,4,2,61,-6,1,0
"8732","26",328,6,3,1,1,14,3,1,1,13,9,1,1,4,-2,1,-6,0,0
"8733","26",251,4,3,1,1,-1,1,2,-1,-1,-170,0,-2,4,0,0,171,2,1
"8734","26",126,2,2,0,2,101,199,-1,-3,89,204,-1,-1,4,2,12,-5,0,-2
"8735","26",122,1,1,0,0,-187,-179,-4,-4,216,208,4,4,4,3,-403,-387,-8,-8
"8736","26",313,2,3,1,0,-94,-105,-3,-3,-236,-233,-4,-4,4,2,142,128,1,1
"8737","26",31,4,1,0,0,-182,-77,-1,-1,-121,-82,-3,-3,4,0,-61,5,2,2
"8738","26",51,7,4,1,1,52,-146,-3,2,33,-67,0,-1,4,-3,19,-79,-3,3
"8739","26",387,4,3,1,1,140,139,2,-1,191,171,3,4,4,0,-51,-32,-1,-5
"8740","26",108,9,2,1,3,208,215,4,4,221,221,4,4,4,-5,-13,-6,0,0
"8741","26",104,2,1,0,0,-237,0,1,-3,224,-4,1,-3,4,2,-461,4,0,0
"8742","26",327,6,4,1,3,118,-5,2,1,185,-16,4,1,4,-2,-67,11,-2,0
"8743","26",250,6,1,0,3,69,27,1,1,83,23,1,1,4,-2,-14,4,0,0
"8744","26",271,4,3,1,1,-79,-2,-1,-1,217,-2,3,3,4,0,-296,0,-4,-4
"8745","26",268,7,4,1,3,132,124,2,2,116,-126,3,3,4,-3,16,250,-1,-1
"8746","26",312,5,4,1,1,-51,82,0,0,-103,106,2,0,4,-1,52,-24,-2,0
"8747","26",309,5,4,1,2,222,15,-1,0,209,58,-1,-2,4,-1,13,-43,0,2
"8748","26",4,4,3,1,1,1,6,-2,-1,243,168,3,4,4,0,-242,-162,-5,-5
"8749","26",79,5,4,1,2,-51,-7,0,0,-40,-10,-1,-1,4,-1,-11,3,1,1
"8750","26",354,6,1,1,0,40,46,1,1,98,88,1,3,4,-2,-58,-42,0,-2
"8751","26",208,6,4,1,2,98,-1,1,1,-55,-5,-3,1,4,-2,153,4,4,0
"8752","26",427,4,4,1,1,243,38,1,-1,-206,-39,2,-2,4,0,449,77,-1,1
"8753","26",278,1,4,1,1,-33,-221,4,-4,229,-219,4,-4,4,3,-262,-2,0,0
"8754","26",173,6,4,1,3,60,5,1,1,96,20,0,0,4,-2,-36,-15,1,1
"8755","26",17,1,3,1,0,66,46,-1,-4,175,115,-2,-4,4,3,-109,-69,1,0
"8756","26",60,3,1,0,3,212,4,-2,-2,230,1,3,3,4,1,-18,3,-5,-5
"8757","26",57,1,4,1,1,142,-233,1,-4,140,-210,0,-4,4,3,2,-23,1,0
"8758","26",53,7,4,1,3,204,-4,2,2,-1,-77,2,2,4,-3,205,73,0,0
"8759","26",113,7,2,1,2,14,19,0,2,22,25,2,2,4,-3,-8,-6,-2,0
"8760","26",11,4,4,1,1,183,-127,1,-1,111,-56,0,-2,4,0,72,-71,1,1
"8761","26",106,6,2,1,1,50,31,1,1,39,25,2,1,4,-2,11,6,-1,0
"8762","26",329,3,4,1,3,150,-58,2,-2,83,-75,0,0,4,1,67,17,2,-2
"8763","26",252,6,4,1,1,109,-117,1,1,-138,-100,0,0,4,-2,247,-17,1,1
"8764","26",127,2,1,1,0,88,43,2,-3,58,87,2,-3,4,2,30,-44,0,0
"8765","26",123,3,4,1,2,-32,-16,-2,-2,-37,-25,-2,-2,4,1,5,9,0,0
"8766","26",314,1,4,1,1,-240,13,4,-4,-240,8,4,-4,4,3,0,5,0,0
"8767","26",310,7,4,1,2,148,55,2,2,68,89,2,2,4,-3,80,-34,0,0
"8768","26",460,3,1,0,0,-175,9,-2,-2,135,12,-2,2,4,1,-310,-3,0,-4
"8769","26",388,6,4,1,0,7,-230,-1,1,-238,4,-4,-4,4,-2,245,-234,3,5
"8770","26",307,6,4,1,2,177,75,2,1,20,14,0,0,4,-2,157,61,2,1
"8771","26",303,4,3,1,2,11,-50,-1,-1,77,-63,1,2,4,0,-66,13,-2,-3
"8772","26",30,7,2,1,2,-122,2,2,2,-182,-4,-2,-1,4,-3,60,6,4,3
"8773","26",297,2,3,1,2,182,39,2,-3,123,21,1,-4,4,2,59,18,1,1
"8774","26",175,3,4,1,1,-85,-41,-2,-2,-73,-56,-1,-3,4,1,-12,15,-1,1
"8775","26",171,5,1,0,1,14,21,0,0,26,63,0,0,4,-1,-12,-42,0,0
"8776","26",62,9,2,0,3,188,13,4,4,188,185,2,4,4,-5,0,-172,2,0
"8777","26",119,6,3,1,3,105,-61,2,1,85,129,-1,1,4,-2,20,-190,3,0
"8778","26",115,6,3,1,3,1,1,0,1,57,2,-1,0,4,-2,-56,-1,1,1
"8779","26",8,1,3,1,1,0,0,-4,-4,-2,-2,0,0,4,3,2,2,-4,-4
"8780","26",355,4,2,1,2,24,-15,-1,-1,70,52,-2,-2,4,0,-46,-67,1,1
"8781","26",209,5,4,1,3,196,1,1,0,155,4,2,2,4,-1,41,-3,-1,-2
"8782","26",428,1,1,0,0,-244,-241,-4,-4,-246,161,-4,-4,4,3,2,-402,0,0
"8783","26",279,7,4,0,3,26,-99,3,2,165,140,1,1,4,-3,-139,-239,2,1
"8784","26",174,6,4,1,3,203,129,1,1,46,165,1,1,4,-2,157,-36,0,0
"8785","26",170,3,2,1,0,79,81,-2,-2,98,98,0,0,4,1,-19,-17,-2,-2
"8786","26",61,1,1,0,3,212,32,4,-4,-9,-47,4,-4,4,3,221,79,0,0
"8787","26",58,6,4,1,1,-250,3,1,1,-3,223,4,4,4,-2,-247,-220,-3,-3
"8788","26",54,3,4,1,1,37,11,1,-2,39,19,0,0,4,1,-2,-8,1,-2
"8789","26",114,2,4,1,1,16,12,1,-3,93,125,1,-3,4,2,-77,-113,0,0
"8790","26",110,6,1,1,1,-102,-136,-2,1,90,148,3,3,4,-2,-192,-284,-5,-2
"8791","26",107,4,2,0,3,-46,47,3,-1,119,186,-2,1,4,0,-165,-139,5,-2
"8792","26",33,5,3,0,1,93,-48,-1,0,59,-56,-1,1,4,-1,34,8,0,-1
"8793","26",253,9,3,1,3,216,231,4,4,216,226,4,4,4,-5,0,5,0,0
"8794","26",128,7,1,0,3,176,-14,2,2,196,-46,2,2,4,-3,-20,32,0,0
"8795","26",124,7,1,0,3,212,2,3,2,241,30,4,1,4,-3,-29,-28,-1,1
"8796","26",315,9,3,1,3,244,11,4,4,244,20,4,4,4,-5,0,-9,0,0
"8797","26",311,1,2,1,2,90,2,3,-4,200,30,4,-4,4,3,-110,-28,-1,0
"8798","26",461,6,4,1,2,137,48,1,1,55,31,-1,-1,4,-2,82,17,2,2
"8799","26",389,9,3,1,2,-217,8,4,4,7,-50,0,0,4,-5,-224,58,4,4
"8800","26",308,2,4,1,0,-137,-116,-4,-3,93,103,0,1,4,2,-230,-219,-4,-4
"8801","26",304,7,2,1,2,184,21,2,2,129,-124,-1,2,4,-3,55,145,3,0
"8802","26",300,2,1,1,0,-91,52,-2,-3,14,36,0,-1,4,2,-105,16,-2,-2
"8803","26",298,4,1,1,0,-106,15,0,-1,2,-242,-1,0,4,0,-108,257,1,-1
"8804","26",176,8,1,1,1,189,32,1,3,140,31,2,3,4,-4,49,1,-1,0
"8805","26",395,8,3,1,1,44,12,-2,3,212,21,3,4,4,-4,-168,-9,-5,-1
"8806","26",63,5,4,0,1,-1,4,0,0,-1,4,0,0,4,-1,0,0,0,0
"8807","26",12,9,4,1,3,-1,0,4,4,-3,0,4,4,4,-5,2,0,0,0
"8808","26",116,6,2,1,3,85,-39,1,1,60,-15,1,3,4,-2,25,-24,0,-2
"8809","26",80,8,4,1,3,46,1,3,3,244,3,3,0,4,-4,-198,-2,0,3
"8810","26",356,3,4,1,1,-96,-10,-1,-2,199,60,2,3,4,1,-295,-70,-3,-5
"8811","26",21,4,4,1,2,53,57,2,-1,62,71,1,-1,4,0,-9,-14,1,0
"8812","26",429,1,2,1,0,-63,16,-2,-4,42,18,0,-4,4,3,-105,-2,-2,0
"8813","26",28,4,4,1,1,-46,-41,-1,-1,15,-61,-1,-1,4,0,-61,20,0,0
"8814","26",13,3,4,1,1,41,-92,0,-2,19,-72,0,-2,4,1,22,-20,0,0
"8815","26",373,3,3,1,0,-221,-37,1,-2,-224,-44,0,-4,4,1,3,7,1,2
"8816","26",317,4,4,1,2,-24,24,-1,-1,-35,38,-1,-1,4,0,11,-14,0,0
"8817","26",394,1,3,0,0,-246,246,-4,-4,-242,244,-4,-4,4,3,-4,2,0,0
"8818","26",390,7,2,1,2,156,170,2,2,62,36,2,4,4,-3,94,134,0,-2
"8819","26",196,2,3,1,0,40,2,-1,-3,134,134,1,1,4,2,-94,-132,-2,-4
"8820","26",192,7,4,1,1,-3,30,1,2,-148,-1,-2,0,4,-3,145,31,3,2
"8821","26",261,9,1,1,3,189,166,4,4,30,-74,4,4,4,-5,159,240,0,0
"8822","26",258,2,3,0,0,90,0,1,-3,-61,2,2,2,4,2,151,-2,-1,-5
"8823","26",254,3,2,1,3,175,-185,1,-2,200,-141,2,-1,4,1,-25,-44,-1,-1
"8824","26",129,3,4,1,1,-198,-4,-2,-2,-214,8,-2,-2,4,1,16,-12,0,0
"8825","26",125,3,4,1,0,80,-47,-3,-2,-27,-18,-3,0,4,1,107,-29,0,-2
"8826","26",316,5,3,1,0,179,-102,0,0,-103,-76,-2,-2,4,-1,282,-26,2,2
"8827","26",393,1,1,0,0,-101,-60,-4,-4,-66,-147,-4,-4,4,3,-35,87,0,0
"8828","26",39,4,3,0,1,163,-173,-2,-1,114,-108,1,0,4,0,49,-65,-3,-1
"8829","26",82,9,4,1,2,-65,37,4,4,17,239,4,4,4,-5,-82,-202,0,0
"8830","26",358,1,4,1,2,208,167,0,-4,249,235,0,-4,4,3,-41,-68,0,0
"8831","26",305,9,4,1,3,247,243,4,4,236,249,4,4,4,-5,11,-6,0,0
"8832","26",301,3,4,1,1,-46,-1,-1,-2,-91,4,-1,-2,4,1,45,-5,0,0
"8833","26",299,6,4,1,1,222,35,1,1,72,202,1,1,4,-2,150,-167,0,0
"8834","26",177,1,4,1,1,-131,101,-2,-4,51,195,-4,-3,4,3,-182,-94,2,-1
"8835","26",396,1,1,1,1,-230,108,4,-4,-2,1,4,-4,4,3,-228,107,0,0
"8836","26",64,9,1,0,1,211,-188,4,4,236,-1,4,4,4,-5,-25,-187,0,0
"8837","26",120,7,3,1,1,187,46,2,2,172,5,3,3,4,-3,15,41,-1,-1
"8838","26",117,3,4,1,2,65,29,-2,-2,51,28,-2,-3,4,1,14,1,0,1
"8839","26",81,2,1,0,0,-48,-108,-3,-3,-247,180,-4,-4,4,2,199,-288,1,1
"8840","26",357,4,4,1,2,-140,-16,-1,-1,151,55,-1,-1,4,0,-291,-71,0,0
"8841","26",210,1,4,1,2,17,149,0,-4,92,-35,1,-3,4,3,-75,184,-1,-1
"8842","26",43,1,3,1,0,-155,77,-4,-4,112,7,-2,-4,4,3,-267,70,-2,0
"8843","26",280,7,2,1,1,223,73,-1,2,233,-15,1,0,4,-3,-10,88,-2,2
"8844","26",130,9,1,0,3,181,76,4,4,145,28,4,4,4,-5,36,48,0,0
"8845","26",374,7,4,1,2,154,92,2,2,156,89,3,3,4,-3,-2,3,-1,-1
"8846","26",318,4,2,1,2,-27,-186,-4,-1,191,-187,-4,0,4,0,-218,1,0,-1
"8847","26",95,6,4,1,2,-4,-4,1,1,0,-39,1,1,4,-2,-4,35,0,0
"8848","26",391,5,2,1,3,160,153,0,0,133,154,0,1,4,-1,27,-1,0,-1
"8849","26",197,2,4,1,3,-196,-135,2,-3,-245,-9,3,-2,4,2,49,-126,-1,-1
"8850","26",193,1,1,0,0,187,109,-4,-4,216,169,1,1,4,3,-29,-60,-5,-5
"8851","26",262,6,4,1,3,91,33,2,1,107,76,1,1,4,-2,-16,-43,1,0
"8852","26",259,1,3,1,1,-36,18,4,-4,-1,3,4,-4,4,3,-35,15,0,0
"8853","26",255,6,3,1,1,119,-50,1,1,-78,-99,0,0,4,-2,197,49,1,1
"8854","26",179,5,1,1,1,0,-1,3,0,2,3,0,0,4,-1,-2,-4,3,0
"8855","26",230,6,1,0,0,-146,36,-3,1,-125,-11,-3,1,4,-2,-21,47,0,0
"8856","26",453,6,4,1,2,196,2,2,1,200,7,2,3,4,-2,-4,-5,0,-2
"8857","26",94,5,4,1,1,1,-4,0,0,-109,-121,-3,-3,4,-1,110,117,3,3
"8858","26",90,1,4,0,0,-241,13,-3,-4,234,13,4,4,4,3,-475,0,-7,-8
"8859","26",83,6,1,1,3,119,-121,2,1,152,-128,2,1,4,-2,-33,7,0,0
"8860","26",359,9,4,1,3,226,36,4,4,233,14,3,3,4,-5,-7,22,1,1
"8861","26",306,5,3,1,3,98,140,1,0,115,145,1,0,4,-1,-17,-5,0,0
"8862","26",302,3,1,1,0,-56,-11,-3,-2,205,36,-2,-2,4,1,-261,-47,-1,0
"8863","26",3,1,3,1,0,1,3,-1,-4,0,-2,0,-2,4,3,1,5,-1,-2
"8864","26",178,5,1,0,1,0,-3,0,0,-5,1,0,0,4,-1,5,-4,0,0
"8865","26",376,4,4,1,1,15,-155,-1,-1,44,-148,-1,-1,4,0,-29,-7,0,0
"8866","26",65,7,1,0,3,17,105,2,2,12,18,2,2,4,-3,5,87,0,0
"8867","26",121,1,1,0,0,-173,-22,-4,-4,234,-146,0,-4,4,3,-407,124,-4,0
"8868","26",118,6,3,1,1,-14,12,-1,1,14,14,1,1,4,-2,-28,-2,-2,0
"8869","26",199,7,4,1,2,212,102,2,2,205,90,2,2,4,-3,7,12,0,0
"8870","26",195,3,1,1,1,-158,117,2,-2,-112,101,3,-3,4,1,-46,16,-1,1
"8871","26",211,7,3,1,1,-33,-64,-2,2,105,114,-2,2,4,-3,-138,-178,0,0
"8872","26",430,5,2,1,1,54,-34,0,0,197,-99,1,-2,4,-1,-143,65,-1,2
"8873","26",281,1,4,1,2,-1,-248,0,-4,10,-239,0,1,4,3,-11,-9,0,-5
"8874","26",131,8,4,1,3,111,-35,-1,3,124,-44,-1,3,4,-4,-13,9,0,0
"8875","26",375,5,3,1,1,0,-1,1,0,12,1,1,0,4,-1,-12,-2,0,0
"8876","26",319,2,1,1,1,-205,-88,-3,-3,-85,40,1,2,4,2,-120,-128,-4,-5
"8877","26",96,2,1,0,0,-201,0,-3,-3,-30,-3,-1,-1,4,2,-171,3,-2,-2
"8878","26",392,2,1,1,0,-208,207,-3,-3,-169,128,-2,-2,4,2,-39,79,-1,-1
"8879","26",198,3,1,1,1,-120,93,-1,-2,-193,-177,-2,-3,4,1,73,270,1,1
"8880","26",194,8,1,1,0,-162,11,-4,3,-187,11,-4,3,4,-4,25,0,0,0
"8881","26",263,1,4,1,0,-211,0,-2,-4,-248,2,-4,-4,4,3,37,-2,2,0
"8882","26",26,3,1,0,0,-242,72,1,-2,-222,-63,-4,-4,4,1,-20,135,5,2
"8883","26",256,6,3,1,1,142,-1,2,1,120,86,1,1,4,-2,22,-87,1,0
"8884","26",18,3,3,1,1,-3,-14,1,-2,64,18,1,0,4,1,-67,-32,0,-2
"8885","26",231,5,4,1,0,2,-1,0,0,-2,1,-4,1,4,-1,4,-2,4,-1
"8886","26",454,8,4,1,3,241,3,2,3,232,1,3,3,4,-4,9,2,-1,0
"8887","26",162,8,3,1,3,91,125,-1,3,150,153,3,4,4,-4,-59,-28,-4,-1
"8888","26",91,4,2,1,3,176,2,2,-1,248,0,4,4,4,0,-72,2,-2,-5
"8889","26",84,8,4,1,3,195,2,3,3,207,2,3,3,4,-4,-12,0,0,0
"8890","26",36,3,3,1,3,174,184,2,-2,-130,-86,-1,-2,4,1,304,270,3,0
"8891","26",165,5,1,1,1,83,77,-1,0,65,51,1,1,4,-1,18,26,-2,-1
"8892","26",384,2,1,0,0,-205,1,-3,-3,0,137,-2,-2,4,2,-205,-136,-1,-1
"8893","26",98,3,3,1,0,-237,-17,-2,-2,110,-149,1,1,4,1,-347,132,-3,-3
"8894","26",377,1,1,0,0,-244,7,-4,-4,-246,8,-4,-4,4,3,2,-1,0,0
"8895","26",93,6,1,0,1,-67,49,-2,1,-131,82,-2,0,4,-2,64,-33,0,1
"8896","26",457,9,3,0,1,178,1,4,4,161,-16,3,3,4,-5,17,17,1,1
"8897","26",161,3,2,1,2,98,66,1,-2,85,75,1,-2,4,1,13,-9,0,0
"8898","26",45,4,3,1,0,80,97,1,-1,23,-44,1,1,4,0,57,141,0,-2
"8899","26",87,9,4,1,3,-54,129,3,4,-108,174,3,3,4,-5,54,-45,0,1
"8900","26",362,1,4,0,3,-116,134,4,-4,109,96,3,2,4,3,-225,38,1,-6
"8901","26",212,5,1,0,1,-35,9,4,0,-220,24,4,-2,4,-1,185,-15,0,2
"8902","26",431,5,3,1,0,4,10,0,0,27,36,0,0,4,-1,-23,-26,0,0
"8903","26",282,9,3,0,3,166,-50,1,4,178,25,1,4,4,-5,-12,-75,0,0
"8904","26",132,7,4,1,1,-56,17,1,2,4,84,1,2,4,-3,-60,-67,0,0
"8905","26",46,1,1,1,0,-202,-244,-4,-4,-112,-247,-4,-2,4,3,-90,3,0,-2
"8906","26",456,2,1,1,0,-198,39,0,-3,138,145,1,-3,4,2,-336,-106,-1,0
"8907","26",97,2,1,1,1,6,11,3,-3,-229,12,2,-3,4,2,235,-1,1,0
"8908","26",166,2,4,1,2,210,217,-2,-3,193,181,-2,-3,4,2,17,36,0,0
"8909","26",86,7,4,1,3,130,3,1,2,167,-8,2,3,4,-3,-37,11,-1,-1
"8910","26",361,2,1,1,0,2,-249,1,-3,2,-248,3,-1,4,2,0,-1,-2,-2
"8911","26",264,4,4,1,2,221,82,0,-1,199,174,-1,0,4,0,22,-92,1,-1
"8912","26",260,3,3,1,0,-188,-187,-2,-2,-229,-226,-3,-3,4,1,41,39,1,1
"8913","26",257,1,1,1,0,82,88,2,-4,126,72,2,-4,4,3,-44,16,0,0
"8914","26",180,9,2,1,2,247,-33,3,4,213,0,3,4,4,-5,34,-33,0,0
"8915","26",459,1,3,1,1,13,-26,2,-4,-117,-136,1,-4,4,3,130,110,1,0
"8916","26",455,6,2,1,2,4,48,2,1,162,0,2,2,4,-2,-158,48,0,-1
"8917","26",163,5,3,0,1,138,14,-1,0,10,65,1,0,4,-1,128,-51,-2,0
"8918","26",92,5,4,1,2,0,-3,0,0,0,-3,0,0,4,-1,0,0,0,0
"8919","26",85,6,2,1,2,127,-92,2,1,153,112,3,3,4,-2,-26,-204,-1,-2
"8920","26",360,1,3,1,0,-114,-10,-4,-4,125,182,0,-4,4,3,-239,-192,-4,0
"8921","26",133,4,2,1,1,-43,36,0,-1,230,14,4,0,4,0,-273,22,-4,-1
"8922","26",385,4,4,0,1,-24,55,0,-1,181,105,1,-1,4,0,-205,-50,-1,0
"8923","26",99,7,4,1,3,166,-40,2,2,222,-8,2,2,4,-3,-56,-32,0,0
"8924","26",378,3,4,1,1,-155,-1,-2,-2,-177,1,-2,-2,4,1,22,-2,0,0
"8925","26",215,2,1,0,0,-118,27,-2,-3,-109,28,-2,-3,4,2,-9,-1,0,0
"8926","26",458,3,1,1,1,2,3,-1,-2,62,83,-1,-2,4,1,-60,-80,0,0
"8927","26",366,7,4,1,3,192,-50,4,2,193,-72,3,2,4,-3,-1,22,1,0
"8928","26",450,5,4,1,3,156,3,1,0,-6,128,0,-1,4,-1,162,-125,1,1
"8929","26",88,9,4,1,2,213,224,4,4,225,234,3,4,4,-5,-12,-10,1,0
"8930","26",363,8,3,1,3,250,-1,3,3,-248,-1,-3,-3,4,-4,498,0,6,6
"8931","26",213,6,2,0,1,-56,0,-1,1,-1,20,1,1,4,-2,-55,-20,-2,0
"8932","26",432,5,2,0,1,61,-53,0,0,46,-59,0,0,4,-1,15,6,0,0
"8933","26",283,6,1,1,1,-77,-106,-2,1,-127,-83,-2,1,4,-2,50,-23,0,0
"8934","26",164,6,2,1,2,117,-98,1,1,98,-155,2,2,4,-2,19,57,-1,-1
"8935","26",452,2,3,1,1,-180,-6,-3,-3,-69,7,-1,-1,4,2,-111,-13,-2,-2
"8936","26",9,4,4,1,2,37,20,1,-1,32,23,1,-1,4,0,5,-3,0,0
"8937","26",365,1,3,1,1,-176,-3,0,-4,-247,-1,0,-4,4,3,71,-2,0,0
"8938","26",134,5,2,1,2,36,-1,0,0,70,6,1,0,4,-1,-34,-7,-1,0
"8939","26",37,1,1,1,0,-133,15,-3,-4,-199,28,-4,-4,4,3,66,-13,1,0
"8940","26",382,5,4,1,2,9,-12,1,0,141,12,1,1,4,-1,-132,-24,0,-1
"8941","26",216,6,3,0,1,51,-4,0,1,43,-24,-1,0,4,-2,8,20,1,1
"8942","26",189,2,1,0,1,-93,72,3,-3,-143,25,3,-3,4,2,50,47,0,0
"8943","26",185,5,4,1,2,38,-12,-1,0,67,-6,0,1,4,-1,-29,-6,-1,-1
"8944","26",181,3,4,1,3,102,-69,-2,-2,218,-90,-3,-3,4,1,-116,21,1,1
"8945","26",451,2,1,0,0,-142,-191,-3,-3,-18,-162,-2,-2,4,2,-124,-29,-1,-1
"8946","26",89,1,3,1,0,-207,0,-1,-4,-246,2,-4,-3,4,3,39,-2,3,-1
"8947","26",364,5,3,0,1,-17,-17,0,0,10,8,-1,0,4,-1,-27,-25,1,0
"8948","26",214,9,1,0,3,224,0,4,4,194,2,4,4,4,-5,30,-2,0,0
"8949","26",433,7,1,1,0,-66,-76,2,2,222,221,3,3,4,-3,-288,-297,-1,-1
"8950","26",284,3,3,1,1,-145,39,-3,-2,-205,131,-2,-3,4,1,60,-92,-1,1
"8951","26",369,3,4,1,0,-65,0,-1,-2,72,3,0,0,4,1,-137,-3,-1,-2
"8952","26",434,6,4,1,3,210,-21,1,1,211,-97,1,2,4,-2,-1,76,0,-1
"8953","26",158,5,3,1,0,-44,-212,-1,0,-74,-218,0,0,4,-1,30,6,-1,0
"8954","26",379,3,3,1,1,-5,-105,1,-2,33,21,1,0,4,1,-38,-126,0,-2
"8955","26",22,4,3,1,1,-60,7,-1,-1,13,11,0,0,4,0,-73,-4,-1,-1
"8956","26",370,9,1,0,3,245,-3,4,4,-244,-8,-4,-4,4,-5,489,5,8,8
"8957","26",367,3,3,1,1,-61,-88,2,-2,-101,-67,2,-1,4,1,40,-21,0,-1
"8958","26",217,4,4,1,2,59,33,1,-1,57,43,1,-1,4,0,2,-10,0,0
"8959","26",19,3,2,0,2,109,-70,0,-2,119,132,2,-1,4,1,-10,-202,-2,-1
"8960","26",186,5,2,1,2,1,4,0,0,132,117,0,0,4,-1,-131,-113,0,0
"8961","26",182,6,4,1,3,-5,-141,2,1,3,-180,2,2,4,-2,-8,39,0,-1
"8962","26",218,8,4,1,3,156,53,4,3,128,91,4,3,4,-4,28,-38,0,0
"8963","26",372,3,3,0,0,-212,-208,-3,-2,17,22,-1,-4,4,1,-229,-230,-2,2
"8964","26",187,7,4,1,2,95,111,2,2,173,167,3,3,4,-3,-78,-56,-1,-1
"8965","26",219,5,4,1,3,246,5,4,0,249,1,0,4,4,-1,-3,4,4,-4
"8966","26",191,2,1,0,0,-213,-36,-2,-3,-168,-66,-2,-2,4,2,-45,30,0,-1
"8967","26",227,7,3,0,3,-37,-24,1,2,-200,24,3,2,4,-3,163,-48,-2,0
"8968","26",135,5,1,0,1,-205,-90,0,0,-201,-57,0,0,4,-1,-4,-33,0,0
"8969","26",435,5,4,1,1,-1,-4,0,0,152,-9,3,0,4,-1,-153,5,-3,0
"8970","26",383,5,4,1,1,-1,2,0,0,1,-1,0,0,4,-1,-2,3,0,0
"8971","26",38,9,4,1,3,0,0,3,4,145,50,4,4,4,-5,-145,-50,-1,0
"8972","26",220,2,4,1,2,104,97,-2,-3,159,174,-3,-3,4,2,-55,-77,1,0
"8973","26",371,4,3,1,0,-118,-197,-1,-1,46,-171,-1,-1,4,0,-164,-26,0,0
"8974","26",368,5,3,0,3,-90,-77,0,0,-169,143,4,4,4,-1,79,-220,-4,-4
"8975","26",380,2,4,1,1,65,-40,3,-3,-185,-37,3,-4,4,2,250,-3,0,1
"8976","26",190,7,4,1,3,192,219,2,2,203,145,2,2,4,-3,-11,74,0,0
"8977","26",160,6,2,0,0,-198,26,-4,1,16,7,-4,2,4,-2,-214,19,0,-1
"8978","26",183,2,4,1,1,46,94,1,-3,30,64,0,0,4,2,16,30,1,-3
"8979","26",222,2,1,0,0,-246,-2,-3,-3,-235,-3,-3,-3,4,2,-11,1,0,0
"8980","26",285,5,2,0,1,-8,2,0,0,-90,-55,0,0,4,-1,82,57,0,0
"8981","26",188,9,2,1,3,231,0,4,4,239,1,4,4,4,-5,-8,-1,0,0
"8982","26",223,5,1,1,1,33,0,0,0,-3,-1,0,0,4,-1,36,1,0,0
"8983","26",159,8,3,1,2,0,0,3,3,221,-3,3,4,4,-4,-221,3,0,-1
"8984","26",228,6,4,1,2,15,116,1,1,94,116,2,2,4,-2,-79,0,-1,-1
"8985","26",136,1,1,1,0,-246,239,-4,-4,-98,92,-4,-4,4,3,-148,147,0,0
"8986","26",436,5,4,1,3,122,-1,4,0,114,-141,4,-1,4,-1,8,140,0,1
"8987","26",287,7,4,1,3,91,-1,2,2,-81,9,1,3,4,-3,172,-10,1,-1
"8988","26",229,6,1,1,1,59,68,-1,1,33,-49,2,2,4,-2,26,117,-3,-1
"8989","26",221,3,4,1,1,-228,11,-2,-2,16,0,1,1,4,1,-244,11,-3,-3
"8990","26",437,3,1,1,0,-200,4,-2,-2,-200,4,-2,-2,4,1,0,0,0,0
"8991","26",23,9,1,0,3,211,219,4,4,220,217,4,4,4,-5,-9,2,0,0
"8992","26",381,7,2,1,2,212,200,2,2,184,137,3,3,4,-3,28,63,-1,-1
"8993","26",438,6,4,1,3,129,1,4,1,123,1,4,2,4,-2,6,0,0,-1
"8994","26",441,9,4,1,2,44,21,3,4,32,8,3,3,4,-5,12,13,0,1
"8995","26",184,4,3,1,3,116,1,-1,-1,76,-1,1,1,4,0,40,2,-2,-2
"8996","26",439,6,2,1,1,98,0,1,1,130,5,2,2,4,-2,-32,-5,-1,-1
"8997","26",286,6,1,0,3,81,-9,2,1,51,-3,2,1,4,-2,30,-6,0,0
"8998","26",29,4,4,1,0,187,41,-2,-1,-230,249,-4,-4,4,0,417,-208,2,3
"8999","26",224,7,2,1,2,101,99,2,2,187,115,3,2,4,-3,-86,-16,-1,0
"9000","26",16,1,1,0,0,-150,18,-1,-4,238,16,2,-1,4,3,-388,2,-3,-3
"9001","26",290,4,1,0,1,93,-67,0,-1,64,-55,0,-2,4,0,29,-12,0,1
"9002","26",137,5,1,0,1,-98,-66,2,0,-242,-81,-4,-2,4,-1,144,15,6,2
"9003","26",225,9,2,1,2,192,-21,4,4,246,118,3,3,4,-5,-54,-139,1,1
"9004","26",288,5,2,0,2,-63,-3,-2,0,-2,4,0,1,4,-1,-61,-7,-2,-1
"9005","26",291,5,4,1,2,16,-1,-1,0,-186,25,-3,-4,4,-1,202,-26,2,4
"9006","26",226,1,1,0,0,-94,2,-2,-4,119,1,2,-2,4,3,-213,1,-4,-2
"9007","26",157,3,3,1,2,-73,-54,-2,-2,153,105,-2,0,4,1,-226,-159,0,-2
"9008","26",289,8,1,0,3,198,218,3,3,228,230,3,3,4,-4,-30,-12,0,0
"9009","26",154,5,4,0,3,84,74,0,0,21,131,0,2,4,-1,63,-57,0,-2
"9010","26",442,6,4,1,1,-27,25,-1,1,29,28,1,1,4,-2,-56,-3,-2,0
"9011","26",446,5,4,0,1,19,6,3,0,57,3,0,0,4,-1,-38,3,3,0
"9012","26",14,6,3,1,1,-30,-19,1,1,206,-57,4,3,4,-2,-236,38,-3,-2
"9013","26",44,3,2,1,2,-59,0,0,-2,219,192,0,1,4,1,-278,-192,0,-3
"9014","26",443,4,1,1,0,-17,-5,-1,-1,74,28,1,1,4,0,-91,-33,-2,-2
"9015","26",294,5,1,0,3,10,2,0,0,122,6,2,2,4,-1,-112,-4,-2,-2
"9016","26",140,7,1,1,1,-20,69,0,2,-26,-49,-1,0,4,-3,6,118,1,2
"9017","26",440,3,3,1,0,0,2,-2,-2,-53,1,-3,-3,4,1,53,1,1,1
"9018","26",444,5,2,1,2,1,-3,0,0,46,22,1,1,4,-1,-45,-25,-1,-1
"9019","26",138,5,3,1,1,-3,-7,0,0,69,-54,0,0,4,-1,-72,47,0,0
"9020","26",141,4,1,0,0,-112,-85,-2,-1,-220,-232,-4,-4,4,0,108,147,2,3
"9021","26",445,6,4,1,3,83,-25,1,1,59,-59,1,1,4,-2,24,34,0,0
"9022","26",139,9,4,1,2,115,-4,2,4,246,-2,3,4,4,-5,-131,-2,-1,0
"9023","26",142,5,2,1,2,50,-2,-2,0,219,-174,-1,0,4,-1,-169,172,-1,0
"9024","26",146,2,2,1,0,-177,-183,-3,-3,-179,-167,-3,-3,4,2,2,-16,0,0
"9025","26",293,1,4,1,0,-217,20,-4,-4,-11,-234,-4,-4,4,3,-206,254,0,0
"9026","26",155,9,2,1,1,-22,1,-4,4,243,237,-4,3,4,-5,-265,-236,0,1
"9027","26",147,6,2,1,3,139,-129,2,1,82,162,2,1,4,-2,57,-291,0,0
"9028","26",447,7,4,1,2,165,92,-2,2,189,69,1,0,4,-3,-24,23,-3,2
"9029","26",151,1,2,1,1,-19,8,0,-4,-6,9,0,-4,4,3,-13,-1,0,0
"9030","26",156,6,2,1,1,22,4,1,1,15,6,1,1,4,-2,7,-2,0,0
"9031","26",148,2,1,1,1,-195,-82,2,-3,-246,-84,3,-4,4,2,51,2,-1,1
"9032","26",295,5,1,0,1,-1,-3,0,0,-2,-3,0,0,4,-1,1,0,0,0
"9033","26",152,1,1,1,0,-147,-2,-2,-4,43,-2,0,-4,4,3,-190,0,-2,0
"9034","26",145,1,1,1,1,-198,-162,-4,-4,-245,-143,-3,-3,4,3,47,-19,-1,-1
"9035","26",292,6,3,0,1,102,-1,1,1,12,12,0,0,4,-2,90,-13,1,1
"9036","26",296,6,1,0,3,107,-3,1,1,193,-16,3,2,4,-2,-86,13,-2,-1
"9037","26",153,5,1,1,3,-2,2,1,0,-124,-52,1,1,4,-1,122,54,0,-1
"9038","26",15,6,4,1,3,34,41,2,1,-38,28,2,2,4,-2,72,13,0,-1
"9039","26",143,4,1,1,3,-14,26,-1,-1,62,-13,3,3,4,0,-76,39,-4,-4
"9040","26",449,6,4,1,3,95,-17,1,1,96,27,1,2,4,-2,-1,-44,0,-1
"9041","26",448,4,2,1,2,208,-1,0,-1,239,-4,-1,0,4,0,-31,3,1,-1
"9042","26",144,3,3,1,0,-48,-26,0,-2,3,1,2,0,4,1,-51,-27,-2,-2
"9043","26",150,5,3,1,1,-9,0,0,0,64,9,0,0,4,-1,-73,-9,0,0
"9044","26",149,6,3,1,1,0,-1,-3,1,245,4,-3,1,4,-2,-245,-5,0,0
"9045","27",346,8,3,0,0,-250,-55,0,3,247,35,3,3,7,-1,-497,-90,-3,0
"9046","27",347,9,1,0,3,-156,237,-4,4,112,135,2,3,7,-2,-268,102,-6,1
"9047","27",343,6,2,1,2,96,3,1,1,48,0,1,1,7,1,48,3,0,0
"9048","27",341,9,1,1,3,0,0,4,4,246,-24,4,4,7,-2,-246,24,0,0
"9049","27",66,3,1,1,1,50,0,-1,-2,-125,-2,2,-1,7,4,175,2,-3,-1
"9050","27",397,7,4,1,3,190,-81,-2,2,-161,-136,0,1,7,0,351,55,-2,1
"9051","27",345,9,1,0,0,-227,238,-4,4,-24,-117,-2,0,7,-2,-203,355,-2,4
"9052","27",318,6,2,0,2,189,186,-4,1,193,-207,-4,0,7,1,-4,393,0,1
"9053","27",100,6,4,1,3,242,3,2,1,233,-1,3,3,7,1,9,4,-1,-2
"9054","27",398,9,4,1,2,247,247,4,4,247,243,4,4,7,-2,0,4,0,0
"9055","27",338,1,3,0,2,20,-58,-4,-4,77,67,-4,-4,7,6,-57,-125,0,0
"9056","27",102,7,4,1,3,-61,63,2,2,-190,107,2,3,7,0,129,-44,0,-1
"9057","27",349,3,4,0,1,-101,-44,-3,-2,-78,109,2,1,7,4,-23,-153,-5,-3
"9058","27",67,2,1,0,0,-232,20,-4,-3,195,-217,4,1,7,5,-427,237,-8,-4
"9059","27",339,1,3,1,1,-202,-174,-4,-4,-108,-76,-3,-2,7,6,-94,-98,-1,-2
"9060","27",103,7,2,1,3,171,1,2,2,38,0,4,1,7,0,133,1,-2,1
"9061","27",342,4,3,0,1,12,11,0,-1,7,15,-1,0,7,3,5,-4,1,-1
"9062","27",68,1,4,1,0,41,4,-3,-4,192,2,1,-3,7,6,-151,2,-4,-1
"9063","27",348,2,3,0,1,-51,-2,0,-3,47,43,0,-1,7,5,-98,-45,0,-2
"9064","27",344,6,4,1,3,218,-41,2,1,46,-35,2,3,7,1,172,-6,0,-2
"9065","27",101,1,3,0,0,-245,243,-4,-4,232,233,-4,-4,7,6,-477,10,0,0
"9066","27",316,3,3,0,0,-160,-109,-1,-2,-180,-107,-2,-2,7,4,20,-2,1,0
"9067","27",105,1,1,0,0,-246,-17,-4,-4,-201,-1,-4,-4,7,6,-45,-16,0,0
"9068","27",320,9,2,1,2,232,85,3,4,201,109,2,3,7,-2,31,-24,1,1
"9069","27",317,3,4,1,2,-69,61,-2,-2,-35,42,-1,-1,7,4,-34,19,-1,-1
"9070","27",35,2,1,0,3,24,147,0,-3,130,139,3,-1,7,5,-106,8,-3,-2
"9071","27",399,6,4,1,3,133,58,1,1,123,17,1,1,7,1,10,41,0,0
"9072","27",321,1,1,1,0,-236,-233,-4,-4,-101,-71,-1,-1,7,6,-135,-162,-3,-3
"9073","27",245,1,1,0,0,-243,60,-4,-4,-243,4,-4,-4,7,6,0,56,0,0
"9074","27",319,7,1,0,1,69,-1,1,2,48,2,1,-1,7,0,21,-3,0,3
"9075","27",278,1,4,1,1,231,-227,4,-4,132,-221,4,-4,7,6,99,-6,0,0
"9076","27",34,6,4,1,2,14,-12,1,1,119,-79,1,2,7,1,-105,67,0,-1
"9077","27",104,1,1,0,0,-239,0,-4,-4,-234,2,-3,-4,7,6,-5,-2,-1,0
"9078","27",32,5,1,0,1,-1,0,0,0,182,-152,2,-4,7,2,-183,152,-2,4
"9079","27",69,1,4,0,1,28,22,-4,-4,-220,15,-2,-3,7,6,248,7,-2,-1
"9080","27",340,4,1,0,1,-97,-31,0,-1,40,21,0,0,7,3,-137,-52,0,-1
"9081","27",276,7,4,1,3,192,1,2,2,194,-1,2,2,7,0,-2,2,0,0
"9082","27",7,6,1,0,3,171,129,2,1,190,16,1,2,7,1,-19,113,1,-1
"9083","27",421,2,3,0,1,-191,152,-3,-3,168,180,1,1,7,5,-359,-28,-4,-4
"9084","27",313,2,3,0,0,-209,-211,-3,-3,-194,-172,-3,-3,7,5,-15,-39,0,0
"9085","27",31,4,1,0,0,-70,-52,-1,-1,-172,166,-4,-4,7,3,102,-218,3,3
"9086","27",70,9,2,1,2,243,244,4,4,168,175,1,-3,7,-2,75,69,3,7
"9087","27",4,5,3,0,1,0,4,0,0,231,198,2,4,7,2,-231,-194,-2,-4
"9088","27",314,1,4,1,1,-242,10,4,-4,-241,9,4,-4,7,6,-1,1,0,0
"9089","27",322,4,4,1,3,-61,55,-1,-1,234,-225,4,4,7,3,-295,280,-5,-5
"9090","27",246,9,4,1,3,231,4,4,4,120,-1,3,3,7,-2,111,5,1,1
"9091","27",40,7,1,0,2,125,-182,2,2,154,63,2,2,7,0,-29,-245,0,0
"9092","27",279,6,4,1,3,164,161,1,1,164,97,1,2,7,1,0,64,0,-1
"9093","27",323,1,4,1,1,1,-223,4,-4,113,-2,0,0,7,6,-112,-221,4,-4
"9094","27",352,4,2,1,1,15,-108,0,-1,35,-89,0,-1,7,3,-20,-19,0,0
"9095","27",400,4,4,1,2,109,168,-2,-1,118,-119,-1,-1,7,3,-9,287,-1,0
"9096","27",324,2,2,1,0,218,24,-3,-3,-1,10,-3,-3,7,5,219,14,0,0
"9097","27",106,6,2,1,1,17,27,1,1,63,32,1,1,7,1,-46,-5,0,0
"9098","27",277,6,4,1,1,88,-19,3,1,29,-132,4,0,7,1,59,113,-1,1
"9099","27",334,6,4,1,0,59,245,-4,1,-226,223,-4,-1,7,1,285,22,0,2
"9100","27",350,6,4,1,1,-5,-243,3,1,-6,-245,2,1,7,1,1,2,1,0
"9101","27",107,3,2,1,3,-25,21,2,-2,63,-143,2,0,7,4,-88,164,0,-2
"9102","27",310,8,4,1,2,223,70,3,3,183,48,2,2,7,-1,40,22,1,1
"9103","27",71,4,3,1,1,-107,9,-1,-1,39,29,-1,0,7,3,-146,-20,0,-1
"9104","27",351,1,1,0,0,-246,-246,-4,-4,245,245,-4,-4,7,6,-491,-491,0,0
"9105","27",315,9,3,0,3,242,13,4,4,222,9,4,4,7,-2,20,4,0,0
"9106","27",311,1,2,1,2,208,21,4,-4,179,29,4,-4,7,6,29,-8,0,0
"9107","27",247,3,3,0,0,-224,-11,-2,-2,96,-7,1,1,7,4,-320,-4,-3,-3
"9108","27",312,5,4,1,1,-88,-101,0,0,39,-114,4,0,7,2,-127,13,-4,0
"9109","27",309,2,4,1,2,216,200,2,-3,221,185,-1,-3,7,5,-5,15,3,0
"9110","27",248,5,4,1,3,218,243,4,0,0,46,1,-1,7,2,218,197,3,1
"9111","27",418,6,2,1,2,173,-190,1,1,197,-195,1,1,7,1,-24,5,0,0
"9112","27",401,4,2,1,1,145,12,-2,-1,66,12,1,1,7,3,79,0,-3,-2
"9113","27",422,1,3,0,1,-75,-150,4,-4,-65,-163,2,-4,7,6,-10,13,2,0
"9114","27",249,1,3,0,0,-68,-64,-4,-4,23,-24,1,-4,7,6,-91,-40,-5,0
"9115","27",402,1,3,0,0,-236,-1,-4,-4,244,2,4,1,7,6,-480,-3,-8,-5
"9116","27",335,6,2,1,1,18,31,0,1,-34,10,1,0,7,1,52,21,-1,1
"9117","27",423,4,1,1,3,-10,10,4,-1,6,20,-2,0,7,3,-16,-10,6,-1
"9118","27",108,9,2,1,3,212,178,4,4,205,227,3,3,7,-2,7,-49,1,1
"9119","27",403,3,1,0,0,-95,-11,0,-2,-37,-12,1,-1,7,4,-58,1,-1,-1
"9120","27",72,3,1,0,0,-237,234,0,-2,146,162,2,2,7,4,-383,72,-2,-4
"9121","27",109,1,1,0,1,-72,0,2,-4,-110,0,3,-4,7,6,38,0,-1,0
"9122","27",28,4,4,1,1,-59,-50,-1,-1,23,-57,-1,-1,7,3,-82,7,0,0
"9123","27",73,4,4,1,2,-48,-41,0,-1,-60,-39,0,0,7,3,12,-2,0,-1
"9124","27",353,1,2,1,2,241,242,-4,-4,236,132,-4,-4,7,6,5,110,0,0
"9125","27",244,6,4,1,2,205,231,2,1,85,116,2,1,7,1,120,115,0,0
"9126","27",325,8,1,0,1,-86,-85,-2,3,8,11,-1,3,7,-1,-94,-96,-1,0
"9127","27",330,8,2,1,2,188,232,3,3,159,162,1,1,7,-1,29,70,2,2
"9128","27",419,6,4,1,3,129,110,1,1,137,106,1,0,7,1,-8,4,0,1
"9129","27",281,1,4,1,2,248,3,-4,-4,248,3,4,-4,7,6,0,0,-8,0
"9130","27",326,7,4,1,2,166,81,2,2,156,93,2,2,7,0,10,-12,0,0
"9131","27",25,4,4,1,2,98,118,0,-1,204,208,0,-1,7,3,-106,-90,0,0
"9132","27",42,2,3,0,1,-63,53,2,-3,5,9,2,-2,7,5,-68,44,0,-1
"9133","27",336,3,4,1,3,199,129,3,-2,203,181,-2,3,7,4,-4,-52,5,-5
"9134","27",424,6,2,1,2,140,127,1,1,100,111,1,1,7,1,40,16,0,0
"9135","27",243,4,2,1,2,62,249,2,-1,249,67,1,2,7,3,-187,182,1,-3
"9136","27",167,7,1,0,3,104,110,2,2,-175,-114,-2,-2,7,0,279,224,4,4
"9137","27",425,8,4,1,2,63,45,2,3,-72,42,-1,-1,7,-1,135,3,3,4
"9138","27",11,3,4,1,1,148,-88,1,-2,145,-138,2,1,7,4,3,50,-1,-3
"9139","27",168,4,1,0,3,-22,-67,-1,-1,75,-85,2,2,7,3,-97,18,-3,-3
"9140","27",74,1,3,0,0,-161,-118,-4,-4,187,182,3,2,7,6,-348,-300,-7,-6
"9141","27",354,2,1,0,0,-205,-165,-2,-3,159,171,2,4,7,5,-364,-336,-4,-7
"9142","27",172,7,2,1,3,156,153,3,2,3,6,-1,-1,7,0,153,147,4,3
"9143","27",169,1,3,0,0,-230,-43,-4,-4,-81,74,-4,-4,7,6,-149,-117,0,0
"9144","27",331,2,1,0,0,-16,-206,-4,-3,13,-203,-4,-3,7,5,-29,-3,0,0
"9145","27",355,2,2,1,2,233,231,-4,-3,5,-17,-2,-2,7,5,228,248,-2,-1
"9146","27",282,9,3,0,3,-35,-23,1,4,110,35,1,4,7,-2,-145,-58,0,0
"9147","27",327,9,4,1,3,248,2,4,4,219,23,2,1,7,-2,29,-21,2,3
"9148","27",384,2,1,0,0,-224,1,-3,-3,1,67,-2,-2,7,5,-225,-66,-1,-1
"9149","27",404,4,1,0,1,67,-49,1,-1,51,-57,1,0,7,3,16,8,0,-1
"9150","27",328,4,3,0,1,-127,12,-1,-1,6,6,1,1,7,3,-133,6,-2,-2
"9151","27",251,2,3,0,1,-49,-49,-3,-3,0,-4,2,0,7,5,-49,-45,-5,-3
"9152","27",280,5,2,0,1,230,20,-1,0,56,-40,-1,-2,7,2,174,60,0,2
"9153","27",269,7,4,1,2,110,1,2,2,159,1,1,1,7,0,-49,0,1,1
"9154","27",426,8,4,0,3,247,4,3,3,245,0,3,2,7,-1,2,4,0,1
"9155","27",387,1,3,0,1,139,84,2,-4,103,101,2,1,7,6,36,-17,0,-5
"9156","27",406,6,2,1,2,221,221,3,1,172,50,1,0,7,1,49,171,2,1
"9157","27",75,2,4,1,2,228,47,4,-3,226,161,3,-3,7,5,2,-114,1,0
"9158","27",427,4,4,1,1,236,216,0,-1,-223,-26,2,-2,7,3,459,242,-2,1
"9159","27",173,7,4,1,3,191,3,0,2,16,0,0,0,7,0,175,3,0,2
"9160","27",17,1,3,0,0,-118,24,-2,-4,87,92,-1,-4,7,6,-205,-68,-1,0
"9161","27",250,6,1,0,3,85,22,1,1,92,22,1,1,7,1,-7,0,0,0
"9162","27",420,6,4,1,3,-1,-69,0,1,-42,0,0,1,7,1,41,-69,0,0
"9163","27",337,9,2,1,3,244,246,4,4,239,15,4,4,7,-2,5,231,0,0
"9164","27",39,3,3,0,1,-228,-4,-2,-2,170,193,3,2,7,4,-398,-197,-5,-4
"9165","27",272,7,4,1,2,194,142,2,2,138,-44,0,1,7,0,56,186,2,1
"9166","27",405,1,4,1,1,208,208,-4,-4,74,29,0,-1,7,6,134,179,-4,-3
"9167","27",390,9,2,1,2,250,247,4,4,204,210,4,4,7,-2,46,37,0,0
"9168","27",110,6,1,0,1,-63,61,-4,1,35,-106,-3,2,7,1,-98,167,-1,-1
"9169","27",273,4,1,0,0,-231,3,-2,-1,-37,55,0,0,7,3,-194,-52,-2,-1
"9170","27",27,6,2,1,2,139,163,2,1,27,53,1,0,7,1,112,110,1,1
"9171","27",391,9,2,1,3,190,217,4,4,193,193,0,1,7,-2,-3,24,4,3
"9172","27",388,4,4,1,0,-224,12,-3,-1,-233,2,1,-1,7,3,9,10,-4,0
"9173","27",307,1,4,1,2,-152,213,-4,-4,31,-37,0,4,7,6,-183,250,-4,-8
"9174","27",332,1,1,0,0,-250,157,-4,-4,-250,129,-2,-2,7,6,0,28,-2,-2
"9175","27",356,3,4,1,1,-190,1,-2,-2,122,1,2,1,7,4,-312,0,-4,-3
"9176","27",283,6,1,0,1,-85,51,-3,1,-96,-108,-1,1,7,1,11,159,-2,0
"9177","27",77,5,3,0,1,-4,-15,0,0,-140,1,-1,-1,7,2,136,-16,1,1
"9178","27",385,7,4,1,1,54,55,4,2,128,34,1,-1,7,0,-74,21,3,3
"9179","27",175,4,4,1,1,-84,-10,-2,-1,-44,-79,-1,-2,7,3,-40,69,-1,1
"9180","27",329,7,4,1,3,73,-85,2,2,-127,-77,-2,-2,7,0,200,-8,4,4
"9181","27",252,5,4,0,1,124,-71,0,0,91,-143,1,1,7,2,33,72,-1,-1
"9182","27",115,6,3,0,3,4,3,1,1,1,-3,1,1,7,1,3,6,0,0
"9183","27",111,1,1,0,0,-217,-229,-4,-4,-76,179,1,-1,7,6,-141,-408,-5,-3
"9184","27",407,9,2,1,2,242,-5,4,4,202,14,3,3,7,-2,40,-19,1,1
"9185","27",189,3,1,0,1,-241,18,2,-2,-223,23,3,-2,7,4,-18,-5,-1,0
"9186","27",55,5,4,1,1,-59,-1,0,0,-113,-88,0,0,7,2,54,87,0,0
"9187","27",76,5,4,1,3,8,2,4,0,15,-3,2,0,7,2,-7,5,2,0
"9188","27",428,1,1,0,0,-247,214,-4,-4,-246,204,-4,-4,7,6,-1,10,0,0
"9189","27",174,6,4,1,3,208,97,0,1,193,136,1,0,7,1,15,-39,-1,1
"9190","27",170,3,2,1,0,121,98,-2,-2,100,78,0,0,7,4,21,20,-2,-2
"9191","27",429,9,2,0,0,-68,9,4,4,40,14,0,-4,7,-2,-108,-5,4,8
"9192","27",386,1,1,0,0,-238,210,-4,-4,-12,15,-2,-3,7,6,-226,195,-2,-1
"9193","27",171,5,1,0,1,29,12,1,0,21,25,0,0,7,2,8,-13,1,0
"9194","27",265,6,1,0,3,46,-3,0,1,4,2,0,0,7,1,42,-5,0,1
"9195","27",358,3,4,1,2,249,247,0,-2,200,152,0,-4,7,4,49,95,0,2
"9196","27",305,9,4,1,3,247,244,4,4,244,242,4,4,7,-2,3,2,0,0
"9197","27",33,5,3,0,1,-5,-16,0,0,-229,35,0,0,7,2,224,-51,0,0
"9198","27",253,9,3,0,3,220,221,4,4,210,225,3,4,7,-2,10,-4,1,0
"9199","27",274,7,4,1,2,161,98,2,2,162,117,2,2,7,0,-1,-19,0,0
"9200","27",270,3,3,0,1,81,3,1,-2,158,3,3,2,7,4,-77,0,-2,-4
"9201","27",392,3,1,0,0,-144,49,-1,-2,-234,214,-2,-2,7,4,90,-165,1,0
"9202","27",389,9,3,1,2,249,1,-4,4,33,-16,1,1,7,-2,216,17,-5,3
"9203","27",308,1,4,1,0,-247,-243,-4,-4,246,246,4,4,7,6,-493,-489,-8,-8
"9204","27",333,6,4,1,1,47,7,1,1,-85,100,-4,1,7,1,132,-93,5,0
"9205","27",357,6,4,1,2,53,-13,1,1,61,1,1,-1,7,1,-8,-14,0,2
"9206","27",284,1,3,1,1,-227,-146,-3,-4,-103,-118,-3,-4,7,6,-124,-28,0,0
"9207","27",78,3,4,1,0,-156,-4,-2,-2,-174,-18,-2,-3,7,4,18,14,0,1
"9208","27",43,1,3,0,0,-173,182,-4,-4,108,-5,-1,-4,7,6,-281,187,-3,0
"9209","27",176,8,1,0,1,-67,-27,-3,3,172,18,1,3,7,-1,-239,-45,-4,0
"9210","27",471,6,3,0,2,-127,-112,0,1,-111,-113,1,1,7,1,-16,1,-1,0
"9211","27",266,5,1,0,1,-61,2,0,0,0,-4,0,-2,7,2,-61,6,0,2
"9212","27",116,6,2,1,3,121,-16,1,1,63,17,1,2,7,1,58,-33,0,-1
"9213","27",112,9,4,1,3,231,9,4,4,243,9,-4,4,7,-2,-12,0,8,0
"9214","27",408,4,1,0,0,-114,-103,-2,-1,-133,-6,0,-1,7,3,19,-97,-2,0
"9215","27",19,8,2,1,2,105,157,2,3,120,131,1,-1,7,-1,-15,26,1,4
"9216","27",56,5,3,0,1,109,-137,-1,0,29,-113,-2,0,7,2,80,-24,1,0
"9217","27",259,1,3,1,1,-67,33,4,-4,1,0,4,-4,7,6,-68,33,0,0
"9218","27",255,1,3,0,1,-108,-96,-4,-4,18,-52,0,0,7,6,-126,-44,-4,-4
"9219","27",202,4,1,0,1,34,30,1,-1,135,35,-2,-1,7,3,-101,-5,3,0
"9220","27",2,3,4,1,1,-106,80,-2,-2,121,-122,0,2,7,4,-227,202,-2,-4
"9221","27",394,1,3,1,0,-242,246,-4,-4,-245,248,-4,-4,7,6,3,-2,0,0
"9222","27",240,6,2,0,1,176,30,1,1,123,16,-4,1,7,1,53,14,5,0
"9223","27",237,7,2,1,2,245,182,0,2,94,42,-1,0,7,0,151,140,1,2
"9224","27",233,8,2,1,2,208,82,3,3,25,-49,1,1,7,-1,183,131,2,2
"9225","27",359,9,4,1,3,233,14,4,4,227,16,4,4,7,-2,6,-2,0,0
"9226","27",306,5,3,0,3,117,105,1,0,123,138,1,0,7,2,-6,-33,0,0
"9227","27",258,2,3,1,0,38,1,-3,-3,-19,1,1,-2,7,5,57,0,-4,-1
"9228","27",254,2,2,1,3,205,-229,-4,-3,218,-131,1,-1,7,5,-13,-98,-5,-2
"9229","27",275,4,4,1,2,248,2,3,-1,3,245,0,3,7,3,245,-243,3,-4
"9230","27",271,4,3,0,1,-56,2,-1,-1,198,4,4,4,7,3,-254,-2,-5,-5
"9231","27",393,1,1,0,0,-225,-31,-4,-4,30,30,4,-4,7,6,-255,-61,-8,0
"9232","27",24,9,2,1,2,241,-249,0,4,221,-1,3,4,7,-2,20,-248,-3,0
"9233","27",236,5,1,0,1,-1,1,0,0,-9,2,0,0,7,2,8,-1,0,0
"9234","27",232,1,1,0,0,-250,-216,-4,-4,-179,-93,-3,-4,7,6,-71,-123,-1,0
"9235","27",191,3,1,0,0,-186,-78,-2,-2,-209,-54,-2,-2,7,4,23,-24,0,0
"9236","27",285,5,2,0,1,-4,2,0,0,-77,4,-2,0,7,2,73,-2,2,0
"9237","27",79,5,4,1,2,-25,-15,0,0,-20,-10,0,0,7,2,-5,-5,0,0
"9238","27",430,3,2,1,1,190,-189,3,-2,185,-119,1,-2,7,4,5,-70,2,0
"9239","27",177,5,4,1,1,59,119,0,0,-107,113,0,0,7,2,166,6,0,0
"9240","27",472,1,1,0,0,-243,244,-4,-4,-233,208,-4,-4,7,6,-10,36,0,0
"9241","27",267,5,3,0,1,-4,-2,0,0,66,-8,0,1,7,2,-70,6,0,-1
"9242","27",117,1,4,1,2,196,158,-4,-4,33,-1,-1,-2,7,6,163,159,-3,-2
"9243","27",113,6,2,1,2,61,-14,1,1,25,46,-1,0,7,1,36,-60,2,1
"9244","27",409,6,4,1,2,194,188,3,1,124,127,2,2,7,1,70,61,1,-1
"9245","27",190,7,4,1,3,180,139,2,2,201,215,2,2,7,0,-21,-76,0,0
"9246","27",57,1,4,1,1,178,-184,-2,-4,137,-215,0,-4,7,6,41,31,-2,0
"9247","27",26,1,1,0,0,-231,-163,-4,-4,-169,-155,-3,-4,7,6,-62,-8,-1,0
"9248","27",256,5,3,0,1,-142,1,0,0,118,101,1,1,7,2,-260,-100,-1,-1
"9249","27",203,9,4,1,3,230,21,4,4,-12,-230,-4,4,7,-2,242,251,8,0
"9250","27",20,3,3,0,0,-194,-198,4,-2,54,72,2,4,7,4,-248,-270,2,-6
"9251","27",395,1,3,0,1,170,20,-4,-4,138,24,-2,3,7,6,32,-4,-2,-7
"9252","27",241,6,4,1,2,228,211,3,1,177,165,2,0,7,1,51,46,1,1
"9253","27",238,1,3,1,1,76,-12,-3,-4,106,-115,2,0,7,6,-30,103,-5,-4
"9254","27",234,4,3,0,3,93,44,0,-1,117,39,1,0,7,3,-24,5,-1,-1
"9255","27",36,8,3,0,3,-85,169,3,3,83,-148,3,-2,7,-1,-168,317,0,5
"9256","27",165,4,1,0,1,-170,6,-1,-1,78,57,1,1,7,3,-248,-51,-2,-2
"9257","27",303,8,3,1,2,142,-104,3,3,23,-42,1,1,7,-1,119,-62,2,2
"9258","27",30,9,2,1,2,179,2,4,4,182,3,1,2,7,-2,-3,-1,3,2
"9259","27",179,5,1,1,1,-4,2,0,0,3,1,0,0,7,2,-7,1,0,0
"9260","27",474,1,1,0,0,2,-71,0,-4,3,-77,0,-4,7,6,-1,6,0,0
"9261","27",122,3,1,0,0,-175,-161,-4,-2,226,211,4,4,7,4,-401,-372,-8,-6
"9262","27",119,7,3,0,3,136,-18,1,2,135,115,2,2,7,0,1,-133,-1,0
"9263","27",414,2,1,0,0,-143,-140,-3,-3,-38,-30,0,0,7,5,-105,-110,-3,-3
"9264","27",410,2,1,0,0,-246,-7,-2,-3,-142,-23,-2,-1,7,5,-104,16,0,-2
"9265","27",192,6,4,1,1,-2,-55,1,1,0,-126,1,1,7,1,-2,71,0,0
"9266","27",286,6,1,0,3,82,-1,0,1,69,-1,1,1,7,1,13,0,-1,0
"9267","27",8,6,3,1,1,-126,-11,2,1,14,19,0,1,7,1,-140,-30,2,0
"9268","27",431,3,3,0,0,-207,3,-3,-2,55,55,-1,-1,7,4,-262,-52,-2,-1
"9269","27",178,5,1,0,1,-1,3,0,0,-1,3,0,0,7,2,0,0,0,0
"9270","27",473,4,3,0,0,-202,-21,-1,-1,-163,-27,-1,-2,7,3,-39,6,0,1
"9271","27",268,7,4,0,3,132,124,2,2,112,-124,4,3,7,0,20,248,-2,-1
"9272","27",118,5,3,0,1,-86,36,-2,0,0,24,1,1,7,2,-86,12,-3,-1
"9273","27",114,2,4,0,1,-1,-2,0,-3,46,64,1,-3,7,5,-47,-66,-1,0
"9274","27",41,6,2,1,3,113,107,3,1,85,88,3,1,7,1,28,19,0,0
"9275","27",361,1,1,1,0,-2,-249,-4,-4,249,2,4,4,7,6,-251,-251,-8,-8
"9276","27",58,8,4,1,1,-246,5,-4,3,-2,241,4,3,7,-1,-244,-236,-8,0
"9277","27",260,3,3,0,0,-241,-244,-2,-2,-213,-226,-2,-2,7,4,-28,-18,0,0
"9278","27",257,1,1,0,0,-221,45,-1,-4,105,106,1,-4,7,6,-326,-61,-2,0
"9279","27",204,4,3,0,1,89,-38,0,-1,122,-111,0,0,7,3,-33,73,0,-1
"9280","27",200,1,3,0,0,-197,-47,-4,-4,62,-20,-3,-4,7,6,-259,-27,-1,0
"9281","27",396,1,1,0,1,-247,247,4,-4,0,1,4,-4,7,6,-247,246,0,0
"9282","27",242,4,4,1,2,131,99,2,-1,59,34,2,-2,7,3,72,65,0,1
"9283","27",239,2,1,0,1,-236,-208,-3,-3,152,-52,2,1,7,5,-388,-156,-5,-4
"9284","27",235,1,3,1,0,-248,5,-4,-4,184,3,2,2,7,6,-432,2,-6,-6
"9285","27",360,1,3,0,0,-195,-171,0,-4,-1,3,0,-4,7,6,-194,-174,0,0
"9286","27",166,2,4,1,2,228,232,-3,-3,192,182,-2,-2,7,5,36,50,-1,-1
"9287","27",304,7,2,1,2,238,-19,2,2,109,-56,1,1,7,0,129,37,1,1
"9288","27",300,2,1,0,0,-227,35,-2,-3,37,39,1,1,7,5,-264,-4,-3,-4
"9289","27",18,3,3,0,1,-46,-138,-2,-2,10,10,1,-1,7,4,-56,-148,-3,-1
"9290","27",475,4,3,0,3,38,-66,0,-1,64,35,0,0,7,3,-26,-101,0,-1
"9291","27",123,4,4,1,2,133,-34,-3,-1,-52,-30,-2,-2,7,3,185,-4,-1,1
"9292","27",12,9,4,1,3,1,1,4,4,0,2,4,4,7,-2,1,-1,0,0
"9293","27",415,9,2,1,2,214,221,1,4,174,182,0,2,7,-2,40,39,1,2
"9294","27",411,9,2,1,2,219,228,4,4,229,239,4,4,7,-2,-10,-11,0,0
"9295","27",193,1,1,0,0,-214,-190,-4,-4,158,-51,1,1,7,6,-372,-139,-5,-5
"9296","27",287,8,4,1,3,117,10,2,3,116,18,1,1,7,-1,1,-8,1,2
"9297","27",80,8,4,1,3,214,0,3,3,218,-2,3,3,7,-1,-4,2,0,0
"9298","27",432,4,2,1,1,106,88,-1,-1,45,-58,0,0,7,3,61,146,-1,-1
"9299","27",206,1,4,1,0,-103,-53,-3,-4,-230,-192,-4,-4,7,6,127,139,1,0
"9300","27",13,2,4,1,1,2,-114,-1,-3,103,-46,1,-1,7,5,-101,-68,-2,-2
"9301","27",126,4,2,1,2,168,223,-1,-1,94,206,-1,-1,7,3,74,17,0,0
"9302","27",470,4,1,0,1,-71,36,-1,-1,-148,32,-2,-2,7,3,77,4,1,1
"9303","27",467,5,1,0,3,-48,-90,4,0,84,71,4,0,7,2,-132,-161,0,0
"9304","27",463,6,4,1,3,-247,3,-4,1,-244,3,2,4,7,1,-3,0,-6,-3
"9305","27",362,2,4,0,3,-142,62,4,-3,94,-82,2,-1,7,5,-236,144,2,-2
"9306","27",59,2,1,0,0,-140,76,-3,-3,-55,-36,1,1,7,5,-85,112,-4,-4
"9307","27",261,9,1,0,3,210,207,4,4,193,185,4,4,7,-2,17,22,0,0
"9308","27",185,8,4,1,2,175,-13,-1,3,220,-23,-2,3,7,-1,-45,10,1,0
"9309","27",205,6,1,0,2,233,-2,0,1,1,-196,3,3,7,1,232,194,-3,-2
"9310","27",201,9,3,0,1,93,-5,2,4,28,0,-2,-3,7,-2,65,-5,4,7
"9311","27",125,3,4,1,0,-212,-22,-4,-2,-46,-31,-3,-1,7,4,-166,9,-1,-1
"9312","27",47,7,4,1,3,213,21,1,2,149,-1,2,1,7,0,64,22,-1,1
"9313","27",466,2,3,0,0,-107,53,-2,-3,-67,-114,-2,-2,7,5,-40,167,0,-1
"9314","27",462,9,3,0,3,228,16,4,4,227,218,4,4,7,-2,1,-202,0,0
"9315","27",195,1,1,1,1,-218,208,4,-4,-191,183,3,-3,7,6,-27,25,1,-1
"9316","27",289,8,1,0,3,187,187,3,3,215,223,3,3,7,-1,-28,-36,0,0
"9317","27",82,9,4,1,2,21,240,4,4,-6,3,0,0,7,-2,27,237,4,4
"9318","27",301,2,4,0,1,-166,4,-2,-3,-71,3,-1,-2,7,5,-95,1,-1,-1
"9319","27",180,9,2,1,2,214,-1,0,4,248,0,3,3,7,-2,-34,-1,-3,1
"9320","27",476,3,3,0,0,-143,-143,-2,-2,-187,-70,1,2,7,4,44,-73,-3,-4
"9321","27",124,8,1,0,3,167,-1,3,3,216,1,0,2,7,-1,-49,-2,3,1
"9322","27",120,6,3,0,1,-28,-60,1,1,134,120,1,1,7,1,-162,-180,0,0
"9323","27",416,7,4,0,0,-234,227,-4,2,-80,53,-4,-4,7,0,-154,174,0,6
"9324","27",412,1,1,0,0,-243,-21,-4,-4,243,1,4,4,7,6,-486,-22,-8,-8
"9325","27",194,8,1,0,0,-221,10,-4,3,-192,9,-4,3,7,-1,-29,1,0,0
"9326","27",288,7,2,1,2,193,113,3,2,42,-39,1,2,7,0,151,152,2,0
"9327","27",81,7,1,0,0,-232,161,-3,2,-206,144,-2,1,7,0,-26,17,-1,1
"9328","27",433,1,1,1,0,-229,-230,-4,-4,214,178,2,2,7,6,-443,-408,-6,-6
"9329","27",207,3,1,0,0,-249,-1,-4,-2,0,1,0,0,7,4,-249,-2,-4,-2
"9330","27",130,9,1,0,3,223,55,4,4,115,51,4,4,7,-2,108,4,0,0
"9331","27",127,1,1,0,0,-224,-42,2,-4,85,64,2,-3,7,6,-309,-106,0,-1
"9332","27",1,4,1,0,1,-100,-97,-1,-1,24,20,1,2,7,3,-124,-117,-2,-3
"9333","27",468,7,1,0,3,67,7,1,2,108,47,1,0,7,0,-41,-40,0,2
"9334","27",464,6,1,0,1,7,18,1,1,16,40,1,1,7,1,-9,-22,0,0
"9335","27",363,3,3,0,3,-249,2,2,-2,3,249,3,3,7,4,-252,-247,-1,-5
"9336","27",6,8,4,1,2,233,-37,2,3,166,0,2,2,7,-1,67,-37,0,1
"9337","27",262,6,4,1,3,55,51,1,1,72,104,1,1,7,1,-17,-53,0,0
"9338","27",186,7,2,1,2,229,223,1,2,131,128,0,1,7,0,98,95,1,1
"9339","27",182,7,4,1,3,128,-57,2,2,2,-164,1,1,7,0,126,107,1,1
"9340","27",49,8,4,1,1,113,83,3,3,0,-3,0,0,7,-1,113,86,3,3
"9341","27",377,1,1,0,0,-243,6,-4,-4,-243,7,-4,-4,7,6,0,-1,0,0
"9342","27",373,1,3,0,0,-244,-52,0,-4,-233,-163,0,-4,7,6,-11,111,0,0
"9343","27",154,5,4,1,3,-5,-28,0,0,-55,-75,0,0,7,2,50,47,0,0
"9344","27",196,1,3,0,0,-243,1,-4,-4,1,3,0,0,7,6,-244,-2,-4,-4
"9345","27",366,7,4,1,3,148,-64,4,2,45,46,3,2,7,0,103,-110,1,0
"9346","27",29,1,4,1,0,-202,200,-4,-4,86,73,-4,-2,7,6,-288,127,0,-2
"9347","27",83,6,1,0,3,136,-165,1,1,148,-113,2,1,7,1,-12,-52,-1,0
"9348","27",302,3,1,0,0,-216,25,-4,-2,208,38,-2,-2,7,4,-424,-13,-2,0
"9349","27",181,9,4,1,3,223,209,4,4,157,153,1,1,7,-2,66,56,3,3
"9350","27",48,1,3,0,0,-1,0,-4,-4,74,-82,-4,-4,7,6,-75,82,0,0
"9351","27",129,7,4,1,1,163,-5,2,2,-211,1,-2,-2,7,0,374,-6,4,4
"9352","27",121,1,1,0,0,-192,-31,-4,-4,229,-143,-1,-4,7,6,-421,112,-3,0
"9353","27",417,8,2,1,2,167,158,3,3,3,2,0,0,7,-1,164,156,3,3
"9354","27",413,6,1,0,1,140,3,-1,1,-133,4,-3,0,7,1,273,-1,2,1
"9355","27",365,1,3,1,1,2,-221,4,-4,-241,-4,0,-4,7,6,243,-217,4,0
"9356","27",61,1,1,0,3,240,5,4,-4,-27,8,4,-4,7,6,267,-3,0,0
"9357","27",264,6,4,1,2,232,237,1,1,181,92,-1,-1,7,1,51,145,2,2
"9358","27",434,7,4,1,3,191,-11,2,2,191,-11,2,2,7,0,0,0,0,0
"9359","27",208,9,4,1,2,247,3,4,4,-136,-6,-4,1,7,-2,383,9,8,3
"9360","27",131,8,4,1,3,195,43,-3,3,103,-48,-1,3,7,-1,92,91,-2,0
"9361","27",128,7,1,0,3,202,-35,2,2,179,-117,1,2,7,0,23,82,1,0
"9362","27",10,4,3,0,1,-38,6,-1,-1,-12,3,-1,0,7,3,-26,3,0,-1
"9363","27",469,2,4,1,0,242,48,-4,-3,71,101,-3,-3,7,5,171,-53,-1,0
"9364","27",465,6,4,1,3,229,8,2,1,11,-225,2,3,7,1,218,233,0,-2
"9365","27",364,5,3,0,1,-9,-10,0,0,-56,-3,-1,-1,7,2,47,-7,1,1
"9366","27",60,7,1,0,3,206,4,3,2,-7,-247,3,3,7,0,213,251,0,-1
"9367","27",263,1,4,1,0,-241,-1,-4,-4,-219,7,-2,-2,7,6,-22,-8,-2,-2
"9368","27",187,7,4,1,2,206,212,3,2,124,152,2,2,7,0,82,60,1,0
"9369","27",183,6,4,1,1,71,4,1,1,62,51,1,1,7,1,9,-47,0,0
"9370","27",5,9,2,1,2,212,190,3,4,155,87,1,1,7,-2,57,103,2,3
"9371","27",378,5,4,1,1,-101,5,-1,0,79,-1,1,1,7,2,-180,6,-2,-1
"9372","27",374,9,4,1,2,189,185,3,4,176,87,2,2,7,-2,13,98,1,2
"9373","27",155,9,2,1,1,223,226,-4,4,242,247,-4,4,7,-2,-19,-21,0,0
"9374","27",197,4,4,1,3,-224,-55,2,-1,-247,-12,3,-1,7,3,23,-43,-1,0
"9375","27",367,4,3,0,1,-51,-43,2,-1,-80,-74,2,-1,7,3,29,31,0,0
"9376","27",290,2,1,0,1,-135,35,0,-3,67,20,1,-1,7,5,-202,15,-1,-2
"9377","27",84,8,4,1,3,201,3,3,3,207,2,3,3,7,-1,-6,1,0,0
"9378","27",460,2,1,0,0,-225,105,-4,-3,156,18,-2,1,7,5,-381,87,-2,-4
"9379","27",230,5,1,0,0,-220,77,-3,0,-197,22,-3,1,7,2,-23,55,0,-1
"9380","27",297,1,3,1,2,-228,232,-4,-4,222,221,3,3,7,6,-450,11,-7,-7
"9381","27",199,8,4,1,2,224,144,3,3,211,173,2,2,7,-1,13,-29,1,1
"9382","27",161,3,2,1,2,152,216,-3,-2,81,59,1,-2,7,4,71,157,-4,0
"9383","27",158,4,3,1,0,-63,-33,-2,-1,-36,-24,-1,-1,7,3,-27,-9,-1,0
"9384","27",37,1,1,0,0,-147,14,-3,-4,-135,18,-3,-4,7,6,-12,-4,0,0
"9385","27",45,1,3,0,0,-197,-113,-4,-4,70,79,1,-2,7,6,-267,-192,-5,-2
"9386","27",62,9,2,1,3,191,233,4,4,233,213,4,4,7,-2,-42,20,0,0
"9387","27",87,7,4,1,3,210,-23,2,2,85,-76,1,2,7,0,125,53,1,0
"9388","27",435,5,4,1,1,8,4,2,0,33,-158,1,-1,7,2,-25,162,1,1
"9389","27",209,7,4,1,3,139,7,2,2,178,1,2,3,7,0,-39,6,0,-1
"9390","27",132,7,4,1,1,144,-12,1,2,23,181,1,0,7,0,121,-193,0,2
"9391","27",38,9,4,1,3,114,-18,4,4,203,-39,4,4,7,-2,-89,21,0,0
"9392","27",376,4,4,1,1,30,-154,-1,-1,68,-160,-1,-1,7,3,-38,6,0,0
"9393","27",157,9,3,0,2,195,203,4,4,177,93,-2,0,7,-2,18,110,6,4
"9394","27",85,9,2,1,2,120,141,4,4,149,141,2,2,7,-2,-29,0,2,2
"9395","27",369,1,4,1,0,-218,4,-4,-4,-94,0,1,0,7,6,-124,4,-5,-4
"9396","27",292,5,3,0,1,85,-5,0,0,2,-56,0,0,7,2,83,51,0,0
"9397","27",86,6,4,1,3,25,90,2,1,-129,-7,-2,-1,7,1,154,97,4,2
"9398","27",188,9,2,1,3,228,0,4,4,228,9,4,4,7,-2,0,-9,0,0
"9399","27",184,7,3,0,3,109,2,1,2,-1,2,0,0,7,0,110,0,1,2
"9400","27",50,3,2,1,1,210,52,2,-2,125,-89,2,-2,7,4,85,141,0,0
"9401","27",379,4,3,1,1,0,-162,-1,-1,24,-81,1,0,7,3,-24,-81,-2,-1
"9402","27",375,5,3,0,1,0,1,0,0,5,0,0,0,7,2,-5,1,0,0
"9403","27",156,5,2,1,1,-22,4,0,0,6,-3,1,1,7,2,-28,7,-1,-1
"9404","27",198,3,1,0,1,-70,-52,-1,-2,-6,-105,0,-1,7,4,-64,53,-1,-1
"9405","27",368,1,3,0,3,98,-140,-4,-4,-89,103,4,4,7,6,187,-243,-8,-8
"9406","27",291,8,4,1,2,247,179,4,3,-246,73,-4,-4,7,-1,493,106,8,7
"9407","27",133,1,2,1,1,-232,-26,0,-4,230,12,4,0,7,6,-462,-38,-4,-4
"9408","27",461,6,4,1,2,123,35,1,1,65,48,1,1,7,1,58,-13,0,0
"9409","27",231,8,4,1,0,-183,-164,-4,3,-7,5,1,1,7,-1,-176,-169,-5,2
"9410","27",298,2,1,0,0,-237,16,-1,-3,18,-164,-1,1,7,5,-255,180,0,-4
"9411","27",453,8,4,1,2,173,3,3,3,-1,-131,2,2,7,-1,174,134,1,1
"9412","27",162,9,3,0,3,25,77,0,4,113,131,3,4,7,-2,-88,-54,-3,0
"9413","27",159,1,3,0,2,241,-5,-3,-4,213,14,4,4,7,6,28,-19,-7,-8
"9414","27",370,9,1,0,3,-246,-14,-4,4,-243,-14,-4,-4,7,-2,-3,0,0,8
"9415","27",450,7,4,1,3,-85,2,-1,2,-4,162,1,1,7,0,-81,-160,-2,1
"9416","27",63,5,4,0,1,0,-4,0,0,0,-4,0,0,7,2,0,0,0,0
"9417","27",88,9,4,1,2,216,229,4,4,236,54,3,4,7,-2,-20,175,1,0
"9418","27",436,6,4,0,3,120,-223,3,1,129,-176,4,2,7,1,-9,-47,-1,-1
"9419","27",21,4,4,1,2,82,76,3,-1,145,35,1,-1,7,3,-63,41,2,0
"9420","27",160,7,2,1,0,236,75,-4,2,30,19,-4,2,7,0,206,56,0,0
"9421","27",372,1,3,0,0,-248,-242,-4,-4,35,90,-2,-4,7,6,-283,-332,-2,0
"9422","27",452,4,3,0,1,-8,-1,-1,-1,-67,2,-1,-1,7,3,59,-3,0,0
"9423","27",65,7,1,0,3,51,103,2,2,35,28,2,2,7,0,16,75,0,0
"9424","27",9,4,4,1,2,6,5,1,-1,35,20,1,-1,7,3,-29,-15,0,0
"9425","27",98,1,3,0,0,-242,-17,-4,-4,223,207,3,3,7,6,-465,-224,-7,-7
"9426","27",293,1,4,1,0,-117,14,-4,-4,-229,-5,-4,-4,7,6,112,19,0,0
"9427","27",90,1,4,1,0,-244,-1,-4,-4,134,-1,0,4,7,6,-378,0,-4,-8
"9428","27",439,7,2,0,1,143,-3,2,2,139,-3,2,2,7,0,4,0,0,0
"9429","27",383,5,4,1,1,-1,1,0,0,-1,1,0,0,7,2,0,0,0,0
"9430","27",51,4,4,1,1,64,-114,0,-1,64,-120,1,-1,7,3,0,6,-1,0
"9431","27",371,1,3,0,0,-186,-195,-4,-4,176,171,-2,1,7,6,-362,-366,-2,-5
"9432","27",164,7,2,1,2,92,78,2,2,72,-55,1,2,7,0,20,133,1,0
"9433","27",64,9,1,0,1,229,-224,4,4,225,1,4,4,7,-2,4,-225,0,0
"9434","27",89,4,3,1,0,-238,6,-3,-1,-249,-1,-1,-4,7,3,11,7,-2,3
"9435","27",437,2,1,0,0,-218,1,-3,-3,-105,2,-3,-3,7,5,-113,-1,0,0
"9436","27",210,9,4,0,2,234,-27,-4,4,237,147,4,4,7,-2,-3,-174,-8,0
"9437","27",134,5,2,1,2,138,10,2,0,10,3,1,0,7,2,128,7,1,0
"9438","27",438,9,4,1,3,247,2,4,4,102,-2,4,1,7,-2,145,4,0,3
"9439","27",382,6,4,1,2,2,2,0,1,25,5,-1,0,7,1,-23,-3,1,1
"9440","27",299,2,4,1,1,-211,-20,-2,-3,80,188,1,1,7,5,-291,-208,-3,-4
"9441","27",454,8,4,1,3,249,4,3,3,247,2,4,4,7,-1,2,2,-1,-1
"9442","27",163,6,3,0,1,77,-43,-2,1,22,61,1,0,7,1,55,-104,-3,1
"9443","27",16,2,1,0,0,-230,231,-1,-3,65,18,1,-2,7,5,-295,213,-2,-1
"9444","27",91,8,2,1,3,242,2,3,3,242,-1,3,3,7,-1,0,3,0,0
"9445","27",451,1,1,0,0,-212,-231,-3,-4,-177,-124,-2,-2,7,6,-35,-107,-1,-2
"9446","27",213,6,2,1,1,176,-3,2,1,0,-41,1,0,7,1,176,38,1,1
"9447","27",52,3,3,0,0,-94,0,-2,-2,186,-1,3,1,7,4,-280,1,-5,-3
"9448","27",456,1,1,0,0,-243,222,-2,-4,147,135,1,-3,7,6,-390,87,-3,-1
"9449","27",440,2,3,1,0,-139,-4,-3,-3,-1,0,0,0,7,5,-138,-4,-3,-3
"9450","27",296,7,1,0,3,150,-11,2,2,197,22,2,2,7,0,-47,-33,0,0
"9451","27",457,7,3,0,1,124,-3,2,2,197,-23,3,3,7,0,-73,20,-1,-1
"9452","27",441,8,4,1,2,75,64,3,3,59,43,3,2,7,-1,16,21,0,1
"9453","27",94,3,4,1,1,-4,-3,-2,-2,55,-46,-1,2,7,4,-59,43,-1,-4
"9454","27",227,7,3,0,3,-197,-108,2,2,-7,31,2,3,7,0,-190,-139,0,-1
"9455","27",99,8,4,1,3,164,-5,4,3,213,-22,1,2,7,-1,-49,17,3,1
"9456","27",294,7,1,0,3,158,2,2,2,-1,-1,0,0,7,0,159,3,2,2
"9457","27",3,1,3,0,0,-149,-1,2,-4,-53,-1,-2,-2,7,6,-96,0,4,-2
"9458","27",44,7,2,1,2,205,184,0,2,221,18,0,1,7,0,-16,166,0,1
"9459","27",443,2,1,0,0,-170,-67,-2,-3,44,38,2,0,7,5,-214,-105,-4,-3
"9460","27",295,5,1,0,1,1,-2,0,0,-4,-4,0,0,7,2,5,2,0,0
"9461","27",92,6,4,1,2,70,73,1,1,-3,5,0,0,7,1,73,68,1,1
"9462","27",46,2,1,0,0,-48,-247,-4,-3,-24,-246,-4,-4,7,5,-24,-1,0,1
"9463","27",214,9,1,0,3,250,1,4,4,205,2,4,4,7,-2,45,-1,0,0
"9464","27",93,6,1,0,1,-126,113,-2,1,-88,53,-2,0,7,1,-38,60,0,1
"9465","27",23,9,1,0,3,214,213,4,4,209,216,4,4,7,-2,5,-3,0,0
"9466","27",211,9,3,1,1,64,95,4,4,106,100,3,4,7,-2,-42,-5,1,0
"9467","27",135,7,1,0,1,-150,-72,2,2,-49,-48,0,2,7,0,-101,-24,2,0
"9468","27",442,6,4,1,1,-61,28,-1,1,28,27,1,1,7,1,-89,1,-2,0
"9469","27",212,3,1,0,1,-27,26,4,-2,-210,33,4,-2,7,4,183,-7,0,0
"9470","27",95,8,4,1,2,198,-3,3,3,-3,-4,0,0,7,-1,201,1,3,3
"9471","27",455,9,2,1,2,200,9,4,4,222,0,3,3,7,-2,-22,9,1,1
"9472","27",459,1,3,0,1,-35,-190,3,-4,33,-52,2,-4,7,6,-68,-138,1,0
"9473","27",217,5,4,1,2,135,51,1,0,63,33,1,-1,7,2,72,18,0,1
"9474","27",380,1,4,1,1,-169,-36,3,-4,-128,-45,3,-4,7,6,-41,9,0,0
"9475","27",229,7,1,0,1,95,-37,1,2,77,-48,-1,0,7,0,18,11,2,2
"9476","27",444,6,2,1,2,174,84,2,1,-1,-1,0,0,7,1,175,85,2,1
"9477","27",53,7,4,1,3,195,3,2,2,168,1,1,1,7,0,27,2,1,1
"9478","27",381,8,2,1,2,211,213,3,3,129,99,2,2,7,-1,82,114,1,1
"9479","27",445,6,4,1,3,117,-30,1,1,86,-35,1,1,7,1,31,5,0,0
"9480","27",215,2,1,0,0,-192,77,-2,-3,-151,35,-2,-3,7,5,-41,42,0,0
"9481","27",458,2,1,0,1,-93,-89,0,-3,68,77,-1,-2,7,5,-161,-166,1,-1
"9482","27",446,5,4,0,1,-249,-7,-4,0,102,87,-1,0,7,2,-351,-94,-3,0
"9483","27",216,7,3,0,1,-121,-17,3,2,-115,133,0,-2,7,0,-6,-150,3,4
"9484","27",228,9,4,1,2,49,56,4,4,164,97,3,3,7,-2,-115,-41,1,1
"9485","27",14,5,3,0,1,-1,2,0,0,198,-50,3,2,7,2,-199,52,-3,-2
"9486","27",447,8,4,1,2,194,8,-1,3,202,98,-1,2,7,-1,-8,-90,0,1
"9487","27",96,2,1,0,0,-206,7,-3,-3,-184,3,-3,-3,7,5,-22,4,0,0
"9488","27",137,3,1,0,1,-229,161,-4,-2,-61,-98,3,2,7,4,-168,259,-7,-4
"9489","27",140,6,1,0,1,-8,46,0,1,-11,91,1,1,7,1,3,-45,-1,0
"9490","27",97,2,1,0,1,-231,12,3,-3,-22,9,4,-1,7,5,-209,3,-1,-2
"9491","27",221,1,4,1,1,-247,-4,-4,-4,12,1,0,0,7,6,-259,-5,-4,-4
"9492","27",138,4,3,0,1,-132,-20,-1,-1,24,-30,0,0,7,3,-156,10,-1,-1
"9493","27",449,7,4,1,3,138,56,2,2,79,-9,1,1,7,0,59,65,1,1
"9494","27",54,9,4,0,1,-236,-17,2,4,43,34,-1,1,7,-2,-279,-51,3,3
"9495","27",139,8,4,1,2,8,230,4,3,248,-4,4,4,7,-1,-240,234,0,-1
"9496","27",142,5,2,1,2,240,166,-4,0,0,-3,0,0,7,2,240,169,-4,0
"9497","27",136,1,1,0,0,-247,245,-4,-4,-125,125,-4,-4,7,6,-122,120,0,0
"9498","27",223,5,1,0,1,-1,-1,0,0,2,-1,0,0,7,2,-3,0,0,0
"9499","27",143,6,1,0,3,139,-10,-4,1,-10,57,2,2,7,1,149,-67,-6,-1
"9500","27",220,4,4,1,2,205,176,-3,-1,147,118,-2,-2,7,3,58,58,-1,1
"9501","27",224,8,2,1,2,188,205,3,3,197,102,2,2,7,-1,-9,103,1,1
"9502","27",141,1,1,0,0,-190,-236,-4,-4,214,83,3,2,7,6,-404,-319,-7,-6
"9503","27",218,8,4,1,3,200,143,4,3,126,105,4,3,7,-1,74,38,0,0
"9504","27",148,1,1,0,1,-247,-114,2,-4,-186,-87,2,-4,7,6,-61,-27,0,0
"9505","27",225,8,2,1,2,27,250,4,3,180,-20,4,4,7,-1,-153,270,0,-1
"9506","27",22,5,3,0,1,-11,9,0,0,-54,2,0,0,7,2,43,7,0,0
"9507","27",219,5,4,1,3,249,1,4,0,248,3,4,0,7,2,1,-2,0,0
"9508","27",222,1,1,0,0,-245,2,-4,-4,-229,-5,-2,-3,7,6,-16,7,-2,-1
"9509","27",226,1,1,0,0,-40,1,-3,-4,178,0,3,-1,7,6,-218,1,-6,-3
"9510","27",150,5,3,0,1,-1,3,0,0,-6,12,0,0,7,2,5,-9,0,0
"9511","27",15,6,4,1,3,-29,14,1,1,-36,19,2,1,7,1,7,-5,-1,0
"9512","27",153,7,1,0,3,103,-48,2,2,-124,-81,1,1,7,0,227,33,1,1
"9513","27",147,6,2,0,3,118,85,2,1,147,74,2,1,7,1,-29,11,0,0
"9514","27",151,1,2,1,1,121,14,0,-4,-14,8,0,-4,7,6,135,6,0,0
"9515","27",146,2,2,1,0,-200,-171,-3,-3,-161,-165,-3,-3,7,5,-39,-6,0,0
"9516","27",448,6,2,1,2,242,-7,-4,1,173,0,0,-1,7,1,69,-7,-4,2
"9517","27",149,5,3,0,1,-176,-16,-4,0,246,4,-3,1,7,2,-422,-20,-1,-1
"9518","27",152,1,1,0,0,-116,-8,-2,-4,-75,0,0,-4,7,6,-41,-8,-2,0
"9519","27",145,1,1,0,1,-247,4,-4,-4,-194,-111,-3,-3,7,6,-53,115,-1,-1
"9520","27",144,5,3,0,0,-250,0,-1,0,231,241,4,2,7,2,-481,-241,-5,-2
"9521","28",474,1,1,0,0,3,-65,0,-4,5,-74,0,-4,5,4,-2,9,0,0
"9522","28",18,3,3,0,1,-46,-152,1,-2,47,19,0,-2,5,2,-93,-171,1,0
"9523","28",180,9,2,1,2,247,-72,4,4,246,1,4,4,5,-4,1,-73,0,0
"9524","28",179,5,1,0,1,0,1,0,0,-8,2,0,4,5,0,8,-1,0,-4
"9525","28",203,9,4,1,3,-24,10,4,4,-8,-240,4,4,5,-4,-16,250,0,0
"9526","28",202,4,1,0,1,-20,106,-2,-1,14,33,-3,0,5,1,-34,73,1,-1
"9527","28",2,6,4,1,1,107,-88,0,1,71,-136,1,1,5,-1,36,48,-1,0
"9528","28",206,1,4,1,0,0,0,-3,-4,139,121,3,4,5,4,-139,-121,-6,-8
"9529","28",182,7,4,1,3,-3,-76,2,2,-1,-192,2,2,5,-2,-2,116,0,0
"9530","28",168,4,1,0,3,43,-67,-1,-1,103,-60,1,2,5,1,-60,-7,-2,-3
"9531","28",20,1,3,1,0,-200,-202,-4,-4,153,159,3,4,5,4,-353,-361,-7,-8
"9532","28",475,2,3,0,3,130,-28,1,-3,35,46,0,0,5,3,95,-74,1,-3
"9533","28",184,7,3,1,3,93,-4,1,2,93,-6,1,1,5,-2,0,2,0,1
"9534","28",204,3,3,0,1,-55,115,-4,-2,121,-124,-2,-2,5,2,-176,239,-2,0
"9535","28",178,5,1,0,1,-2,1,0,0,1,-1,0,0,5,0,-3,2,0,0
"9536","28",181,5,4,1,3,200,75,0,0,203,161,3,3,5,0,-3,-86,-3,-3
"9537","28",48,1,3,1,0,6,-10,-4,-4,87,-95,-4,-4,5,4,-81,85,0,0
"9538","28",473,3,3,1,0,-214,-24,-2,-2,-200,-24,-2,-2,5,2,-14,0,0,0
"9539","28",77,7,3,1,1,9,2,1,2,-103,-4,-1,-1,5,-2,112,6,2,3
"9540","28",49,7,4,1,1,169,72,2,2,101,46,2,2,5,-2,68,26,0,0
"9541","28",170,3,2,1,0,126,113,-2,-2,105,107,0,0,5,2,21,6,-2,-2
"9542","28",183,6,4,1,1,53,26,1,1,56,51,0,0,5,-1,-3,-25,1,1
"9543","28",78,3,4,1,0,-195,6,-2,-2,-152,-5,-2,-2,5,2,-43,11,0,0
"9544","28",5,7,2,1,2,197,124,2,2,201,181,3,2,5,-2,-4,-57,-1,0
"9545","28",467,5,1,1,3,-106,-122,4,0,110,61,4,0,5,0,-216,-183,0,0
"9546","28",463,5,4,1,3,-7,1,0,0,230,-12,-2,2,5,0,-237,13,2,-2
"9547","28",169,1,3,0,0,-208,212,-4,-4,-134,94,-4,-4,5,4,-74,118,0,0
"9548","28",200,1,3,1,0,-232,-155,-4,-4,-218,-20,-4,-4,5,4,-14,-135,0,0
"9549","28",476,6,3,1,0,-106,-111,-1,1,-142,-72,1,1,5,-1,36,-39,-2,0
"9550","28",17,1,3,1,0,26,5,0,-4,147,144,-1,-4,5,4,-121,-139,1,0
"9551","28",205,3,1,0,2,235,3,-2,-2,-2,-195,3,3,5,2,237,198,-5,-5
"9552","28",201,9,3,0,1,59,-1,3,4,54,-3,2,-4,5,-4,5,2,1,8
"9553","28",167,7,1,0,3,-72,-71,2,2,128,-166,2,2,5,-2,-200,95,0,0
"9554","28",80,8,4,0,3,213,1,3,3,230,-2,3,-2,5,-3,-17,3,0,5
"9555","28",73,5,4,1,2,-13,-12,0,0,-74,-61,0,0,5,0,61,49,0,0
"9556","28",101,1,3,1,0,-240,236,-4,-4,234,236,-3,-3,5,4,-474,0,-1,-1
"9557","28",171,5,1,0,1,36,30,3,0,56,33,0,0,5,0,-20,-3,3,0
"9558","28",207,9,1,0,0,-249,1,-1,4,249,1,4,4,5,-4,-498,0,-5,0
"9559","28",74,2,3,1,0,-163,-85,-4,-3,156,-90,2,2,5,3,-319,5,-6,-5
"9560","28",79,5,4,0,2,-31,-16,0,0,98,-10,1,1,5,0,-129,-6,-1,-1
"9561","28",50,3,2,1,1,135,2,1,-2,110,-38,2,-2,5,2,25,40,-1,0
"9562","28",468,3,1,0,3,124,69,-1,-2,166,25,2,2,5,2,-42,44,-3,-4
"9563","28",185,6,4,1,2,116,-12,-1,1,215,-18,-2,3,5,-1,-99,6,1,-2
"9564","28",173,6,4,1,3,144,6,1,1,173,8,2,2,5,-1,-29,-2,-1,-1
"9565","28",51,7,4,1,1,29,100,1,2,-49,109,-2,0,5,-2,78,-9,3,2
"9566","28",186,7,2,1,2,195,203,0,2,108,112,0,1,5,-2,87,91,0,1
"9567","28",100,7,4,1,3,249,-5,2,2,230,6,2,3,5,-2,19,-11,0,-1
"9568","28",52,1,3,1,0,-239,2,-3,-4,-110,6,0,-1,5,4,-129,-4,-3,-3
"9569","28",109,1,1,0,1,-46,-1,2,-4,-62,-1,3,-4,5,4,16,0,-1,0
"9570","28",187,7,4,1,2,124,101,2,2,107,53,2,2,5,-2,17,48,0,0
"9571","28",66,4,1,1,1,-55,2,0,-1,-158,-3,-1,1,5,1,103,5,1,-2
"9572","28",470,4,1,1,1,-55,25,-1,-1,-74,10,-1,0,5,1,19,15,0,-1
"9573","28",102,5,4,1,3,184,4,2,0,29,-90,-2,2,5,0,155,94,4,-2
"9574","28",172,7,2,1,3,94,94,-2,2,148,147,-2,2,5,-2,-54,-53,0,0
"9575","28",208,9,4,1,2,250,-13,4,4,-138,3,-4,4,5,-4,388,-16,8,0
"9576","28",464,6,1,0,1,12,13,1,1,31,18,1,1,5,-1,-19,-5,0,0
"9577","28",8,8,3,0,1,-12,-7,-2,3,-1,1,-2,0,5,-3,-11,-8,0,3
"9578","28",68,1,4,1,0,2,2,0,-4,187,4,-1,-3,5,4,-185,-2,1,-1
"9579","28",108,9,2,1,3,213,199,4,4,230,206,4,4,5,-4,-17,-7,0,0
"9580","28",465,6,4,1,3,12,19,-1,1,6,-245,1,2,5,-1,6,264,-2,-1
"9581","28",174,6,4,1,3,170,172,1,1,122,161,0,1,5,-1,48,11,1,0
"9582","28",466,2,3,1,0,-129,108,-3,-3,-111,-74,-2,-2,5,3,-18,182,-1,-1
"9583","28",7,6,1,0,3,72,76,1,1,153,145,2,2,5,-1,-81,-69,-1,-1
"9584","28",81,9,1,0,0,-229,204,0,4,-220,195,3,-3,5,-4,-9,9,-3,7
"9585","28",53,7,4,1,3,225,1,2,2,192,1,2,2,5,-2,33,0,0,0
"9586","28",196,1,3,1,0,1,-30,-4,-4,114,123,1,4,5,4,-113,-153,-5,-8
"9587","28",192,4,4,1,1,102,-13,-2,-1,0,80,1,1,5,1,102,-93,-3,-2
"9588","28",67,1,1,0,0,-235,27,-4,-4,211,-198,3,3,5,4,-446,225,-7,-7
"9589","28",75,2,4,1,2,218,46,3,-3,235,219,3,-4,5,3,-17,-173,0,1
"9590","28",103,6,2,1,3,79,4,1,1,222,-4,2,2,5,-1,-143,8,-1,-1
"9591","28",193,1,1,0,0,-235,-26,-4,-4,174,129,1,1,5,4,-409,-155,-5,-5
"9592","28",469,2,4,1,0,124,28,-3,-3,113,82,-3,-4,5,3,11,-54,0,1
"9593","28",76,5,4,1,3,3,1,0,0,9,4,2,0,5,0,-6,-3,-2,0
"9594","28",6,7,4,1,2,191,5,2,2,157,0,2,2,5,-2,34,5,0,0
"9595","28",21,4,4,1,2,76,75,2,-1,136,52,2,-1,5,1,-60,23,0,0
"9596","28",462,9,3,1,3,213,221,4,4,208,189,4,4,5,-4,5,32,0,0
"9597","28",105,1,1,0,0,-245,-59,-4,-4,-250,2,-4,-4,5,4,5,-61,0,0
"9598","28",175,3,4,1,1,-152,-56,-3,-2,-122,-93,-2,-1,5,2,-30,37,-1,-1
"9599","28",11,5,4,1,1,-190,-94,-2,0,108,-176,-2,2,5,0,-298,82,0,-2
"9600","28",188,9,2,1,3,240,6,4,4,212,2,4,4,5,-4,28,4,0,0
"9601","28",244,4,4,1,2,45,-32,0,-1,62,-67,1,1,5,1,-17,35,-1,-2
"9602","28",471,7,3,1,2,199,-39,0,2,194,-26,2,3,5,-2,5,-13,-2,-1
"9603","28",197,2,4,1,3,-88,-111,1,-3,71,27,1,2,5,3,-159,-138,0,-5
"9604","28",59,2,1,0,0,-95,94,-3,-3,-60,-33,-1,-1,5,3,-35,127,-2,-2
"9605","28",209,7,4,1,3,175,-1,2,2,195,5,1,2,5,-2,-20,-6,1,0
"9606","28",472,1,1,0,0,-241,244,-4,-4,-247,231,-4,-4,5,4,6,13,0,0
"9607","28",104,1,1,0,0,-236,3,-4,-4,244,1,1,-2,5,4,-480,2,-5,-2
"9608","28",69,6,4,1,1,43,-113,1,1,-218,35,3,3,5,-1,261,-148,-2,-2
"9609","28",133,2,2,1,1,-47,-183,0,-3,167,29,3,0,5,3,-214,-212,-3,-3
"9610","28",397,6,4,1,3,101,167,-3,1,-110,61,-1,-1,5,-1,211,106,-2,2
"9611","28",243,5,2,1,2,247,86,2,0,248,218,3,2,5,0,-1,-132,-1,-2
"9612","28",276,7,4,1,3,190,-1,2,2,177,3,2,2,5,-2,13,-4,0,0
"9613","28",70,2,2,1,2,135,204,-1,-3,230,230,4,4,5,3,-95,-26,-5,-7
"9614","28",82,9,4,1,2,19,226,4,4,19,243,4,4,5,-4,0,-17,0,0
"9615","28",54,8,4,0,1,-213,20,1,3,59,18,-2,2,5,-3,-272,2,3,1
"9616","28",110,7,1,0,1,-128,72,-4,2,47,-126,-4,1,5,-2,-175,198,0,1
"9617","28",71,4,3,0,1,-70,13,-1,-1,19,14,-1,0,5,1,-89,-1,0,-1
"9618","28",177,5,4,1,1,-28,74,-1,0,-103,117,0,0,5,0,75,-43,-1,0
"9619","28",19,6,2,1,2,103,123,1,1,113,-117,0,0,5,-1,-10,240,1,1
"9620","28",198,3,1,0,1,-186,138,-1,-2,2,-30,0,1,5,2,-188,168,-1,-3
"9621","28",194,7,1,0,0,-219,7,-4,2,-242,7,-4,2,5,-2,23,0,0,0
"9622","28",47,7,4,1,3,158,2,1,2,161,1,0,1,5,-2,-3,1,1,1
"9623","28",112,9,4,1,3,143,-68,4,4,244,1,4,2,5,-4,-101,-69,0,2
"9624","28",60,8,1,0,3,247,3,3,3,-1,-243,3,3,5,-3,248,246,0,0
"9625","28",210,6,4,1,2,232,136,2,1,209,187,4,4,5,-1,23,-51,-2,-3
"9626","28",398,9,4,1,2,249,245,3,4,246,248,4,4,5,-4,3,-3,-1,0
"9627","28",106,7,2,1,1,150,-82,2,2,192,-122,2,2,5,-2,-42,40,0,0
"9628","28",176,8,1,0,1,-85,1,-3,3,163,-1,0,2,5,-3,-248,2,-3,1
"9629","28",277,5,4,1,1,64,-127,0,0,50,-96,0,0,5,0,14,-31,0,0
"9630","28",399,6,4,1,3,84,79,1,1,141,-32,1,1,5,-1,-57,111,0,0
"9631","28",245,1,1,0,0,-247,65,-3,-4,-242,2,-3,-4,5,4,-5,63,0,0
"9632","28",55,5,4,1,1,156,83,0,0,-62,57,0,0,5,0,218,26,0,0
"9633","28",111,6,1,0,0,-92,-96,0,1,226,230,4,-2,5,-1,-318,-326,-4,3
"9634","28",165,5,1,0,1,64,37,0,0,80,103,1,1,5,0,-16,-66,-1,-1
"9635","28",56,4,3,1,1,21,-116,-1,-1,21,-110,-2,0,5,1,0,-6,1,-1
"9636","28",403,3,1,0,0,-166,-13,-1,-2,-198,-21,0,-3,5,2,32,8,-1,1
"9637","28",429,1,2,1,0,6,1,0,-4,37,-2,0,-4,5,4,-31,3,0,0
"9638","28",28,4,4,1,1,-61,-60,-2,-1,-31,-84,-1,-1,5,1,-30,24,-1,0
"9639","28",134,5,2,1,2,97,7,1,0,78,8,1,0,5,0,19,-1,0,0
"9640","28",13,3,4,1,1,2,-120,-1,-2,-26,-137,-2,-2,5,2,28,17,1,0
"9641","28",126,4,2,1,2,168,242,-2,-1,161,221,-1,-1,5,1,7,21,-1,0
"9642","28",189,2,1,0,1,-236,32,2,-3,-200,52,3,-3,5,3,-36,-20,-1,0
"9643","28",135,5,1,0,1,-155,-145,0,0,123,-81,0,0,5,0,-278,-64,0,0
"9644","28",83,5,1,0,3,107,-148,0,0,88,-85,1,1,5,0,19,-63,-1,-1
"9645","28",281,1,4,1,2,0,-239,0,-4,245,-5,-4,-4,5,4,-245,-234,4,0
"9646","28",278,1,4,1,1,232,-235,4,-4,228,-226,4,-4,5,4,4,-9,0,0
"9647","28",72,3,1,0,0,-117,14,0,-2,143,148,2,2,5,2,-260,-134,-2,-4
"9648","28",254,3,2,1,3,153,-159,-2,-2,182,-224,-3,-2,5,2,-29,65,1,0
"9649","28",190,7,4,1,3,185,130,2,2,209,219,2,2,5,-2,-24,-89,0,0
"9650","28",199,8,4,1,2,214,114,3,3,220,175,2,2,5,-3,-6,-61,1,1
"9651","28",195,1,1,0,1,-180,190,4,-4,94,-108,3,1,5,4,-274,298,1,-5
"9652","28",404,4,1,0,1,22,-9,-1,-1,51,-42,1,0,5,1,-29,33,-2,-1
"9653","28",113,5,2,0,2,190,103,0,0,35,30,2,3,5,0,155,73,-2,-3
"9654","28",61,1,1,0,3,249,22,4,-4,-40,-3,4,-4,5,4,289,25,0,0
"9655","28",211,7,3,1,1,17,20,4,2,96,98,-2,1,5,-2,-79,-78,6,1
"9656","28",405,6,4,1,1,159,136,1,1,154,2,-2,-1,5,-1,5,134,3,2
"9657","28",107,6,2,1,3,140,163,-3,1,-186,-61,-1,2,5,-1,326,224,-2,-1
"9658","28",127,1,1,0,0,-233,-1,-3,-4,0,1,2,-3,5,4,-233,-2,-5,-1
"9659","28",321,2,1,0,0,-204,-242,-3,-3,-55,-42,-2,-3,5,3,-149,-200,-1,0
"9660","28",4,3,3,0,1,-3,5,-2,-2,217,200,1,4,5,2,-220,-195,-3,-6
"9661","28",246,8,4,1,3,232,1,3,3,249,1,4,4,5,-3,-17,0,-1,-1
"9662","28",213,6,2,1,1,2,38,1,1,-135,2,-1,-1,5,-1,137,36,2,2
"9663","28",137,4,1,0,1,-14,-233,-4,-1,232,238,-3,-3,5,1,-246,-471,-1,2
"9664","28",166,3,4,1,2,219,215,-2,-2,194,196,-2,-3,5,2,25,19,0,1
"9665","28",57,1,4,1,1,176,-133,0,-4,140,-200,-2,-4,5,4,36,67,2,0
"9666","28",36,9,3,1,3,186,-68,4,4,100,-52,3,-2,5,-4,86,-16,1,6
"9667","28",43,1,3,0,0,-149,11,-4,-4,115,2,-2,-4,5,4,-264,9,-2,0
"9668","28",280,6,2,1,1,-28,20,-1,1,228,-22,2,0,5,-1,-256,42,-3,1
"9669","28",122,2,1,0,0,0,0,-4,-3,210,226,4,4,5,3,-210,-226,-8,-7
"9670","28",130,9,1,0,3,218,27,4,4,94,27,4,4,5,-4,124,0,0,0
"9671","28",62,9,2,1,3,131,64,4,4,212,221,4,4,5,-4,-81,-157,0,0
"9672","28",212,2,1,0,1,-213,-34,4,-3,-220,30,4,-2,5,3,7,-64,0,-1
"9673","28",136,1,1,0,0,-247,247,-4,-4,-249,245,-4,-4,5,4,2,2,0,0
"9674","28",84,8,4,1,3,204,5,3,3,204,6,2,2,5,-3,0,-1,1,1
"9675","28",282,9,3,0,3,-26,-97,1,4,189,22,1,4,5,-4,-215,-119,0,0
"9676","28",279,6,4,1,3,177,141,1,1,164,93,1,2,5,-1,13,48,0,-1
"9677","28",331,2,1,0,0,-17,-218,-4,-3,0,-211,-4,-3,5,3,-17,-7,0,0
"9678","28",255,5,3,0,1,-106,-108,0,0,-152,-144,0,0,5,0,46,36,0,0
"9679","28",191,3,1,0,0,-135,-79,-2,-2,-193,-43,-2,-3,5,2,58,-36,0,1
"9680","28",400,5,4,1,2,86,40,1,0,112,68,0,0,5,0,-26,-28,1,0
"9681","28",248,5,4,1,3,22,98,1,0,29,139,1,-1,5,0,-7,-41,0,1
"9682","28",58,6,4,1,1,-244,25,-4,1,242,0,4,4,5,-1,-486,25,-8,-3
"9683","28",114,9,4,0,1,-48,-35,0,4,93,101,1,-3,5,-4,-141,-136,-1,7
"9684","28",430,5,2,1,1,195,-95,0,0,173,-148,1,-2,5,0,22,53,-1,2
"9685","28",257,1,1,0,0,30,237,1,-4,-116,13,-1,-4,5,4,146,224,2,0
"9686","28",406,8,2,1,2,168,103,2,3,143,43,2,1,5,-3,25,60,0,2
"9687","28",330,7,2,1,2,146,35,2,2,166,203,1,1,5,-2,-20,-168,1,1
"9688","28",128,7,1,0,3,221,2,2,2,221,2,1,2,5,-2,0,0,1,0
"9689","28",322,5,4,1,3,14,-18,0,0,243,-223,2,2,5,0,-229,205,-2,-2
"9690","28",40,7,1,0,2,-204,-57,-3,2,159,130,2,1,5,-2,-363,-187,-5,1
"9691","28",247,4,3,1,0,-238,-3,-1,-1,82,-12,0,0,5,1,-320,9,-1,-1
"9692","28",214,9,1,0,3,226,-2,4,4,250,3,4,4,5,-4,-24,-5,0,0
"9693","28",138,5,3,0,1,38,-105,0,0,18,-25,0,0,5,0,20,-80,0,0
"9694","28",86,5,4,1,3,93,-26,0,0,173,-9,1,2,5,0,-80,-17,-1,-2
"9695","28",256,5,3,0,1,-118,-1,0,0,125,99,1,1,5,0,-243,-100,-1,-1
"9696","28",360,1,3,0,0,-208,-51,0,-4,68,56,0,-4,5,4,-276,-107,0,0
"9697","28",401,3,2,1,1,192,13,0,-2,150,22,1,1,5,2,42,-9,-1,-3
"9698","28",249,1,3,1,0,-60,-65,-4,-4,35,-38,1,-4,5,4,-95,-27,-5,0
"9699","28",123,3,4,1,2,108,-37,-2,-2,-21,-28,-2,-2,5,2,129,-9,0,0
"9700","28",131,8,4,1,3,127,132,-3,3,115,-34,-1,3,5,-3,12,166,-2,0
"9701","28",63,5,4,0,1,0,3,0,0,-6,6,0,0,5,0,6,-3,0,0
"9702","28",12,9,4,1,3,2,-1,4,4,2,0,4,4,5,-4,0,-1,0,0
"9703","28",116,9,2,1,3,187,-3,2,4,88,-23,2,3,5,-4,99,20,0,1
"9704","28",85,8,2,1,2,126,119,4,3,135,116,4,4,5,-3,-9,3,0,-1
"9705","28",283,5,1,0,1,-126,38,-3,0,-71,-125,-2,1,5,0,-55,163,-1,-1
"9706","28",408,1,1,0,0,-223,216,0,-4,-150,1,-1,-2,5,4,-73,215,1,-2
"9707","28",332,1,1,0,0,-250,84,-2,-4,-248,142,-3,-3,5,4,-2,-58,1,-1
"9708","28",352,4,2,1,1,11,-61,0,-1,5,-50,0,-1,5,1,6,-11,0,0
"9709","28",324,2,2,1,0,124,3,-3,-3,-5,0,-3,-3,5,3,129,3,0,0
"9710","28",265,8,1,0,3,185,1,3,3,1,-7,0,0,5,-3,184,8,3,3
"9711","28",87,8,4,1,3,0,0,3,3,-53,174,3,3,5,-3,53,-174,0,0
"9712","28",119,7,3,1,3,85,109,1,2,-98,-96,2,2,5,-2,183,205,-1,0
"9713","28",115,6,3,1,3,-4,4,0,1,-240,2,-1,2,5,-1,236,2,1,-1
"9714","28",431,4,3,1,0,-24,17,-2,-1,65,57,-1,-1,5,1,-89,-40,-1,0
"9715","28",258,1,3,1,0,-33,0,-4,-4,-64,-1,-3,-4,5,4,31,1,-1,0
"9716","28",407,9,2,1,2,242,-2,4,4,232,11,3,3,5,-4,10,-13,1,1
"9717","28",432,4,2,1,1,56,-59,-1,-1,69,-60,0,0,5,1,-13,1,-1,-1
"9718","28",129,6,4,1,1,186,-4,1,1,177,5,2,2,5,-1,9,-9,-1,-1
"9719","28",323,4,4,1,1,234,-2,0,-1,136,-3,1,-2,5,1,98,1,-1,1
"9720","28",356,3,4,1,1,-235,-2,-2,-2,129,-76,1,2,5,2,-364,74,-3,-4
"9721","28",65,7,1,0,3,72,77,2,2,17,43,2,2,5,-2,55,34,0,0
"9722","28",215,2,1,0,0,-158,48,-2,-3,-135,60,-2,-3,5,3,-23,-12,0,0
"9723","28",139,9,4,1,2,0,0,4,4,7,196,4,4,5,-4,-7,-196,0,0
"9724","28",333,6,4,1,1,40,-9,1,1,-41,45,1,0,5,-1,81,-54,0,1
"9725","28",285,8,2,0,1,-1,-86,-2,3,-4,1,-2,2,5,-3,3,-87,0,1
"9726","28",361,1,1,0,0,-249,0,-3,-4,1,219,4,4,5,4,-250,-219,-7,-8
"9727","28",402,1,3,1,0,-224,0,-4,-4,-153,-6,-2,-3,5,4,-71,6,-2,-1
"9728","28",25,4,4,1,2,42,65,0,-1,144,184,-1,-1,5,1,-102,-119,1,0
"9729","28",124,6,1,0,3,232,61,4,1,242,2,3,2,5,-1,-10,59,1,-1
"9730","28",132,6,4,1,1,-63,-5,-1,1,67,-9,1,1,5,-1,-130,4,-2,0
"9731","28",64,9,1,0,1,214,-229,4,4,239,-8,4,4,5,-4,-25,-221,0,0
"9732","28",120,4,3,0,1,-50,-50,-1,-1,79,-22,0,0,5,1,-129,-28,-1,-1
"9733","28",117,2,4,1,2,98,59,-4,-3,31,1,-2,-2,5,3,67,58,-2,-1
"9734","28",433,2,1,1,0,-235,-238,-3,-3,-15,-26,-2,-2,5,3,-220,-212,-1,-1
"9735","28",284,2,3,1,1,-111,-153,0,-3,-160,-119,-3,-4,5,3,49,-34,3,1
"9736","28",409,7,4,1,2,131,135,2,2,117,136,2,2,5,-2,14,-1,0,0
"9737","28",357,6,4,1,2,86,-22,1,1,58,-85,2,1,5,-1,28,63,-1,0
"9738","28",353,8,2,1,2,241,71,0,3,230,137,-4,-4,5,-3,11,-66,4,7
"9739","28",325,9,1,0,1,-29,-42,-1,4,-64,-58,-2,4,5,-4,35,16,1,0
"9740","28",266,5,1,0,1,-115,0,0,0,-152,3,-2,-2,5,0,37,-3,2,2
"9741","28",88,9,4,1,2,192,194,4,4,212,207,4,4,5,-4,-20,-13,0,0
"9742","28",241,5,4,1,2,187,144,2,0,217,158,2,0,5,0,-30,-14,0,0
"9743","28",460,1,1,0,0,-188,14,-4,-4,187,31,-3,1,5,4,-375,-17,-1,-5
"9744","28",335,6,2,1,1,-6,87,0,1,21,43,1,2,5,-1,-27,44,-1,-1
"9745","28",259,1,3,1,1,-117,34,4,-4,-44,33,4,-4,5,4,-73,1,0,0
"9746","28",158,1,3,0,0,-227,-26,-4,-4,-48,-41,-2,-2,5,4,-179,15,-2,-2
"9747","28",230,5,1,0,0,-214,106,-3,0,-220,108,-3,0,5,0,6,-2,0,0
"9748","28",251,3,3,1,1,-231,140,3,-2,-117,-120,4,-2,5,2,-114,260,-1,0
"9749","28",272,6,4,1,2,100,70,1,1,159,106,1,1,5,-1,-59,-36,0,0
"9750","28",320,8,2,1,2,227,115,3,3,238,114,3,3,5,-3,-11,1,0,0
"9751","28",349,3,4,0,1,-34,-59,-2,-2,-83,82,1,3,5,2,49,-141,-3,-5
"9752","28",216,4,3,1,1,-73,-46,1,-1,-124,-124,2,0,5,1,51,78,-1,-1
"9753","28",14,5,3,0,1,1,4,0,0,156,-27,2,2,5,0,-155,31,-2,-2
"9754","28",334,2,4,1,0,-227,140,-4,-3,-69,215,-4,2,5,3,-158,-75,0,-5
"9755","28",286,6,1,0,3,79,-7,1,1,56,-4,0,1,5,-1,23,-3,1,0
"9756","28",362,6,4,1,3,101,-148,4,1,130,-117,2,-1,5,-1,-29,-31,2,2
"9757","28",359,9,4,1,3,229,13,4,4,230,20,4,4,5,-4,-1,-7,0,0
"9758","28",250,6,1,0,3,82,29,1,1,104,20,1,1,5,-1,-22,9,0,0
"9759","28",125,4,4,1,0,-128,-34,-3,-1,-94,-21,-4,-1,5,1,-34,-13,1,0
"9760","28",32,5,1,0,1,2,1,0,0,170,-192,3,-4,5,0,-168,193,-3,4
"9761","28",9,4,4,1,2,32,14,1,-1,-42,9,1,-1,5,1,74,5,0,0
"9762","28",121,1,1,0,0,-178,22,-4,-4,241,-137,-1,-4,5,4,-419,159,-3,0
"9763","28",118,5,3,1,1,-29,18,-2,0,1,-17,-2,1,5,0,-30,35,0,-1
"9764","28",434,6,4,1,3,41,-35,2,1,139,-44,0,2,5,-1,-98,9,2,-1
"9765","28",260,2,3,1,0,-237,-240,-3,-3,-221,-221,-2,-2,5,3,-16,-19,-1,-1
"9766","28",41,6,2,1,3,79,97,3,1,103,94,3,1,5,-1,-24,3,0,0
"9767","28",358,5,4,1,2,193,145,0,0,239,165,0,-4,5,0,-46,-20,0,4
"9768","28",354,2,1,0,0,-235,239,-2,-3,171,137,2,3,5,3,-406,102,-4,-6
"9769","28",326,7,4,1,2,172,72,2,2,175,59,2,-2,5,-2,-3,13,0,4
"9770","28",267,4,3,0,1,43,-5,-1,-1,85,-2,2,1,5,1,-42,-3,-3,-2
"9771","28",89,1,3,1,0,-243,-1,-4,-4,-242,2,-3,-4,5,4,-1,-3,-1,0
"9772","28",242,7,4,1,2,73,90,2,2,-76,-22,1,-3,5,-2,149,112,1,5
"9773","28",461,3,4,1,2,-19,27,-1,-2,76,46,1,1,5,2,-95,-19,-2,-3
"9774","28",336,3,4,1,3,152,137,3,-2,195,167,-2,3,5,2,-43,-30,5,-5
"9775","28",26,1,1,0,0,-210,-42,-4,-4,-220,-157,-4,-4,5,4,10,115,0,0
"9776","28",159,2,3,1,2,244,9,-3,-3,228,3,4,3,5,3,16,6,-7,-6
"9777","28",231,7,4,1,0,-172,-174,-3,2,-5,80,-4,-2,5,-2,-167,-254,1,4
"9778","28",252,4,4,1,1,-149,-195,-1,-1,109,129,1,1,5,1,-258,-324,-2,-2
"9779","28",273,5,1,0,0,21,5,0,0,62,1,0,0,5,0,-41,4,0,0
"9780","28",1,4,1,0,1,-48,-43,-1,-1,-69,-64,-1,0,5,1,21,21,0,-1
"9781","28",35,3,1,0,3,49,158,2,-2,121,140,2,-2,5,2,-72,18,0,0
"9782","28",217,4,4,1,2,85,39,1,-1,67,36,1,-1,5,1,18,3,0,0
"9783","28",140,5,1,0,1,-23,62,-1,0,-11,-57,1,1,5,0,-12,119,-2,-1
"9784","28",436,5,4,1,3,87,-245,0,0,66,-204,4,2,5,0,21,-41,-4,-2
"9785","28",287,7,4,1,3,110,-10,2,2,132,-26,2,2,5,-2,-22,16,0,0
"9786","28",363,8,3,1,3,248,1,3,3,249,1,1,1,5,-3,-1,0,2,2
"9787","28",234,4,3,1,3,133,28,0,-1,121,38,0,-1,5,1,12,-10,0,0
"9788","28",154,6,4,1,3,120,-144,1,1,47,-108,1,1,5,-1,73,-36,0,0
"9789","28",328,4,3,1,1,-38,11,-1,-1,8,9,1,1,5,1,-46,2,-2,-2
"9790","28",269,7,4,1,2,142,2,2,2,187,1,2,2,5,-2,-45,1,0,0
"9791","28",90,5,4,1,0,-249,14,0,0,69,-4,1,2,5,0,-318,18,-1,-2
"9792","28",345,7,1,0,0,-184,34,-4,2,-196,77,-4,2,5,-2,12,-43,0,0
"9793","28",341,9,1,1,3,193,-57,4,4,224,-24,4,4,5,-4,-31,-33,0,0
"9794","28",435,5,4,1,1,10,-3,0,0,5,-10,2,0,5,0,5,7,-2,0
"9795","28",261,9,1,0,3,210,191,4,4,210,214,4,4,5,-4,0,-23,0,0
"9796","28",410,1,1,0,0,-20,-23,0,-4,-143,-38,0,-4,5,4,123,15,0,0
"9797","28",233,7,2,1,2,191,129,2,2,155,67,1,1,5,-2,36,62,1,1
"9798","28",355,2,2,1,2,152,168,-3,-3,87,110,-3,-3,5,3,65,58,0,0
"9799","28",327,8,4,1,3,194,17,2,3,124,7,3,2,5,-3,70,10,-1,1
"9800","28",268,7,4,1,3,83,-119,2,2,108,-153,2,2,5,-2,-25,34,0,0
"9801","28",351,1,1,0,0,-246,-246,-4,-4,244,244,-4,-4,5,4,-490,-490,0,0
"9802","28",219,5,4,1,3,249,1,4,0,0,-248,4,0,5,0,249,249,0,0
"9803","28",142,5,2,1,2,231,-229,-1,0,204,-109,-2,0,5,0,27,-120,1,0
"9804","28",337,9,2,1,3,242,241,4,4,244,67,4,4,5,-4,-2,174,0,0
"9805","28",163,4,3,1,1,-27,-103,2,-1,-33,-104,2,0,5,1,6,1,0,-1
"9806","28",16,3,1,0,0,-232,16,0,-2,38,15,1,-2,5,2,-270,1,-1,0
"9807","28",232,1,1,0,0,-246,-244,-4,-4,-248,-237,-4,-4,5,4,2,-7,0,0
"9808","28",253,9,3,1,3,213,211,4,4,221,222,4,4,5,-4,-8,-11,0,0
"9809","28",274,7,4,1,2,169,102,2,2,177,111,2,2,5,-2,-8,-9,0,0
"9810","28",10,5,3,0,1,13,-9,0,0,51,-1,0,1,5,0,-38,-8,0,-1
"9811","28",350,9,4,1,1,10,-243,4,4,245,7,2,0,5,-4,-235,-250,2,4
"9812","28",218,8,4,1,3,165,80,4,3,210,131,4,3,5,-3,-45,-51,0,0
"9813","28",141,2,1,0,0,-39,-16,-2,-3,238,107,2,4,5,3,-277,-123,-4,-7
"9814","28",437,3,1,0,0,-221,0,-2,-2,-242,5,-3,-3,5,2,21,-5,1,1
"9815","28",288,5,2,1,2,11,-6,0,0,9,1,1,0,5,0,2,-7,-1,0
"9816","28",364,5,3,0,1,-101,-48,0,0,-68,-4,0,0,5,0,-33,-44,0,0
"9817","28",235,6,3,1,0,13,-2,1,1,18,0,1,1,5,-1,-5,-2,0,0
"9818","28",155,8,2,1,1,15,10,1,3,246,248,4,4,5,-3,-231,-238,-3,-1
"9819","28",329,5,4,1,3,-93,157,0,0,-157,-101,-2,-2,5,0,64,258,2,2
"9820","28",27,6,2,1,2,116,125,2,1,89,77,1,0,5,-1,27,48,1,1
"9821","28",91,5,2,1,3,-3,-5,0,0,246,1,2,2,5,0,-249,-6,-2,-2
"9822","28",346,6,3,1,0,-249,-94,-4,1,239,-1,2,2,5,-1,-488,-93,-6,-1
"9823","28",342,5,3,1,1,-44,30,-1,0,-9,17,-2,-3,5,0,-35,13,1,3
"9824","28",339,3,3,1,1,-56,-97,-2,-2,-80,-38,-2,-3,5,2,24,-59,0,1
"9825","28",262,6,4,1,3,112,166,1,1,55,77,4,1,5,-1,57,89,-3,0
"9826","28",411,9,2,1,2,231,236,4,4,228,224,4,4,5,-4,3,12,0,0
"9827","28",271,3,3,1,1,119,-3,0,-2,-134,0,2,2,5,2,253,-3,-2,-4
"9828","28",310,6,4,1,2,140,43,1,1,232,42,4,3,5,-1,-92,1,-3,-2
"9829","28",98,1,3,0,0,-238,-19,-4,-4,235,238,4,4,5,4,-473,-257,-8,-8
"9830","28",388,4,4,1,0,-239,4,1,-1,-241,4,1,-1,5,1,2,0,0,0
"9831","28",94,3,4,1,1,-112,-88,-2,-2,161,161,2,2,5,2,-273,-249,-4,-4
"9832","28",22,5,3,0,1,-230,11,0,0,12,-241,4,4,5,0,-242,252,-4,-4
"9833","28",143,8,1,0,3,144,-10,3,3,156,-44,4,3,5,-3,-12,34,-1,0
"9834","28",338,1,3,1,2,-172,-202,-4,-4,83,59,-4,-4,5,4,-255,-261,0,0
"9835","28",164,8,2,1,2,168,182,3,3,112,151,2,2,5,-3,56,31,1,1
"9836","28",160,7,2,1,0,33,38,-4,2,23,34,-4,2,5,-2,10,4,0,0
"9837","28",317,3,4,1,2,-95,106,-2,-2,-65,71,-2,-2,5,2,-30,35,0,0
"9838","28",157,8,3,0,2,137,55,3,3,136,79,-2,0,5,-3,1,-24,5,3
"9839","28",275,8,4,1,2,249,-12,3,3,1,249,3,3,5,-3,248,-261,0,0
"9840","28",343,7,2,1,2,94,-7,1,2,-1,-51,2,2,5,-2,95,44,-1,0
"9841","28",93,5,1,0,1,-135,53,-2,0,-92,60,-2,0,5,0,-43,-7,0,0
"9842","28",348,2,3,0,1,-78,-1,0,-3,54,44,0,-2,5,3,-132,-45,0,-1
"9843","28",344,8,4,1,3,169,-59,2,3,61,65,3,3,5,-3,108,-124,-1,0
"9844","28",438,5,4,1,3,243,4,4,0,237,0,4,4,5,0,6,4,0,-4
"9845","28",289,8,1,0,3,150,145,3,3,213,231,3,3,5,-3,-63,-86,0,0
"9846","28",365,1,3,1,1,23,3,0,-4,-120,-2,0,-4,5,4,143,5,0,0
"9847","28",316,4,3,1,0,-136,-67,-1,-1,-129,-100,-1,-1,5,1,-7,33,0,0
"9848","28",156,5,2,0,1,0,1,0,0,40,0,1,1,5,0,-40,1,-1,-1
"9849","28",33,6,3,0,1,59,-30,-1,1,37,-33,0,1,5,-1,22,3,-1,0
"9850","28",270,5,3,1,1,-7,8,0,0,-2,164,2,0,5,0,-5,-156,-2,0
"9851","28",92,6,4,1,2,6,7,1,1,1,-6,0,0,5,-1,5,13,1,1
"9852","28",347,6,1,0,3,116,-143,2,1,-167,111,1,-4,5,-1,283,-254,1,5
"9853","28",161,3,2,1,2,152,149,-1,-2,97,74,1,-2,5,2,55,75,-2,0
"9854","28",34,5,4,0,2,87,-52,1,0,113,-52,0,-1,5,0,-26,0,1,1
"9855","28",263,1,4,1,0,-246,-5,-3,-4,-242,-4,-4,-4,5,4,-4,-1,1,0
"9856","28",412,9,1,0,0,-246,2,-4,4,244,-1,4,4,5,-4,-490,3,-8,0
"9857","28",146,2,2,0,0,-135,-192,-3,-3,-149,-149,-3,-3,5,3,14,-43,0,0
"9858","28",311,1,2,1,2,229,30,4,-4,190,41,4,-4,5,4,39,-11,0,0
"9859","28",99,8,4,1,3,248,-6,3,3,232,-26,2,2,5,-3,16,20,1,1
"9860","28",389,2,3,1,2,140,-22,-3,-3,70,-2,1,1,5,3,70,-20,-4,-4
"9861","28",95,7,4,1,2,1,-124,2,2,69,6,1,1,5,-2,-68,-130,1,1
"9862","28",220,3,4,1,2,125,118,-4,-2,177,165,-4,-4,5,2,-52,-47,0,2
"9863","28",144,1,3,1,0,-249,4,-4,-4,220,10,1,-1,5,4,-469,-6,-5,-3
"9864","28",318,4,2,1,2,-38,-194,-4,-1,178,-166,-4,0,5,1,-216,-28,0,-1
"9865","28",238,7,3,1,1,-66,-68,-3,2,178,98,4,2,5,-2,-244,-166,-7,0
"9866","28",31,3,1,0,0,-134,-66,-2,-2,-186,95,-2,-2,5,2,52,-161,0,0
"9867","28",390,6,2,1,2,46,61,1,1,238,245,4,4,5,-1,-192,-184,-3,-3
"9868","28",314,1,4,1,1,-244,14,4,-4,-235,11,4,-4,5,4,-9,3,0,0
"9869","28",391,6,2,1,3,160,197,3,1,99,115,1,1,5,-1,61,82,2,0
"9870","28",162,9,3,0,3,64,84,0,4,103,123,3,4,5,-4,-39,-39,-3,0
"9871","28",307,5,4,1,2,4,28,-3,0,204,178,4,4,5,0,-200,-150,-7,-4
"9872","28",223,5,1,0,1,2,1,0,0,2,1,0,0,5,0,0,0,0,0
"9873","28",425,5,4,1,2,30,-16,0,0,14,94,3,3,5,0,16,-110,-3,-3
"9874","28",439,6,2,1,1,97,-4,1,1,82,2,1,1,5,-1,15,-6,0,0
"9875","28",29,1,4,1,0,-199,96,-4,-4,240,204,-2,-1,5,4,-439,-108,-2,-3
"9876","28",366,8,4,1,3,205,-30,4,3,119,-76,3,2,5,-3,86,46,1,1
"9877","28",39,3,3,0,1,-202,-14,-3,-2,206,198,3,4,5,2,-408,-212,-6,-6
"9878","28",313,2,3,1,0,-209,-178,-4,-3,-214,-213,-3,-3,5,3,5,35,-1,0
"9879","28",221,5,4,0,1,-3,-5,0,0,-6,9,0,1,5,0,3,-14,0,-1
"9880","28",145,5,1,0,1,-46,-98,0,0,-128,-215,0,0,5,0,82,117,0,0
"9881","28",97,1,1,0,1,-234,9,3,-4,-231,13,3,-3,5,4,-3,-4,0,-1
"9882","28",222,2,1,0,0,0,0,-3,-3,-245,6,-4,-4,5,3,245,-6,1,1
"9883","28",226,1,1,0,0,-65,1,-2,-4,170,3,2,-4,5,4,-235,-2,-4,0
"9884","28",340,4,1,0,1,-111,-54,0,-1,59,19,0,0,5,1,-170,-73,0,-1
"9885","28",264,7,4,1,2,126,6,2,2,219,229,1,1,5,-2,-93,-223,1,1
"9886","28",413,3,1,0,1,-160,23,-2,-2,-98,-3,-2,-1,5,2,-62,26,0,-1
"9887","28",147,7,2,1,3,186,200,2,2,111,119,1,2,5,-2,75,81,1,0
"9888","28",312,5,4,1,1,-85,69,0,0,-60,-94,0,0,5,0,-25,163,0,0
"9889","28",309,2,4,1,2,132,38,-1,-3,232,242,-2,-4,5,3,-100,-204,1,1
"9890","28",426,9,4,1,3,21,248,4,4,242,4,4,4,5,-4,-221,244,0,0
"9891","28",96,3,1,0,0,-182,-4,-2,-2,-166,18,-3,-3,5,2,-16,-22,1,1
"9892","28",290,4,1,0,1,-53,-51,0,-1,75,-47,0,-2,5,1,-128,-4,0,1
"9893","28",367,4,3,0,1,-47,-55,2,-1,-87,-64,1,2,5,1,40,9,1,-3
"9894","28",319,6,1,0,1,75,8,2,1,-138,2,-1,-1,5,-1,213,6,3,2
"9895","28",239,6,1,0,1,71,97,2,1,99,107,-3,1,5,-1,-28,-10,5,0
"9896","28",291,6,4,1,2,-207,182,-1,1,-240,156,-4,-4,5,-1,33,26,3,5
"9897","28",428,1,1,0,0,-245,240,-4,-4,-249,245,-4,-4,5,4,4,-5,0,0
"9898","28",315,9,3,1,3,242,13,4,4,233,13,4,4,5,-4,9,0,0,0
"9899","28",392,3,1,0,0,-146,54,-2,-2,-131,77,-2,-2,5,2,-15,-23,0,0
"9900","28",236,5,1,0,1,-3,1,0,0,-3,1,0,0,5,0,0,0,0,0
"9901","28",308,1,4,1,0,-246,-242,-4,-4,124,103,2,4,5,4,-370,-345,-6,-8
"9902","28",224,7,2,1,2,166,144,3,2,182,103,2,2,5,-2,-16,41,1,0
"9903","28",414,1,1,1,0,-123,-145,-4,-4,-52,-42,-1,-1,5,4,-71,-103,-3,-3
"9904","28",44,7,2,1,2,234,-182,0,2,213,149,0,2,5,-2,21,-331,0,0
"9905","28",386,1,1,0,0,-247,197,-4,-4,-2,9,-1,-2,5,4,-245,188,-3,-2
"9906","28",394,1,3,1,0,-245,238,-4,-4,-244,242,-4,-4,5,4,-1,-4,0,0
"9907","28",427,4,4,1,1,63,11,1,-1,-140,-19,2,-2,5,1,203,30,-1,1
"9908","28",387,1,3,1,1,-204,-189,-3,-4,172,175,2,3,5,4,-376,-364,-5,-7
"9909","28",423,6,1,1,3,114,-43,-1,1,-153,-3,1,0,5,-1,267,-40,-2,1
"9910","28",368,9,3,1,3,-158,143,4,4,-100,137,4,4,5,-4,-58,6,0,0
"9911","28",441,7,4,1,2,122,64,3,2,86,80,3,2,5,-2,36,-16,0,0
"9912","28",227,7,3,0,3,-117,-12,0,2,-159,-48,1,2,5,-2,42,36,-1,0
"9913","28",457,9,3,0,1,218,0,4,4,13,-175,1,0,5,-4,205,175,3,4
"9914","28",421,6,3,1,1,-23,8,-1,1,52,39,1,1,5,-1,-75,-31,-2,0
"9915","28",418,6,2,1,2,120,-131,1,1,187,-208,1,1,5,-1,-67,77,0,0
"9916","28",393,1,1,0,0,-212,-60,-4,-4,-56,-172,-4,-4,5,4,-156,112,0,0
"9917","28",148,1,1,0,1,-235,-122,2,-4,-196,-117,2,-3,5,4,-39,-5,0,-1
"9918","28",422,1,3,0,1,-99,-167,4,-4,-90,-154,4,-3,5,4,-9,-13,0,-1
"9919","28",225,9,2,1,2,243,-14,4,4,31,216,4,4,5,-4,212,-230,0,0
"9920","28",415,9,2,1,2,177,209,1,4,156,203,0,1,5,-4,21,6,1,3
"9921","28",440,2,3,1,0,-182,-4,-3,-3,-38,-1,-2,-2,5,3,-144,-3,-1,-1
"9922","28",152,1,1,0,0,-202,-2,-2,-4,-86,-1,0,-4,5,4,-116,-1,-2,0
"9923","28",23,9,1,0,3,209,221,4,4,210,211,4,4,5,-4,-1,10,0,0
"9924","28",15,4,4,1,3,-40,13,-1,-1,-46,18,2,1,5,1,6,-5,-3,-2
"9925","28",24,7,2,1,2,134,0,0,2,231,4,4,4,5,-2,-97,-4,-4,-2
"9926","28",292,3,3,0,1,-150,-3,-2,-2,-5,-9,0,2,5,2,-145,6,-2,-4
"9927","28",150,2,3,1,1,247,2,-3,-3,-249,1,0,0,5,3,496,1,-3,-3
"9928","28",442,6,4,1,1,-67,31,-1,1,27,26,1,1,5,-1,-94,5,-2,0
"9929","28",228,9,4,1,2,140,68,4,4,44,79,3,4,5,-4,96,-11,1,0
"9930","28",237,6,2,1,2,182,0,0,1,151,40,0,1,5,-1,31,-40,0,0
"9931","28",151,1,2,1,1,13,9,0,-4,6,10,0,-4,5,4,7,-1,0,0
"9932","28",419,6,4,1,3,98,103,1,1,161,114,1,0,5,-1,-63,-11,0,1
"9933","28",229,7,1,0,1,123,-39,2,2,60,43,2,2,5,-2,63,-82,0,0
"9934","28",149,5,3,0,1,-243,-9,-4,0,247,-1,-3,1,5,0,-490,-8,-1,-1
"9935","28",374,8,4,1,2,194,160,3,3,187,151,3,4,5,-3,7,9,0,-1
"9936","28",42,3,3,0,1,-72,64,2,-2,-81,37,2,-3,5,2,9,27,0,1
"9937","28",416,1,4,1,0,-229,239,-4,-4,-196,226,-4,4,5,4,-33,13,0,-8
"9938","28",424,6,2,1,2,88,93,1,1,111,137,1,2,5,-1,-23,-44,0,-1
"9939","28",445,7,4,1,3,88,-38,1,2,87,-41,1,1,5,-2,1,3,0,1
"9940","28",369,3,4,1,0,-172,-1,-1,-2,-205,1,0,0,5,2,33,-2,-1,-2
"9941","28",453,8,4,1,2,195,-2,3,3,190,13,3,3,5,-3,5,-15,0,0
"9942","28",240,7,2,1,1,167,11,-1,2,107,9,1,-1,5,-2,60,2,-2,3
"9943","28",458,2,1,0,1,-66,-71,0,-3,72,85,-1,-2,5,3,-138,-156,1,-1
"9944","28",37,1,1,0,0,-204,24,-4,-4,-154,19,-3,-4,5,4,-50,5,-1,0
"9945","28",443,2,1,0,0,-248,-219,-3,-3,47,-2,0,0,5,3,-295,-217,-3,-3
"9946","28",395,6,3,1,1,-220,30,-2,1,198,20,3,3,5,-1,-418,10,-5,-2
"9947","28",370,9,1,0,3,243,-12,4,4,-241,-11,-4,-4,5,-4,484,-1,8,8
"9948","28",298,1,1,0,0,-14,235,-4,-4,22,-226,1,2,5,4,-36,461,-5,-6
"9949","28",444,6,2,1,2,88,55,1,1,1,3,0,0,5,-1,87,52,1,1
"9950","28",46,1,1,0,0,-36,-239,-4,-4,106,-29,4,4,5,4,-142,-210,-8,-8
"9951","28",153,6,1,0,3,-46,-79,0,1,-5,1,1,1,5,-1,-41,-80,-1,0
"9952","28",456,2,1,1,0,-221,-100,-1,-3,20,24,0,-1,5,3,-241,-124,-1,-2
"9953","28",420,7,4,1,3,0,78,2,2,-1,1,0,1,5,-2,1,77,2,1
"9954","28",417,6,2,1,2,58,153,1,1,174,208,2,2,5,-1,-116,-55,-1,-1
"9955","28",446,5,4,1,1,-33,-21,-1,0,8,25,0,0,5,0,-41,-46,-1,0
"9956","28",293,1,4,1,0,-218,19,-4,-4,-227,13,-4,-4,5,4,9,6,0,0
"9957","28",297,1,3,1,2,-35,57,1,-4,-182,132,2,-4,5,4,147,-75,-1,0
"9958","28",454,7,4,1,3,226,4,2,2,227,5,2,2,5,-2,-1,-1,0,0
"9959","28",447,8,4,1,2,211,36,-1,3,173,63,1,2,5,-3,38,-27,-2,1
"9960","28",459,1,3,1,1,-78,-211,3,-4,-24,-154,3,-4,5,4,-54,-57,0,0
"9961","28",385,5,4,1,1,38,30,3,0,176,114,1,-1,5,0,-138,-84,2,1
"9962","28",455,8,2,1,2,73,-5,2,3,240,3,4,4,5,-3,-167,-8,-2,-1
"9963","28",396,1,1,0,1,-249,248,4,-4,-187,20,4,-4,5,4,-62,228,0,0
"9964","28",371,1,3,0,0,-188,-184,-4,-4,140,-154,-1,-1,5,4,-328,-30,-3,-3
"9965","28",375,4,3,1,1,-23,-1,-1,-1,-1,1,0,0,5,1,-22,-2,-1,-1
"9966","28",449,6,4,1,3,123,28,1,1,106,38,1,1,5,-1,17,-10,0,0
"9967","28",296,7,1,0,3,190,17,2,2,190,17,2,2,5,-2,0,0,0,0
"9968","28",372,1,3,1,0,-221,-235,-4,-4,1,2,-4,-4,5,4,-222,-237,0,0
"9969","28",45,3,3,1,0,-87,-29,-1,-2,60,-39,2,1,5,2,-147,10,-3,-3
"9970","28",384,2,1,0,0,-228,0,-3,-3,-2,56,-2,-2,5,3,-226,-56,-1,-1
"9971","28",373,1,3,0,0,-249,-216,0,-4,132,-48,-1,-4,5,4,-381,-168,1,0
"9972","28",377,1,1,0,0,-240,8,-4,-4,-241,7,-4,-4,5,4,1,1,0,0
"9973","28",294,7,1,0,3,226,5,2,2,-1,2,0,2,5,-2,227,3,2,0
"9974","28",299,6,4,0,1,207,-16,1,1,122,153,1,1,5,-1,85,-169,0,0
"9975","28",378,4,4,1,1,-89,-2,-1,-1,-111,-2,-3,-1,5,1,22,0,2,0
"9976","28",448,8,2,1,2,247,3,-1,3,199,-1,-3,1,5,-3,48,4,2,2
"9977","28",295,5,1,0,1,1,1,0,0,1,-1,0,0,5,0,0,2,0,0
"9978","28",376,4,4,1,1,14,-166,-1,-1,64,-161,-1,-1,5,1,-50,-5,0,0
"9979","28",379,3,3,0,1,32,-63,-1,-2,85,61,1,0,5,2,-53,-124,-2,-2
"9980","28",452,3,3,1,1,-191,5,-2,-2,-6,2,0,0,5,2,-185,3,-2,-2
"9981","28",3,1,3,0,0,-237,6,0,-4,-192,-1,0,-3,5,4,-45,7,0,-1
"9982","28",450,3,4,1,3,203,-5,1,-2,83,0,1,-2,5,2,120,-5,0,0
"9983","28",38,9,4,1,3,233,-28,4,4,141,-40,4,4,5,-4,92,12,0,0
"9984","28",30,7,2,1,2,90,14,1,2,232,-13,2,1,5,-2,-142,27,-1,1
"9985","28",303,5,3,1,2,70,-38,0,0,130,-94,2,3,5,0,-60,56,-2,-3
"9986","28",451,2,1,0,0,-226,-227,-3,-3,-191,-187,-4,-4,5,3,-35,-40,1,1
"9987","28",302,3,1,0,0,-139,-25,-3,-2,217,216,-4,-2,5,2,-356,-241,1,0
"9988","28",300,2,1,1,0,-194,35,-2,-3,20,38,1,1,5,3,-214,-3,-3,-4
"9989","28",381,9,2,1,2,245,249,4,4,166,151,2,2,5,-4,79,98,2,2
"9990","28",304,7,2,1,2,180,0,2,2,54,-27,1,-2,5,-2,126,27,1,4
"9991","28",380,1,4,1,1,-209,-40,3,-4,-120,-58,3,-3,5,4,-89,18,0,-1
"9992","28",301,5,4,1,1,-6,66,0,0,-140,1,-2,-1,5,0,134,65,2,1
"9993","28",382,5,4,1,2,40,10,0,0,54,13,1,1,5,0,-14,-3,-1,-1
"9994","28",305,9,4,1,3,233,243,4,4,233,244,4,4,5,-4,0,-1,0,0
"9995","28",306,5,3,1,3,126,137,1,0,116,145,1,0,5,0,10,-8,0,0
"9996","28",383,5,4,1,1,1,5,0,0,-2,6,0,0,5,0,3,-1,0,0
"9997","29",467,5,1,0,3,-118,-189,4,0,138,160,4,0,5,0,-256,-349,0,0
"9998","29",256,5,3,0,1,-133,0,0,0,114,103,0,0,5,0,-247,-103,0,0
"9999","29",257,1,1,0,0,0,0,-3,-4,76,55,0,-4,5,4,-76,-55,-3,0
"10000","29",276,7,4,1,3,208,2,2,2,168,-1,2,2,5,-2,40,3,0,0
"10001","29",43,1,3,1,0,-49,23,-3,-4,138,52,-1,-3,5,4,-187,-29,-2,-1
"10002","29",254,4,2,1,3,215,-149,1,-1,154,-83,2,0,5,1,61,-66,-1,-1
"10003","29",280,3,2,1,1,-77,41,-1,-2,49,-26,1,-1,5,2,-126,67,-2,-1
"10004","29",468,5,1,1,3,174,-118,2,0,-106,72,-1,-1,5,0,280,-190,3,1
"10005","29",430,3,2,1,1,131,-93,2,-2,209,-142,1,-2,5,2,-78,49,1,0
"10006","29",259,1,3,1,1,-113,33,4,-4,93,32,4,-2,5,4,-206,1,0,-2
"10007","29",50,3,2,1,1,91,-21,1,-2,126,-70,2,-2,5,2,-35,49,-1,0
"10008","29",258,3,3,0,0,20,3,1,-2,92,6,2,-2,5,2,-72,-3,-1,0
"10009","29",255,5,3,1,1,-64,-58,0,0,-156,-57,0,0,5,0,92,-1,0,0
"10010","29",429,1,2,1,0,30,16,-2,-4,32,14,0,-4,5,4,-2,2,-2,0
"10011","29",466,2,3,0,0,-93,-33,-2,-3,-99,-78,-2,-2,5,3,6,45,0,-1
"10012","29",28,4,4,1,1,4,-7,-1,-1,18,-66,-1,-1,5,1,-14,59,0,0
"10013","29",49,7,4,1,1,149,46,2,2,161,55,2,2,5,-2,-12,-9,0,0
"10014","29",66,1,1,0,1,-97,-2,-2,-4,-69,0,1,1,5,4,-28,-2,-3,-5
"10015","29",463,8,4,0,3,-244,-2,0,3,248,-3,1,-2,5,-3,-492,1,-1,5
"10016","29",175,6,4,1,1,-97,58,0,1,-56,-13,-2,-1,5,-1,-41,71,2,2
"10017","29",277,5,4,1,1,63,-169,0,0,48,-119,2,0,5,0,15,-50,-2,0
"10018","29",67,5,1,0,0,-20,24,-3,0,116,-123,1,2,5,0,-136,147,-4,-2
"10019","29",281,1,4,1,2,-9,-249,-4,-4,-9,-248,-4,-4,5,4,0,-1,0,0
"10020","29",176,8,1,0,1,-168,-23,-3,3,195,4,-2,1,5,-3,-363,-27,-1,2
"10021","29",469,3,4,1,0,131,11,-3,-2,103,77,-3,-4,5,2,28,-66,0,2
"10022","29",48,1,3,1,0,5,-5,-4,-4,83,-76,-4,-4,5,4,-78,71,0,0
"10023","29",282,9,3,1,3,-82,-33,1,4,220,17,1,4,5,-4,-302,-50,0,0
"10024","29",473,4,3,1,0,-209,-15,-1,-1,-187,-33,-2,-2,5,1,-22,18,1,1
"10025","29",432,4,2,1,1,131,90,-1,-1,67,-46,0,0,5,1,64,136,-1,-1
"10026","29",462,9,3,1,3,230,121,4,4,199,205,4,4,5,-4,31,-84,0,0
"10027","29",474,1,1,0,0,2,-67,0,-4,4,-63,0,-4,5,4,-2,-4,0,0
"10028","29",26,1,1,0,0,-242,-172,-4,-4,-173,-72,-3,-4,5,4,-69,-100,-1,0
"10029","29",433,1,1,0,0,-209,-229,-4,-4,229,230,4,4,5,4,-438,-459,-8,-8
"10030","29",5,6,2,1,2,188,80,2,1,142,104,1,0,5,-1,46,-24,1,1
"10031","29",475,4,3,0,3,-64,56,-2,-1,-123,-173,-2,-2,5,1,59,229,0,1
"10032","29",464,6,1,0,1,-21,27,1,1,19,5,1,1,5,-1,-40,22,0,0
"10033","29",434,6,4,1,3,112,2,1,1,-176,-118,-2,-1,5,-1,288,120,3,2
"10034","29",278,1,4,1,1,239,-241,4,-4,226,-230,4,-4,5,4,13,-11,0,0
"10035","29",431,3,3,1,0,-39,2,-2,-2,32,37,-1,-1,5,2,-71,-35,-1,-1
"10036","29",465,7,4,1,3,10,-232,1,2,0,-235,1,1,5,-2,10,3,0,1
"10037","29",51,6,4,1,1,1,10,0,1,-23,-46,0,-1,5,-1,24,56,0,2
"10038","29",47,7,4,1,3,196,0,1,2,47,1,0,1,5,-2,149,-1,1,1
"10039","29",262,6,4,1,3,61,79,1,1,58,62,1,1,5,-1,3,17,0,0
"10040","29",283,4,1,1,1,-103,53,-3,-1,-116,-104,-1,0,5,1,13,157,-2,-1
"10041","29",470,4,1,0,1,-55,30,-1,-1,-80,37,-1,-1,5,1,25,-7,0,0
"10042","29",7,6,1,1,3,65,98,1,1,40,87,1,2,5,-1,25,11,0,-1
"10043","29",352,4,2,1,1,13,-103,-1,-1,16,-120,0,-1,5,1,-3,17,-1,0
"10044","29",171,6,1,0,1,90,45,1,1,24,22,0,0,5,-1,66,23,1,1
"10045","29",260,2,3,1,0,-245,-246,-3,-3,-235,-231,-3,-3,5,3,-10,-15,0,0
"10046","29",70,3,2,1,2,130,195,0,-2,143,210,0,-3,5,2,-13,-15,0,1
"10047","29",285,7,2,1,1,-3,-63,-2,2,-3,-126,-2,3,5,-2,0,63,0,-1
"10048","29",68,1,4,1,0,34,2,0,-4,83,3,-2,-3,5,4,-49,-1,2,-1
"10049","29",261,9,1,0,3,134,125,4,4,85,-94,4,4,5,-4,49,219,0,0
"10050","29",177,8,4,1,1,-77,132,-3,3,-118,95,-1,0,5,-3,41,37,-2,3
"10051","29",279,7,4,1,3,168,150,1,2,172,80,1,2,5,-2,-4,70,0,0
"10052","29",69,8,4,1,1,-135,53,2,3,-132,11,-1,-2,5,-3,-3,42,3,5
"10053","29",174,5,4,1,3,79,166,1,0,45,158,0,0,5,0,34,8,1,0
"10054","29",73,5,4,1,2,-31,-27,0,0,-105,-118,0,0,5,0,74,91,0,0
"10055","29",331,2,1,1,0,68,-183,-4,-3,39,-213,-4,-3,5,3,29,30,0,0
"10056","29",263,1,4,1,0,-240,-3,-3,-4,-243,3,-3,-4,5,4,3,-6,0,0
"10057","29",284,2,3,1,1,-162,-80,-4,-3,-205,-144,-4,-4,5,3,43,64,0,1
"10058","29",471,6,3,1,2,62,49,2,1,107,-79,1,1,5,-1,-45,128,1,0
"10059","29",168,6,1,0,3,91,-88,-1,1,153,-145,2,3,5,-1,-62,57,-3,-2
"10060","29",353,5,2,1,2,236,101,-4,0,226,188,-4,-1,5,0,10,-87,0,1
"10061","29",476,4,3,1,0,-179,-173,0,-1,-53,-199,1,1,5,1,-126,26,-1,-2
"10062","29",472,1,1,0,0,-231,237,-4,-4,-245,230,-4,-4,5,4,14,7,0,0
"10063","29",435,6,4,1,1,-4,-110,0,1,-163,-8,-2,-1,5,-1,159,-102,2,2
"10064","29",286,6,1,0,3,81,-1,2,1,51,4,4,1,5,-1,30,-5,-2,0
"10065","29",330,7,2,1,2,109,171,2,2,136,161,1,1,5,-2,-27,10,1,1
"10066","29",436,4,4,1,3,0,-117,4,-1,47,119,1,-1,5,1,-47,-236,3,0
"10067","29",52,3,3,0,0,-199,4,1,-2,-83,1,1,-2,5,2,-116,3,0,0
"10068","29",170,3,2,1,0,124,124,-2,-2,130,127,0,0,5,2,-6,-3,-2,-2
"10069","29",182,6,4,0,3,5,-106,2,1,-1,-169,2,2,5,-1,6,63,0,-1
"10070","29",179,5,1,0,1,-1,-5,0,0,-4,168,2,-1,5,0,3,-173,-2,1
"10071","29",74,1,3,0,0,-243,-82,-4,-4,120,93,2,0,5,4,-363,-175,-6,-4
"10072","29",332,1,1,0,0,-249,73,-4,-4,-250,103,-3,-3,5,4,1,-30,-1,-1
"10073","29",264,6,4,1,2,238,249,1,1,219,218,2,2,5,-1,19,31,-1,-1
"10074","29",172,6,2,1,3,75,64,-1,1,106,100,2,1,5,-1,-31,-36,-3,0
"10075","29",75,3,4,1,2,230,38,2,-2,219,36,4,-2,5,2,11,2,-2,0
"10076","29",71,4,3,1,1,-131,21,-1,-1,25,18,-1,0,5,1,-156,3,0,-1
"10077","29",354,3,1,0,0,-235,187,1,-2,126,170,2,3,5,2,-361,17,-1,-5
"10078","29",173,8,4,1,3,236,32,3,3,153,11,1,1,5,-3,83,21,2,2
"10079","29",181,1,4,1,3,83,72,0,-4,-111,-95,0,0,5,4,194,167,0,-4
"10080","29",178,5,1,0,1,1,4,0,0,1,-2,0,0,5,0,0,6,0,0
"10081","29",287,6,4,1,3,-115,1,1,1,205,2,2,3,5,-1,-320,-1,-1,-2
"10082","29",77,4,3,0,1,-93,4,-1,-1,-132,-3,-1,-1,5,1,39,7,0,0
"10083","29",437,3,1,0,0,-218,4,-2,-2,-223,-1,-3,-3,5,2,5,5,1,1
"10084","29",272,6,4,1,2,135,94,1,1,88,63,1,1,5,-1,47,31,0,0
"10085","29",400,4,4,1,2,52,-80,-1,-1,93,-89,-1,-1,5,1,-41,9,0,0
"10086","29",183,1,4,1,1,51,57,2,-4,34,84,2,-3,5,4,17,-27,0,-1
"10087","29",54,6,4,0,1,-188,28,-1,1,73,26,-2,1,5,-1,-261,2,1,0
"10088","29",273,3,1,0,0,238,7,-1,-2,1,1,1,1,5,2,237,6,-2,-3
"10089","29",169,1,3,1,0,-221,229,-4,-4,-247,233,-4,-4,5,4,26,-4,0,0
"10090","29",59,3,1,0,0,-25,12,-2,-2,-67,-44,1,-4,5,2,42,56,-3,2
"10091","29",55,5,4,1,1,-101,61,0,0,-79,161,0,-1,5,0,-22,-100,0,1
"10092","29",76,5,4,1,3,7,1,0,0,6,-1,0,0,5,0,1,2,0,0
"10093","29",6,7,4,1,2,181,2,2,2,181,2,2,2,5,-2,0,0,0,0
"10094","29",355,3,2,1,2,106,77,-3,-2,12,-41,-3,-2,5,2,94,118,0,0
"10095","29",40,8,1,0,2,-177,-41,-3,3,153,-55,3,2,5,-3,-330,14,-6,1
"10096","29",133,4,2,1,1,219,-211,1,-1,38,9,1,-1,5,1,181,-220,0,0
"10097","29",53,6,4,1,3,193,0,1,1,219,-1,2,2,5,-1,-26,1,-1,-1
"10098","29",288,4,2,1,2,71,-15,2,-1,0,2,1,3,5,1,71,-17,1,-4
"10099","29",398,9,4,1,2,248,244,4,4,246,247,4,4,5,-4,2,-3,0,0
"10100","29",18,2,3,0,1,-38,-212,1,-3,83,25,0,-2,5,3,-121,-237,1,-1
"10101","29",289,8,1,0,3,233,240,3,3,196,195,3,3,5,-3,37,45,0,0
"10102","29",333,4,4,1,1,-80,-36,-1,-1,39,-109,0,-1,5,1,-119,73,-1,0
"10103","29",184,7,3,0,3,164,1,2,2,142,-3,2,3,5,-2,22,4,0,-1
"10104","29",180,9,2,1,2,1,239,4,4,242,1,4,3,5,-4,-241,238,0,1
"10105","29",274,7,4,1,2,172,109,2,2,194,116,2,2,5,-2,-22,-7,0,0
"10106","29",72,2,1,0,0,-78,17,-2,-3,203,207,3,3,5,3,-281,-190,-5,-6
"10107","29",241,6,4,1,2,217,190,3,1,213,157,2,0,5,-1,4,33,1,1
"10108","29",56,4,3,1,1,44,-122,-2,-1,40,-121,-2,-1,5,1,4,-1,0,0
"10109","29",167,7,1,0,3,117,83,1,2,93,-153,-2,-1,5,-2,24,236,3,3
"10110","29",356,3,4,1,1,30,2,0,-2,143,3,2,2,5,2,-113,-1,-2,-4
"10111","29",408,5,1,1,0,-196,211,2,0,-161,-2,-1,-2,5,0,-35,213,3,2
"10112","29",78,3,4,1,0,-195,4,-2,-2,-169,21,-2,-2,5,2,-26,-17,0,0
"10113","29",438,6,4,1,3,239,-3,4,1,239,3,4,0,5,-1,0,-6,0,1
"10114","29",357,4,4,1,2,-69,-14,-1,-1,-69,-2,-1,-1,5,1,0,-12,0,0
"10115","29",401,2,2,1,1,116,17,0,-3,72,20,0,-2,5,3,44,-3,0,-1
"10116","29",399,6,4,1,3,102,11,1,1,106,19,1,1,5,-1,-4,-8,0,0
"10117","29",439,7,2,1,1,190,-4,2,2,204,-4,2,2,5,-2,-14,0,0,0
"10118","29",29,1,4,1,0,-248,244,-4,-4,-208,195,-4,-4,5,4,-40,49,0,0
"10119","29",17,1,3,1,0,61,30,-1,-4,133,94,-1,-4,5,4,-72,-64,0,0
"10120","29",185,6,4,1,2,47,-12,-1,1,77,-7,-2,3,5,-1,-30,-5,1,-2
"10121","29",407,9,2,1,2,244,12,4,4,236,13,3,3,5,-4,8,-1,1,1
"10122","29",335,6,2,1,1,25,49,0,1,30,56,1,1,5,-1,-5,-7,-1,0
"10123","29",60,8,1,0,3,2,124,3,3,-1,-133,3,3,5,-3,3,257,0,0
"10124","29",243,5,2,1,2,243,66,2,0,249,244,2,-1,5,0,-6,-178,0,1
"10125","29",202,4,1,0,1,-80,25,1,-1,26,83,-2,-1,5,1,-106,-58,3,0
"10126","29",134,5,2,1,2,87,10,2,0,68,9,1,0,5,0,19,1,1,0
"10127","29",244,4,4,1,2,28,-152,0,-1,230,224,3,2,5,1,-202,-376,-3,-3
"10128","29",58,6,4,1,1,-242,0,-3,1,-3,247,4,3,5,-1,-239,-247,-7,-2
"10129","29",79,7,4,1,2,-25,-8,2,2,-17,-11,0,0,5,-2,-8,3,2,2
"10130","29",135,5,1,0,1,-167,-51,0,0,-220,-18,1,1,5,0,53,-33,-1,-1
"10131","29",358,5,4,1,2,223,72,0,0,225,120,0,0,5,0,-2,-48,0,0
"10132","29",334,1,4,1,0,-219,0,-4,-4,-241,18,-4,1,5,4,22,-18,0,-5
"10133","29",4,5,3,0,1,240,229,0,0,239,230,3,3,5,0,1,-1,-3,-3
"10134","29",246,8,4,1,3,244,0,4,3,222,-1,4,4,5,-3,22,1,0,-1
"10135","29",275,7,4,1,2,-10,249,2,2,247,4,3,3,5,-2,-257,245,-1,-1
"10136","29",186,9,2,1,2,232,234,2,4,138,130,0,2,5,-4,94,104,2,2
"10137","29",242,4,4,1,2,86,80,2,-1,165,42,2,-2,5,1,-79,38,0,1
"10138","29",57,1,4,1,1,170,-140,-1,-4,160,-159,-1,-4,5,4,10,19,0,0
"10139","29",2,4,4,1,1,-47,-29,-3,-1,2,1,0,0,5,1,-49,-30,-3,-1
"10140","29",61,1,1,0,3,233,4,4,-4,-214,-161,4,-4,5,4,447,165,0,0
"10141","29",409,7,4,1,2,105,122,2,2,128,128,2,2,5,-2,-23,-6,0,0
"10142","29",203,9,4,1,3,-10,-16,4,4,-8,7,4,4,5,-4,-2,-23,0,0
"10143","29",20,3,3,0,0,-222,-235,-4,-2,61,65,0,0,5,2,-283,-300,-4,-2
"10144","29",245,1,1,0,0,-241,63,-4,-4,-241,-5,-4,-4,5,4,0,68,0,0
"10145","29",402,1,3,1,0,-227,2,-4,-4,175,-1,3,-1,5,4,-402,3,-7,-3
"10146","29",318,6,2,1,2,191,-195,-4,1,179,-187,-4,0,5,-1,12,-8,0,1
"10147","29",44,7,2,1,2,229,-216,0,2,179,-53,0,0,5,-2,50,-163,0,2
"10148","29",290,4,1,1,1,-187,-33,0,-1,8,-14,0,-3,5,1,-195,-19,0,2
"10149","29",397,5,4,1,3,38,112,0,0,35,79,1,0,5,0,3,33,-1,0
"10150","29",137,2,1,0,1,-243,239,3,-3,243,243,1,-3,5,3,-486,-4,2,0
"10151","29",36,8,3,1,3,-193,210,3,3,204,222,4,4,5,-3,-397,-12,-1,-1
"10152","29",336,3,4,1,3,178,115,3,-2,135,151,3,-2,5,2,43,-36,0,0
"10153","29",187,8,4,1,2,166,92,3,3,157,105,2,3,5,-3,9,-13,1,0
"10154","29",269,6,4,1,2,147,-1,1,1,180,0,1,1,5,-1,-33,-1,0,0
"10155","29",265,9,1,0,3,162,2,3,4,-6,-7,0,0,5,-4,168,9,3,4
"10156","29",341,9,1,0,3,248,-42,4,4,240,-22,3,4,5,-4,8,-20,1,0
"10157","29",62,9,2,1,3,223,231,4,4,218,182,4,4,5,-4,5,49,0,0
"10158","29",418,6,2,1,2,208,-232,2,1,208,-227,1,1,5,-1,0,-5,1,0
"10159","29",8,7,3,1,1,-124,-21,-1,2,-158,-120,0,-1,5,-2,34,99,-1,3
"10160","29",136,1,1,0,0,-181,210,-4,-4,-242,239,-4,-4,5,4,61,-29,0,0
"10161","29",359,9,4,1,3,232,16,4,4,228,15,4,1,5,-4,4,1,0,3
"10162","29",80,8,4,1,3,206,2,3,3,227,-4,3,-3,5,-3,-21,6,0,6
"10163","29",250,6,1,0,3,93,26,1,1,76,19,1,1,5,-1,17,7,0,0
"10164","29",247,4,3,0,0,-165,-6,-1,-1,73,-8,0,0,5,1,-238,2,-1,-1
"10165","29",404,4,1,0,1,55,-52,-1,-1,39,-42,1,0,5,1,16,-10,-2,-1
"10166","29",251,4,3,1,1,-2,-212,4,-1,-234,54,0,-1,5,1,232,-266,4,0
"10167","29",441,7,4,1,2,115,57,4,2,137,43,4,3,5,-2,-22,14,0,-1
"10168","29",292,1,3,0,1,-148,4,-4,-4,70,9,0,3,5,4,-218,-5,-4,-7
"10169","29",337,9,2,1,3,242,241,4,4,238,25,4,4,5,-4,4,216,0,0
"10170","29",188,9,2,1,3,238,5,4,4,194,4,4,4,5,-4,44,1,0,0
"10171","29",41,6,2,1,3,90,94,3,1,87,85,3,1,5,-1,3,9,0,0
"10172","29",204,6,3,1,1,57,-68,1,1,141,-163,0,0,5,-1,-84,95,1,1
"10173","29",200,1,3,1,0,-238,-155,-4,-4,-229,-39,-4,-4,5,4,-9,-116,0,0
"10174","29",270,5,3,1,1,3,-3,0,0,-4,0,1,0,5,0,7,-3,-1,0
"10175","29",403,2,1,0,0,-224,-11,1,-3,-166,-90,1,-1,5,3,-58,79,0,-2
"10176","29",319,6,1,0,1,113,1,2,1,72,-73,1,1,5,-1,41,74,1,0
"10177","29",440,2,3,0,0,-171,-3,-3,-3,-164,2,-3,-3,5,3,-7,-5,0,0
"10178","29",291,6,4,1,2,148,43,-1,1,-243,-239,-2,-4,5,-1,391,282,1,5
"10179","29",81,8,1,0,0,-209,75,4,3,-174,210,4,1,5,-3,-35,-135,0,2
"10180","29",138,6,3,0,1,89,-22,1,1,41,-22,0,0,5,-1,48,0,1,1
"10181","29",360,1,3,1,0,-221,-125,-3,-4,31,-1,0,-4,5,4,-252,-124,-3,0
"10182","29",405,6,4,1,1,121,125,1,1,17,2,1,-1,5,-1,104,123,0,2
"10183","29",252,4,4,0,1,-30,-119,0,-1,-113,-148,0,0,5,1,83,29,0,-1
"10184","29",27,6,2,1,2,72,108,2,1,102,110,2,0,5,-1,-30,-2,0,1
"10185","29",266,4,1,1,1,-108,-1,-1,-1,-154,-2,-2,-1,5,1,46,1,1,0
"10186","29",342,4,3,1,1,-17,-12,0,-1,-20,27,-1,0,5,1,3,-39,1,-1
"10187","29",63,5,4,1,1,0,-1,0,0,0,-1,0,0,5,0,0,0,0,0
"10188","29",419,4,4,1,3,97,109,0,-1,148,110,1,0,5,1,-51,-1,-1,-1
"10189","29",339,2,3,1,1,-74,-73,-4,-3,-141,-74,-2,-2,5,3,67,1,-2,-1
"10190","29",19,5,2,1,2,110,-73,0,0,110,131,1,2,5,0,0,-204,-1,-2
"10191","29",411,9,2,1,2,228,234,4,4,217,226,4,4,5,-4,11,8,0,0
"10192","29",206,4,4,1,0,-42,25,-2,-1,-35,14,-2,-2,5,1,-7,11,0,1
"10193","29",112,3,4,1,3,71,-48,3,-2,244,1,3,4,5,2,-173,-49,0,-6
"10194","29",248,5,4,1,3,30,143,1,0,12,89,1,-1,5,0,18,54,0,1
"10195","29",324,2,2,1,0,99,4,-3,-3,84,-6,-3,-3,5,3,15,10,0,0
"10196","29",320,8,2,1,2,227,109,3,3,223,121,3,3,5,-3,4,-12,0,0
"10197","29",442,6,4,1,1,-39,28,-1,1,28,21,1,1,5,-1,-67,7,-2,0
"10198","29",293,1,4,1,0,-217,25,-4,-4,-239,11,-4,-4,5,4,22,14,0,0
"10199","29",338,1,3,1,2,112,106,-4,-4,92,-170,-2,1,5,4,20,276,-2,-5
"10200","29",189,3,1,0,1,-194,19,2,-2,-213,41,3,-2,5,2,19,-22,-1,0
"10201","29",410,1,1,0,0,-48,-23,0,-4,200,24,1,-1,5,4,-248,-47,-1,-3
"10202","29",205,7,1,0,2,178,4,2,2,198,1,2,2,5,-2,-20,3,0,0
"10203","29",201,1,3,1,1,71,-1,2,-4,31,-1,2,-2,5,4,40,0,0,-2
"10204","29",271,4,3,1,1,128,0,-2,-1,169,0,3,2,5,1,-41,0,-5,-3
"10205","29",323,4,4,1,1,146,0,0,-1,192,1,-1,-4,5,1,-46,-1,1,3
"10206","29",32,5,1,0,1,-2,-8,0,0,153,-182,2,-4,5,0,-155,174,-2,4
"10207","29",65,7,1,0,3,69,47,2,2,34,29,2,2,5,-2,35,18,0,0
"10208","29",420,6,4,1,3,0,1,2,1,-4,75,1,2,5,-1,4,-74,1,-1
"10209","29",82,9,4,1,2,197,31,4,4,238,23,4,4,5,-4,-41,8,0,0
"10210","29",139,9,4,1,2,0,0,4,4,-3,214,1,4,5,-4,3,-214,3,0
"10211","29",361,1,1,0,0,-249,-6,-4,-4,249,-10,4,4,5,4,-498,4,-8,-8
"10212","29",406,6,2,1,2,192,181,2,1,205,66,3,1,5,-1,-13,115,-1,0
"10213","29",253,9,3,1,3,228,234,4,4,239,245,4,4,5,-4,-11,-11,0,0
"10214","29",25,4,4,1,2,50,51,0,-1,101,100,0,-1,5,1,-51,-49,0,0
"10215","29",267,5,3,1,1,52,0,0,0,52,0,1,1,5,0,0,0,-1,-1
"10216","29",343,7,2,1,2,3,-95,2,2,-1,-64,2,2,5,-2,4,-31,0,0
"10217","29",64,9,1,0,1,214,-207,4,4,233,-25,4,4,5,-4,-19,-182,0,0
"10218","29",42,3,3,1,1,-60,59,2,-2,-64,41,2,-3,5,2,4,18,0,1
"10219","29",34,6,4,1,2,90,-74,1,1,103,-57,1,1,5,-1,-13,-17,0,0
"10220","29",190,7,4,1,3,211,178,2,2,249,192,2,2,5,-2,-38,-14,0,0
"10221","29",412,9,1,0,0,-246,2,-4,4,242,1,4,4,5,-4,-488,1,-8,0
"10222","29",207,6,1,0,0,-1,1,-4,1,-3,249,4,4,5,-1,2,-248,-8,-3
"10223","29",113,6,2,1,2,7,4,1,1,-81,22,-2,-1,5,-1,88,-18,3,2
"10224","29",249,1,3,1,0,-51,-43,-4,-4,35,-38,1,-4,5,4,-86,-5,-5,0
"10225","29",325,9,1,0,1,-86,-117,-3,4,-62,-56,-2,4,5,-4,-24,-61,-1,0
"10226","29",321,1,1,0,0,-207,-186,-4,-4,-215,-204,-3,-3,5,4,8,18,-1,-1
"10227","29",443,4,1,0,0,-109,9,-1,-1,62,9,1,1,5,1,-171,0,-2,-2
"10228","29",294,5,1,0,3,-1,1,0,0,-1,1,0,0,5,0,0,0,0,0
"10229","29",395,6,3,1,1,-190,25,-2,1,95,18,-2,3,5,-1,-285,7,0,-2
"10230","29",314,1,4,1,1,-243,8,4,-4,-243,7,4,-4,5,4,0,1,0,0
"10231","29",310,7,4,1,2,129,22,2,2,213,76,3,3,5,-2,-84,-54,-1,-1
"10232","29",116,7,2,1,3,135,-25,1,2,98,-7,2,3,5,-2,37,-18,-1,-1
"10233","29",98,1,3,0,0,-232,-21,-4,-4,194,-157,2,2,5,4,-426,136,-6,-6
"10234","29",109,1,1,0,1,10,-231,3,-4,-46,1,-4,-4,5,4,56,-232,7,0
"10235","29",349,7,4,1,1,29,-51,1,2,52,-94,1,0,5,-2,-23,43,0,2
"10236","29",345,8,1,0,0,-216,16,-4,3,-229,13,-4,2,5,-3,13,3,0,1
"10237","29",425,6,4,1,2,31,52,1,1,8,20,1,1,5,-1,23,32,0,0
"10238","29",421,4,3,1,1,-74,19,0,-1,24,22,0,0,5,1,-98,-3,0,-1
"10239","29",83,6,1,0,3,134,-141,1,1,132,-99,2,1,5,-1,2,-42,-1,0
"10240","29",14,4,3,0,1,-18,-2,0,-1,165,-37,3,2,5,1,-183,35,-3,-3
"10241","29",362,6,4,1,3,107,-146,4,1,104,106,2,1,5,-1,3,-252,2,0
"10242","29",115,5,3,0,3,-2,-7,0,0,69,-2,0,0,5,0,-71,-5,0,0
"10243","29",111,2,1,0,0,-118,-136,-2,-3,56,-62,2,-1,5,3,-174,-74,-4,-2
"10244","29",108,9,2,1,3,218,204,4,4,198,211,4,4,5,-4,20,-7,0,0
"10245","29",268,8,4,0,3,161,67,3,3,86,-104,2,2,5,-3,75,171,1,1
"10246","29",344,8,4,1,3,128,-73,2,3,69,103,2,2,5,-3,59,-176,0,1
"10247","29",445,7,4,1,3,182,-28,2,2,80,-35,2,2,5,-2,102,7,0,0
"10248","29",296,7,1,0,3,174,0,2,2,174,0,2,2,5,-2,0,0,0,0
"10249","29",340,4,1,0,1,-103,-10,0,-1,26,20,0,0,5,1,-129,-30,0,-1
"10250","29",191,3,1,0,0,-186,-30,-2,-2,-189,-45,-2,-3,5,2,3,15,0,1
"10251","29",413,3,1,0,1,-187,4,-2,-2,-199,-14,-2,-2,5,2,12,18,0,0
"10252","29",208,9,4,1,2,225,87,4,4,-242,66,-4,4,5,-4,467,21,8,0
"10253","29",114,6,4,1,1,48,21,1,1,94,85,1,-3,5,-1,-46,-64,0,4
"10254","29",110,7,1,0,1,-127,92,-4,2,133,-103,-3,2,5,-2,-260,195,-1,0
"10255","29",326,7,4,1,2,149,37,2,2,132,132,0,2,5,-2,17,-95,2,0
"10256","29",322,8,4,1,3,18,-16,3,3,230,-220,3,3,5,-3,-212,204,0,0
"10257","29",444,6,2,1,2,69,36,1,1,55,42,1,1,5,-1,14,-6,0,0
"10258","29",295,5,1,0,1,-9,4,0,0,-9,0,0,0,5,0,0,4,0,0
"10259","29",396,1,1,0,1,-247,245,4,-4,-213,64,4,-4,5,4,-34,181,0,0
"10260","29",315,3,3,1,3,235,11,4,-2,238,18,4,4,5,2,-3,-7,0,-6
"10261","29",311,1,2,1,2,192,15,4,-4,222,21,4,-4,5,4,-30,-6,0,0
"10262","29",117,2,4,1,2,86,12,-3,-3,61,12,-2,-2,5,3,25,0,-1,-1
"10263","29",99,8,4,1,3,217,-29,2,3,241,-42,2,4,5,-3,-24,13,0,-1
"10264","29",11,7,4,1,1,-147,85,-1,2,-161,-124,-2,2,5,-2,14,209,1,0
"10265","29",35,2,1,1,3,68,169,3,-3,132,130,2,-1,5,3,-64,39,1,-2
"10266","29",346,7,3,1,0,-249,-189,-4,2,239,0,3,3,5,-2,-488,-189,-7,-1
"10267","29",426,9,4,1,3,-97,247,4,4,246,0,4,3,5,-4,-343,247,0,1
"10268","29",422,5,3,1,1,-59,-180,4,0,-76,-184,4,-3,5,0,17,4,0,3
"10269","29",84,9,4,1,3,212,3,4,4,206,-2,3,3,5,-4,6,5,1,1
"10270","29",140,5,1,0,1,-23,-35,0,0,-99,64,0,0,5,0,76,-99,0,0
"10271","29",363,8,3,1,3,0,0,3,3,249,1,3,3,5,-3,-249,-1,0,0
"10272","29",21,4,4,1,2,82,48,2,-1,112,71,2,-1,5,1,-30,-23,0,0
"10273","29",165,2,1,0,1,-112,5,-3,-3,117,13,1,1,5,3,-229,-8,-4,-4
"10274","29",388,5,4,1,0,-9,239,0,0,-234,4,1,-1,5,0,225,235,-1,1
"10275","29",328,4,3,1,1,-31,12,-1,-1,6,8,1,1,5,1,-37,4,-2,-2
"10276","29",101,1,3,1,0,-233,234,-4,-4,212,225,-3,-3,5,4,-445,9,-1,-1
"10277","29",446,4,4,1,1,-70,-32,-2,-1,38,25,0,0,5,1,-108,-57,-2,-1
"10278","29",297,1,3,1,2,-238,230,-2,-4,-221,26,-1,-4,5,4,-17,204,-1,0
"10279","29",196,2,3,1,0,-177,-38,-3,-3,189,224,2,-1,5,3,-366,-262,-5,-2
"10280","29",192,4,4,1,1,94,0,-1,-1,129,4,1,1,5,1,-35,-4,-2,-2
"10281","29",414,2,1,1,0,-121,-113,-3,-3,-109,-89,-1,-1,5,3,-12,-24,-2,-2
"10282","29",209,6,4,1,3,211,7,2,1,153,-22,2,3,5,-1,58,29,0,-2
"10283","29",31,1,1,0,0,-167,-66,-4,-4,-109,-61,-4,-4,5,4,-58,-5,0,0
"10284","29",387,1,3,1,1,-195,-180,-4,-4,110,139,2,1,5,4,-305,-319,-6,-5
"10285","29",327,5,4,1,3,248,-8,3,0,222,-1,4,1,5,0,26,-7,-1,-1
"10286","29",100,9,4,1,3,246,-1,2,4,236,7,3,3,5,-4,10,-8,-1,1
"10287","29",428,1,1,0,0,-238,245,-4,-4,-241,242,-4,-4,5,4,3,3,0,0
"10288","29",424,6,2,1,2,82,81,1,1,146,138,1,2,5,-1,-64,-57,0,-1
"10289","29",86,8,4,1,3,164,-2,2,3,159,7,2,3,5,-3,5,-9,0,0
"10290","29",316,2,3,1,0,-189,-145,-3,-3,-170,-108,-3,-3,5,3,-19,-37,0,0
"10291","29",312,5,4,1,1,38,46,0,0,10,-66,3,4,5,0,28,112,-3,-4
"10292","29",118,6,3,1,1,-101,21,-2,1,-16,-18,-2,1,5,-1,-85,39,0,0
"10293","29",309,4,4,1,2,166,28,-1,-1,204,93,-1,-2,5,1,-38,-65,0,1
"10294","29",386,1,1,0,0,-238,206,-4,-4,-13,-14,0,0,5,4,-225,220,-4,-4
"10295","29",350,5,4,1,1,9,-242,0,0,-14,-243,2,2,5,0,23,1,-2,-2
"10296","29",347,6,1,0,3,170,-83,2,1,106,-121,2,1,5,-1,64,38,0,0
"10297","29",427,3,4,1,1,243,25,2,-2,-146,-20,1,-1,5,2,389,45,1,-1
"10298","29",423,6,1,0,3,205,-37,0,1,114,-35,2,-2,5,-1,91,-2,-2,3
"10299","29",85,8,2,1,2,128,114,4,3,146,102,3,2,5,-3,-18,12,1,1
"10300","29",141,1,1,0,0,-193,-232,-3,-4,-243,-241,-4,-4,5,4,50,9,1,0
"10301","29",364,5,3,1,1,-52,0,0,0,-4,-5,-1,-1,5,0,-48,5,1,1
"10302","29",210,8,4,1,2,173,185,3,3,195,186,4,4,5,-3,-22,-1,-1,-1
"10303","29",166,2,4,1,2,215,209,-2,-3,198,196,-2,-3,5,3,17,13,0,0
"10304","29",389,4,3,1,2,-138,-1,-1,-1,-192,-102,1,-2,5,1,54,101,-2,1
"10305","29",329,4,4,1,3,111,-78,1,-1,84,51,-1,1,5,1,27,-129,2,-2
"10306","29",102,9,4,1,3,-89,73,2,4,-41,48,0,3,5,-4,-48,25,2,1
"10307","29",447,8,4,1,2,189,58,-1,3,213,58,-1,2,5,-3,-24,0,0,1
"10308","29",298,1,1,0,0,-248,-3,-1,-4,4,-247,1,1,5,4,-252,244,-2,-5
"10309","29",197,3,4,1,3,-93,8,3,-2,-212,8,1,-1,5,2,119,0,2,-1
"10310","29",193,1,1,0,0,-237,-27,-3,-4,198,137,1,1,5,4,-435,-164,-4,-5
"10311","29",415,7,2,1,2,161,190,0,2,190,197,0,3,5,-2,-29,-7,0,-1
"10312","29",12,9,4,1,3,-1,0,4,4,-1,3,4,4,5,-4,0,-3,0,0
"10313","29",348,2,3,1,1,4,0,-4,-3,68,44,0,-2,5,3,-64,-44,-4,-1
"10314","29",238,1,3,1,1,-44,-32,-4,-4,151,72,2,2,5,4,-195,-104,-6,-6
"10315","29",230,5,1,0,0,-222,-18,-3,0,-212,71,-3,0,5,0,-10,-89,0,0
"10316","29",105,1,1,0,0,-229,32,-4,-4,228,85,2,0,5,4,-457,-53,-6,-4
"10317","29",45,3,3,1,0,-72,-22,-2,-2,-22,-33,1,-1,5,2,-50,11,-3,-1
"10318","29",30,7,2,1,2,-24,0,1,2,195,-10,1,1,5,-2,-219,10,0,1
"10319","29",87,8,4,1,3,61,-1,2,3,133,84,4,4,5,-3,-72,-85,-2,-1
"10320","29",317,3,4,1,2,-108,103,-2,-2,-102,111,-2,-2,5,2,-6,-8,0,0
"10321","29",313,2,3,1,0,-217,-198,-3,-3,-216,-199,-3,-3,5,3,-1,1,0,0
"10322","29",119,7,3,1,3,72,-25,1,2,76,106,1,2,5,-2,-4,-131,0,0
"10323","29",240,1,2,1,1,-138,-185,-2,-4,159,62,2,-2,5,4,-297,-247,-4,-2
"10324","29",390,9,2,1,2,116,122,2,4,100,83,3,4,5,-4,16,39,-1,0
"10325","29",351,1,1,0,0,-247,-247,-4,-4,246,245,-4,-4,5,4,-493,-492,0,0
"10326","29",198,5,1,0,1,-155,28,-1,0,79,-150,-1,2,5,0,-234,178,0,-2
"10327","29",449,6,4,1,3,170,-12,1,1,115,-13,1,2,5,-1,55,1,0,-1
"10328","29",3,2,3,1,0,-1,-2,0,-3,-2,-3,0,-3,5,3,1,1,0,0
"10329","29",199,7,4,1,2,184,199,2,2,206,203,3,3,5,-2,-22,-4,-1,-1
"10330","29",142,5,2,1,2,156,-15,0,0,216,-195,-2,0,5,0,-60,180,2,0
"10331","29",365,5,3,1,1,-42,5,0,0,-79,6,0,-4,5,0,37,-1,0,4
"10332","29",211,7,3,1,1,20,22,-4,2,18,24,-1,2,5,-2,2,-2,-3,0
"10333","29",24,5,2,1,2,134,1,0,0,243,-238,4,4,5,0,-109,239,-4,-4
"10334","29",39,4,3,1,1,-50,-29,-1,-1,158,121,2,2,5,1,-208,-150,-3,-3
"10335","29",33,5,3,1,1,-88,75,-1,0,27,-43,0,2,5,0,-115,118,-1,-2
"10336","29",103,1,2,0,3,227,-2,4,-4,131,-98,3,4,5,4,96,96,1,-8
"10337","29",448,9,2,1,2,247,0,-4,4,79,0,2,1,5,-4,168,0,-6,3
"10338","29",299,7,4,0,1,226,18,2,2,190,-102,0,0,5,-2,36,120,2,2
"10339","29",391,7,2,1,3,161,190,4,2,81,79,0,0,5,-2,80,111,4,2
"10340","29",194,7,1,1,0,-156,30,-4,2,-239,6,-4,2,5,-2,83,24,0,0
"10341","29",416,1,4,1,0,-227,233,-4,-4,-224,204,-4,4,5,4,-3,29,0,-8
"10342","29",120,4,3,1,1,-102,-56,-1,-1,-35,-114,-1,-1,5,1,-67,58,0,0
"10343","29",453,9,4,1,2,202,-4,3,4,7,-214,3,3,5,-4,195,210,0,1
"10344","29",239,6,1,0,1,91,63,2,1,-55,-61,2,1,5,-1,146,124,0,0
"10345","29",231,4,4,1,0,-150,-135,-4,-1,5,12,-4,3,5,1,-155,-147,0,-4
"10346","29",106,7,2,1,1,80,-103,1,2,153,-66,1,1,5,-2,-73,-37,0,1
"10347","29",450,7,4,1,3,213,-1,0,2,1,179,1,2,5,-2,212,-180,-1,0
"10348","29",300,2,1,0,0,-191,65,-2,-3,43,49,1,1,5,3,-234,16,-3,-4
"10349","29",88,9,4,1,2,228,217,4,4,200,192,4,4,5,-4,28,25,0,0
"10350","29",144,1,3,1,0,-73,-240,-4,-4,-2,-245,-4,-4,5,4,-71,5,0,0
"10351","29",460,2,1,0,0,-189,14,-3,-3,116,20,-3,2,5,3,-305,-6,0,-5
"10352","29",46,1,1,0,0,-28,-209,2,-4,-1,-241,-1,-2,5,4,-27,32,3,-2
"10353","29",104,1,1,0,0,-233,-2,-4,-4,233,1,1,-3,5,4,-466,-3,-5,-1
"10354","29",452,3,3,1,1,-233,3,-4,-2,-26,9,0,0,5,2,-207,-6,-4,-2
"10355","29",234,4,3,1,3,139,42,1,-1,143,20,0,-1,5,1,-4,22,1,0
"10356","29",9,4,4,1,2,59,21,1,-1,7,9,1,-1,5,1,52,12,0,0
"10357","29",307,6,4,1,2,121,103,-1,1,49,48,0,0,5,-1,72,55,-1,1
"10358","29",303,5,3,1,2,82,-29,0,0,38,-47,2,2,5,0,44,18,-2,-2
"10359","29",13,3,4,1,1,46,-75,1,-2,29,-99,-1,-2,5,2,17,24,2,0
"10360","29",143,8,1,0,3,83,43,3,3,55,-110,3,3,5,-3,28,153,0,0
"10361","29",366,7,4,1,3,200,-33,3,2,159,-69,2,2,5,-2,41,36,1,0
"10362","29",212,3,1,0,1,-98,-148,4,-2,-201,-148,4,-3,5,2,103,0,0,1
"10363","29",107,3,2,1,3,121,99,2,-2,106,-100,2,1,5,2,15,199,0,-3
"10364","29",451,2,1,0,0,-214,-183,-3,-3,-177,-197,-4,-4,5,3,-37,14,1,1
"10365","29",301,4,4,1,1,1,35,0,-1,-51,1,-1,0,5,1,52,34,1,-1
"10366","29",89,1,3,1,0,-245,3,-4,-4,-243,3,-3,-4,5,4,-2,0,-1,0
"10367","29",145,5,1,0,1,1,3,0,0,-36,-70,0,0,5,0,37,73,0,0
"10368","29",302,3,1,0,0,-126,-32,-3,-2,210,48,-2,-2,5,2,-336,-80,-1,0
"10369","29",392,3,1,0,0,-161,127,-2,-2,-162,100,-2,-3,5,2,1,27,0,1
"10370","29",195,1,1,0,1,-226,234,4,-4,19,-27,2,0,5,4,-245,261,2,-4
"10371","29",417,7,2,1,2,109,131,2,2,181,45,1,1,5,-2,-72,86,1,1
"10372","29",121,1,1,0,0,-208,44,-4,-4,223,7,-2,-4,5,4,-431,37,-2,0
"10373","29",454,6,4,1,3,98,1,1,1,18,-1,1,1,5,-1,80,2,0,0
"10374","29",308,2,4,1,0,-171,-172,-4,-3,165,137,3,4,5,3,-336,-309,-7,-7
"10375","29",459,1,3,0,1,-146,-209,3,-4,-47,-184,3,-4,5,4,-99,-25,0,0
"10376","29",130,9,1,0,3,205,30,4,4,90,23,4,4,5,-4,115,7,0,0
"10377","29",127,1,1,1,0,-215,3,-4,-4,-2,-1,2,-3,5,4,-213,4,-6,-1
"10378","29",367,5,3,0,1,-169,-148,1,0,-126,-94,2,-1,5,0,-43,-54,-1,1
"10379","29",213,6,2,1,1,-2,65,0,1,2,42,0,0,5,-1,-4,23,0,1
"10380","29",456,1,1,0,0,-127,-165,-2,-4,123,-42,1,-2,5,4,-250,-123,-3,-2
"10381","29",461,4,4,1,2,67,10,0,-1,77,100,1,1,5,1,-10,-90,-1,-2
"10382","29",306,5,3,1,3,146,108,1,0,125,150,1,0,5,0,21,-42,0,0
"10383","29",457,5,3,0,1,136,102,0,0,6,-204,1,0,5,0,130,306,-1,0
"10384","29",146,2,2,0,0,-177,-169,-3,-3,-174,-167,-3,-3,5,3,-3,-2,0,0
"10385","29",235,6,3,1,0,34,2,1,1,51,51,1,1,5,-1,-17,-49,0,0
"10386","29",90,2,4,1,0,-241,13,-3,-3,-239,7,-4,-4,5,3,-2,6,1,1
"10387","29",126,4,2,0,2,121,227,-1,-1,165,232,-1,-1,5,1,-44,-5,0,0
"10388","29",304,7,2,1,2,197,-2,2,2,18,-112,2,4,5,-2,179,110,0,-2
"10389","29",394,5,3,1,0,-145,82,4,0,-234,243,-4,-4,5,0,89,-161,8,4
"10390","29",455,7,2,1,2,103,-1,1,2,138,-5,0,2,5,-2,-35,4,1,0
"10391","29",163,4,3,1,1,131,-56,1,-1,37,65,1,1,5,1,94,-121,0,-2
"10392","29",237,7,2,1,2,178,27,0,2,113,1,0,1,5,-2,65,26,0,1
"10393","29",131,8,4,1,3,163,-17,-2,3,103,-36,-1,3,5,-3,60,19,-1,0
"10394","29",164,7,2,1,2,215,-57,3,2,159,-182,2,1,5,-2,56,125,1,1
"10395","29",368,9,3,1,3,-146,150,4,4,-152,93,4,4,5,-4,6,57,0,0
"10396","29",132,7,4,1,1,11,-20,0,2,20,111,1,2,5,-2,-9,-131,-1,0
"10397","29",93,5,1,0,1,-122,89,-2,0,-93,65,-2,0,5,0,-29,24,0,0
"10398","29",161,3,2,1,2,138,142,-1,-2,96,110,1,-2,5,2,42,32,-2,0
"10399","29",393,1,1,0,0,-246,-1,-4,-4,-92,-34,-4,-4,5,4,-154,33,0,0
"10400","29",458,2,1,0,1,-63,-69,0,-3,75,80,-1,-2,5,3,-138,-149,1,-1
"10401","29",122,1,1,1,0,-247,-248,-4,-4,221,216,4,4,5,4,-468,-464,-8,-8
"10402","29",236,5,1,0,1,-16,-17,0,0,-17,-7,0,0,5,0,1,-10,0,0
"10403","29",91,5,2,1,3,151,3,0,0,32,3,1,0,5,0,119,0,-1,0
"10404","29",148,1,1,0,1,-186,-72,2,-4,-187,-82,2,-4,5,4,1,10,0,0
"10405","29",305,9,4,1,3,227,240,4,4,244,225,4,4,5,-4,-17,15,0,0
"10406","29",1,4,1,0,1,-156,-107,-2,-1,-91,-30,-2,-1,5,1,-65,-77,0,0
"10407","29",128,6,1,0,3,142,1,1,1,142,1,1,1,5,-1,0,0,0,0
"10408","29",149,5,3,1,1,0,-1,-3,0,242,6,-3,1,5,0,-242,-7,0,-1
"10409","29",214,9,1,0,3,215,5,4,4,219,6,4,4,5,-4,-4,-1,0,0
"10410","29",10,4,3,0,1,5,-7,-1,-1,-173,-1,1,-2,5,1,178,-6,-2,1
"10411","29",369,3,4,1,0,-171,1,-4,-2,42,-2,0,0,5,2,-213,3,-4,-2
"10412","29",125,5,4,1,0,-175,-31,-1,0,-178,-31,-3,-1,5,0,3,0,2,1
"10413","29",94,3,4,1,1,54,-37,4,-2,130,-113,2,2,5,2,-76,76,2,-4
"10414","29",147,7,2,1,3,103,32,2,2,148,86,1,1,5,-2,-45,-54,1,1
"10415","29",162,7,3,1,3,30,0,-1,2,118,132,4,4,5,-2,-88,-132,-5,-2
"10416","29",216,4,3,1,1,-82,-61,1,-1,77,-49,1,-1,5,1,-159,-12,0,0
"10417","29",232,1,1,0,0,-246,-245,-4,-4,-244,-244,-4,-4,5,4,-2,-1,0,0
"10418","29",123,3,4,1,2,97,-34,-2,-2,-18,-23,-2,-2,5,2,115,-11,0,0
"10419","29",370,9,1,0,3,241,-13,4,4,-238,-16,-4,-4,5,-4,479,3,8,8
"10420","29",233,6,2,1,2,122,109,1,1,132,77,1,1,5,-1,-10,32,0,0
"10421","29",96,2,1,0,0,-213,-27,-3,-3,-148,-34,-2,-2,5,3,-65,7,-1,-1
"10422","29",124,6,1,0,3,75,-250,0,1,248,0,1,2,5,-1,-173,-250,-1,-1
"10423","29",371,2,3,0,0,-233,-122,-3,-3,0,-158,-2,-2,5,3,-233,36,-1,-1
"10424","29",129,7,4,1,1,191,1,2,2,166,-2,2,2,5,-2,25,3,0,0
"10425","29",15,6,4,1,3,-37,11,2,1,-30,12,2,1,5,-1,-7,-1,0,0
"10426","29",215,2,1,0,0,-154,52,-2,-3,-133,52,-2,-3,5,3,-21,0,0,0
"10427","29",158,4,3,1,0,27,-16,-4,-1,-136,-23,-2,-1,5,1,163,7,-2,0
"10428","29",37,1,1,0,0,-224,105,-4,-4,-218,29,-4,-4,5,4,-6,76,0,0
"10429","29",373,1,3,1,0,-232,-232,-2,-4,-190,-236,0,-4,5,4,-42,4,-2,0
"10430","29",95,7,4,1,2,-1,-156,2,2,39,6,1,1,5,-2,-40,-162,1,1
"10431","29",151,1,2,1,1,10,11,0,-4,9,10,0,-4,5,4,1,1,0,0
"10432","29",155,9,2,1,1,1,1,2,4,239,237,4,4,5,-4,-238,-236,-2,0
"10433","29",92,6,4,1,2,1,0,1,1,1,0,0,0,5,-1,0,0,1,1
"10434","29",220,1,4,1,2,178,165,-4,-4,150,142,-3,-3,5,4,28,23,-1,-1
"10435","29",152,1,1,0,0,-90,-7,-3,-4,-19,-1,-2,-4,5,4,-71,-6,-1,0
"10436","29",156,4,2,0,1,-54,-1,-1,-1,-6,-2,0,0,5,1,-48,1,-1,-1
"10437","29",97,2,1,0,1,-226,28,3,-3,80,17,3,-3,5,3,-306,11,0,0
"10438","29",160,6,2,1,0,-95,38,-4,1,-185,24,-4,2,5,-1,90,14,0,-1
"10439","29",372,1,3,0,0,-236,-242,-4,-4,2,1,-4,-4,5,4,-238,-243,0,0
"10440","29",219,5,4,1,3,249,3,4,0,248,2,1,0,5,0,1,1,3,0
"10441","29",150,5,3,0,1,4,4,0,0,161,3,1,0,5,0,-157,1,-1,0
"10442","29",154,6,4,1,3,117,-7,1,1,145,-111,1,1,5,-1,-28,104,0,0
"10443","29",22,4,3,1,1,-21,8,-1,-1,-125,2,-1,-1,5,1,104,6,0,0
"10444","29",159,1,3,1,2,-229,3,-4,-4,247,-7,3,4,5,4,-476,10,-7,-8
"10445","29",227,8,3,0,3,64,-10,2,3,129,27,2,2,5,-3,-65,-37,0,1
"10446","29",217,4,4,1,2,76,35,1,-1,77,28,1,-1,5,1,-1,7,0,0
"10447","29",378,4,4,1,1,-122,0,-1,-1,-106,8,-2,-1,5,1,-16,-8,1,0
"10448","29",16,1,1,0,0,-228,21,-2,-4,76,10,2,-2,5,4,-304,11,-4,-2
"10449","29",228,9,4,1,2,22,-195,4,4,68,119,3,3,5,-4,-46,-314,1,1
"10450","29",218,8,4,1,3,156,62,4,3,153,74,4,3,5,-3,3,-12,0,0
"10451","29",221,4,4,1,1,5,-4,-1,-1,5,4,4,0,5,1,0,-8,-5,-1
"10452","29",153,8,1,0,3,-105,-16,0,3,-76,-21,1,1,5,-3,-29,5,-1,2
"10453","29",376,4,4,1,1,6,-156,-1,-1,74,-165,0,-1,5,1,-68,9,-1,0
"10454","29",222,1,1,0,0,-246,2,-4,-4,-239,-11,-4,-4,5,4,-7,13,0,0
"10455","29",226,1,1,1,0,-148,1,-2,-4,240,0,3,-4,5,4,-388,1,-5,0
"10456","29",377,1,1,0,0,-245,9,-4,-4,-243,7,-4,-4,5,4,-2,2,0,0
"10457","29",223,5,1,0,1,0,-1,0,0,-1,1,0,0,5,0,1,-2,0,0
"10458","29",157,1,3,1,2,-50,-155,-4,-4,135,97,-2,0,5,4,-185,-252,-2,-4
"10459","29",374,8,4,1,2,166,118,3,3,192,145,3,3,5,-3,-26,-27,0,0
"10460","29",379,1,3,0,1,-69,-116,2,-4,-60,-117,0,0,5,4,-9,1,2,-4
"10461","29",224,7,2,1,2,170,211,2,2,152,69,2,2,5,-2,18,142,0,0
"10462","29",380,2,4,1,1,32,-22,3,-3,-215,-45,3,-4,5,3,247,23,0,1
"10463","29",375,4,3,1,1,-12,11,-1,-1,-1,1,0,0,5,1,-11,10,-1,-1
"10464","29",383,5,4,1,1,-2,-1,0,0,-2,-4,0,0,5,0,0,3,0,0
"10465","29",225,9,2,1,2,215,4,4,4,6,223,3,4,5,-4,209,-219,1,0
"10466","29",381,8,2,1,2,213,159,3,3,202,225,4,4,5,-3,11,-66,-1,-1
"10467","29",38,9,4,1,3,209,-100,4,4,230,-56,4,4,5,-4,-21,-44,0,0
"10468","29",385,6,4,1,1,86,16,1,1,76,119,2,0,5,-1,10,-103,-1,1
"10469","29",384,1,1,0,0,-234,1,-4,-4,2,33,-2,-3,5,4,-236,-32,-2,-1
"10470","29",382,5,4,1,2,16,-5,0,0,69,4,1,2,5,0,-53,-9,-1,-2
"10471","29",229,6,1,0,1,-43,-100,-1,1,-128,141,-2,-2,5,-1,85,-241,1,3
"10472","29",23,9,1,0,3,212,211,4,4,206,194,4,4,5,-4,6,17,0,0
"10473","3",74,3,3,1,0,-171,-53,-3,-2,-244,0,-4,-4,2,-1,73,-53,1,2
"10474","3",356,4,4,1,1,43,-5,1,-1,249,0,3,3,2,-2,-206,-5,-2,-4
"10475","3",331,1,1,0,0,-69,147,-4,-4,221,226,-1,-1,2,1,-290,-79,-3,-3
"10476","3",43,5,3,0,0,-24,-1,0,0,155,5,0,0,2,-3,-179,-6,0,0
"10477","3",75,3,4,0,2,210,30,2,-2,238,237,3,-4,2,-1,-28,-207,-1,2
"10478","3",7,7,1,0,3,92,65,1,2,-66,87,2,1,2,-5,158,-22,-1,1
"10479","3",467,5,1,1,3,-34,28,4,0,57,-34,4,-3,2,-3,-91,62,0,3
"10480","3",76,5,4,1,3,17,1,0,0,8,1,0,0,2,-3,9,0,0,0
"10481","3",72,4,1,1,0,17,15,0,-1,152,170,2,2,2,-2,-135,-155,-2,-3
"10482","3",70,1,2,1,2,-68,-26,4,-4,-67,59,-2,-4,2,1,-1,-85,6,0
"10483","3",77,4,3,1,1,-76,5,1,-1,-210,5,-1,-1,2,-2,134,0,2,0
"10484","3",473,5,3,0,0,-135,-29,0,0,-228,-16,-2,-2,2,-3,93,-13,2,2
"10485","3",429,1,2,0,0,-235,-232,-4,-4,-2,-200,0,-4,2,1,-233,-32,-4,0
"10486","3",49,7,4,1,1,118,114,2,2,82,37,0,0,2,-5,36,77,2,2
"10487","3",78,2,4,0,0,-234,1,-3,-3,-242,-6,-3,-3,2,0,8,7,0,0
"10488","3",332,2,1,0,0,-242,98,-3,-3,-242,74,-3,-2,2,0,0,24,0,-1
"10489","3",470,4,1,0,1,-66,13,-1,-1,85,14,1,2,2,-2,-151,-1,-2,-3
"10490","3",357,1,4,0,2,-233,-53,-4,-4,90,40,4,2,2,1,-323,-93,-8,-6
"10491","3",71,4,3,1,1,-85,15,-1,-1,30,31,-1,0,2,-2,-115,-16,0,-1
"10492","3",430,5,2,0,1,30,-41,0,0,104,-102,1,1,2,-3,-74,61,-1,-1
"10493","3",50,4,2,1,1,32,-33,0,-1,56,-114,0,-1,2,-2,-24,81,0,0
"10494","3",330,5,2,0,2,54,1,1,0,213,134,1,1,2,-3,-159,-133,0,-1
"10495","3",73,1,4,1,2,-86,95,-4,-4,113,141,2,-1,2,1,-199,-46,-6,-3
"10496","3",431,5,3,1,0,17,20,0,0,-2,2,0,0,2,-3,19,18,0,0
"10497","3",465,9,4,1,3,-218,14,4,4,22,-223,4,4,2,-7,-240,237,0,0
"10498","3",80,2,4,1,3,70,2,3,-3,247,0,3,-2,2,0,-177,2,0,-1
"10499","3",466,4,3,0,0,-130,-105,-1,-1,82,-106,2,2,2,-2,-212,1,-3,-3
"10500","3",474,1,1,1,0,-2,-93,-4,-4,0,-85,-4,-4,2,1,-2,-8,0,0
"10501","3",66,4,1,0,1,-232,1,0,-1,233,1,3,1,2,-2,-465,0,-3,-2
"10502","3",81,1,1,0,0,-130,46,-4,-4,-80,51,-3,-3,2,1,-50,-5,-1,-1
"10503","3",463,9,4,1,3,237,16,2,4,-219,-9,1,0,2,-7,456,25,1,4
"10504","3",79,1,4,0,2,-201,-205,-4,-4,-180,166,-2,-2,2,1,-21,-371,-2,-2
"10505","3",468,6,1,1,3,98,-91,1,1,55,81,1,1,2,-4,43,-172,0,0
"10506","3",471,5,3,1,2,64,-117,0,0,-124,-64,0,3,2,-3,188,-53,0,-3
"10507","3",358,1,4,1,2,-180,77,-4,-4,-246,120,-4,-4,2,1,66,-43,0,0
"10508","3",48,1,3,1,0,35,-34,-4,-4,75,-78,-4,-4,2,1,-40,44,0,0
"10509","3",469,1,4,1,0,-138,3,-2,-4,-175,32,-2,-4,2,1,37,-29,0,0
"10510","3",51,8,4,1,1,-101,-124,2,3,-121,-74,1,1,2,-6,20,-50,1,2
"10511","3",359,7,4,1,3,-72,-60,2,2,-58,89,2,2,2,-5,-14,-149,0,0
"10512","3",335,7,2,1,1,11,8,3,2,100,42,1,1,2,-5,-89,-34,2,1
"10513","3",462,9,3,0,3,-2,132,4,4,212,212,-4,-4,2,-7,-214,-80,8,8
"10514","3",36,3,3,1,3,-168,197,3,-2,-143,189,3,3,2,-1,-25,8,0,-5
"10515","3",206,2,4,1,0,-173,-44,1,-3,182,192,0,2,2,0,-355,-236,1,-5
"10516","3",5,2,2,0,2,-237,8,-2,-3,-245,132,-3,-4,2,0,8,-124,1,1
"10517","3",475,5,3,1,3,95,-137,0,0,124,-154,1,0,2,-3,-29,17,-1,0
"10518","3",333,4,4,1,1,-39,-137,-1,-1,-70,-138,-1,-1,2,-2,31,1,0,0
"10519","3",82,1,4,1,2,-238,-12,-4,-4,-98,-124,4,4,2,1,-140,112,-8,-8
"10520","3",464,6,1,0,1,59,17,0,1,-1,57,0,1,2,-4,60,-40,0,0
"10521","3",8,4,3,1,1,-62,-103,-3,-1,51,-92,-2,-2,2,-2,-113,-11,-1,1
"10522","3",334,1,4,1,0,-241,103,-4,-4,-239,107,-4,-4,2,1,-2,-4,0,0
"10523","3",472,1,1,0,0,-228,46,-4,-4,-223,137,-4,-4,2,1,-5,-91,0,0
"10524","3",4,4,3,1,1,21,-2,-1,-1,133,-50,2,2,2,-2,-112,48,-3,-3
"10525","3",69,1,4,0,1,81,50,-4,-4,-24,75,-2,-4,2,1,105,-25,-2,0
"10526","3",432,5,2,0,1,9,1,0,0,24,-33,0,0,2,-3,-15,34,0,0
"10527","3",397,9,4,1,3,169,-99,4,4,84,-162,3,3,2,-7,85,63,1,1
"10528","3",408,2,1,0,0,-240,-3,-1,-3,-132,6,1,-1,2,0,-108,-9,-2,-2
"10529","3",352,5,2,0,1,2,-12,0,0,3,-12,0,0,2,-3,-1,0,0,0
"10530","3",398,1,4,1,2,-238,229,-4,-4,128,124,2,2,2,1,-366,105,-6,-6
"10531","3",67,3,1,0,0,-27,20,-2,-2,134,-125,3,3,2,-1,-161,145,-5,-5
"10532","3",207,4,1,0,0,-241,42,-3,-1,-1,248,4,4,2,-2,-240,-206,-7,-5
"10533","3",434,5,4,1,3,7,-242,0,0,-1,3,0,0,2,-3,8,-245,0,0
"10534","3",476,4,3,1,0,-127,-169,-1,-1,182,181,-1,-1,2,-2,-309,-350,0,0
"10535","3",68,2,4,1,0,138,9,0,-3,198,11,0,-2,2,0,-60,-2,0,-1
"10536","3",83,6,1,1,3,110,-129,2,1,136,-129,2,1,2,-4,-26,0,0,0
"10537","3",435,4,4,1,1,155,-83,0,-1,-1,-6,0,0,2,-2,156,-77,0,-1
"10538","3",407,7,2,0,2,124,97,1,2,21,46,1,3,2,-5,103,51,0,-1
"10539","3",47,6,4,1,3,202,18,2,1,2,-2,1,2,2,-4,200,20,1,-1
"10540","3",52,2,3,1,0,-212,0,-3,-3,-2,-156,-2,-1,2,0,-210,156,-1,-2
"10541","3",40,2,1,0,2,-168,48,-3,-3,233,38,4,0,2,0,-401,10,-7,-3
"10542","3",336,3,4,1,3,201,139,2,-2,183,159,3,-3,2,-1,18,-20,-1,1
"10543","3",433,2,1,0,0,-149,-149,2,-3,189,172,3,-3,2,0,-338,-321,-1,0
"10544","3",360,1,3,1,0,-85,-76,-2,-4,80,99,1,-4,2,1,-165,-175,-3,0
"10545","3",244,1,4,0,2,-164,-181,0,-4,48,-59,1,-1,2,1,-212,-122,-1,-3
"10546","3",353,5,2,0,2,242,123,-3,0,227,-129,-3,0,2,-3,15,252,0,0
"10547","3",399,6,4,0,3,103,1,1,1,130,9,1,1,2,-4,-27,-8,0,0
"10548","3",361,1,1,0,0,-248,2,3,-4,1,-249,3,-1,2,1,-249,251,0,-3
"10549","3",208,4,4,1,2,143,-7,-1,-1,216,18,2,2,2,-2,-73,-25,-3,-3
"10550","3",354,3,1,1,0,-38,116,-1,-2,171,100,2,3,2,-1,-209,16,-3,-5
"10551","3",350,4,4,0,1,-7,-240,-1,-1,8,-244,4,0,2,-2,-15,4,-5,-1
"10552","3",84,4,4,1,3,-129,3,-1,-1,-194,2,-2,-1,2,-2,65,1,1,0
"10553","3",178,5,1,0,1,-3,4,0,0,0,-3,0,0,2,-3,-3,7,0,0
"10554","3",436,1,4,1,3,13,-20,-1,-4,-19,11,3,-2,2,1,32,-31,-4,-2
"10555","3",255,6,3,1,1,119,81,1,1,63,-111,0,0,2,-4,56,192,1,1
"10556","3",179,5,1,1,1,-1,-3,0,0,-1,1,2,1,2,-3,0,-4,-2,-1
"10557","3",349,7,4,1,1,-76,-62,0,2,98,-66,1,2,2,-5,-174,4,-1,0
"10558","3",409,3,4,0,2,-67,-63,2,-2,114,112,2,1,2,-1,-181,-175,0,-3
"10559","3",337,8,2,0,3,-129,13,3,3,240,-14,4,4,2,-6,-369,27,-1,-1
"10560","3",54,5,4,1,1,9,-18,-1,0,14,-14,0,0,2,-3,-5,-4,-1,0
"10561","3",35,4,1,1,3,20,188,3,-1,144,183,3,-1,2,-2,-124,5,0,0
"10562","3",245,1,1,0,0,-221,48,-3,-4,-137,9,-2,-3,2,1,-84,39,-1,-1
"10563","3",59,4,1,0,0,-182,36,-1,-1,-15,-94,1,1,2,-2,-167,130,-2,-2
"10564","3",55,6,4,1,1,89,0,0,1,81,-7,2,1,2,-4,8,7,-2,0
"10565","3",254,5,2,0,3,-3,-6,0,0,184,-210,-3,-1,2,-3,-187,204,3,1
"10566","3",6,2,4,0,2,-238,1,-3,-3,-60,-1,-4,-4,2,0,-178,2,1,1
"10567","3",355,2,2,1,2,-167,70,-4,-3,-32,46,-2,-3,2,0,-135,24,-2,0
"10568","3",363,8,3,1,3,249,1,3,3,-229,2,-3,-3,2,-6,478,-1,6,6
"10569","3",85,1,2,0,2,-106,-116,-4,-4,-86,-93,-4,-4,2,1,-20,-23,0,0
"10570","3",53,7,4,1,3,-4,65,2,2,223,0,2,2,2,-5,-227,65,0,0
"10571","3",400,7,4,1,2,20,-23,2,2,161,27,2,2,2,-5,-141,-50,0,0
"10572","3",256,6,3,1,1,161,0,1,1,1,0,0,0,2,-4,160,0,1,1
"10573","3",18,5,3,0,1,-91,-41,1,0,52,25,1,0,2,-3,-143,-66,0,0
"10574","3",438,5,4,1,3,141,1,4,0,110,1,4,1,2,-3,31,0,0,-1
"10575","3",41,6,2,0,3,40,69,2,1,51,68,2,1,2,-4,-11,1,0,0
"10576","3",257,1,1,0,0,-249,-34,-4,-4,197,57,-4,-4,2,1,-446,-91,0,0
"10577","3",180,5,2,0,2,17,5,-1,0,1,1,-1,0,2,-3,16,4,0,0
"10578","3",362,7,4,1,3,193,-113,4,2,-119,108,3,2,2,-5,312,-221,1,0
"10579","3",209,3,4,1,3,-168,-3,0,-2,235,0,4,4,2,-1,-403,-3,-4,-6
"10580","3",242,3,4,1,2,-45,-2,2,-2,220,127,3,2,2,-1,-265,-129,-1,-4
"10581","3",351,1,1,0,0,-218,-224,-4,-4,126,132,-4,-4,2,1,-344,-356,0,0
"10582","3",21,3,4,0,2,-100,-106,-2,-2,-132,-105,-3,-3,2,-1,32,-1,1,1
"10583","3",133,1,2,0,1,111,-67,0,-4,211,42,4,0,2,1,-100,-109,-4,-4
"10584","3",437,3,1,0,0,-198,3,-2,-2,-112,-1,-2,-2,2,-1,-86,4,0,0
"10585","3",248,6,4,0,3,67,48,0,1,199,194,2,0,2,-4,-132,-146,-2,1
"10586","3",86,6,4,1,3,65,-2,1,1,129,3,1,-1,2,-4,-64,-5,0,2
"10587","3",134,1,2,1,2,-143,-4,-2,-4,-130,-7,0,-3,2,1,-13,3,-2,-1
"10588","3",401,2,2,0,1,-119,26,1,-3,159,10,0,-2,2,0,-278,16,1,-1
"10589","3",249,1,3,1,0,-133,-148,-2,-4,124,-85,2,-4,2,1,-257,-63,-4,0
"10590","3",241,3,4,1,2,27,14,1,-2,187,175,2,0,2,-1,-160,-161,-1,-2
"10591","3",402,4,3,1,0,-246,1,-1,-1,-234,0,-3,-3,2,-2,-12,1,2,2
"10592","3",246,9,4,1,3,189,2,3,4,121,2,2,3,2,-7,68,0,1,1
"10593","3",321,1,1,1,0,-121,-110,-4,-4,-1,-2,0,0,2,1,-120,-108,-4,-4
"10594","3",56,3,3,1,1,42,-126,-2,-2,51,-122,-2,-1,2,-1,-9,-4,0,-1
"10595","3",243,5,2,0,2,-249,-51,-2,0,-230,-248,-2,0,2,-3,-19,197,0,0
"10596","3",60,8,1,1,3,209,0,3,3,237,-9,3,3,2,-6,-28,9,0,0
"10597","3",182,8,4,1,3,120,-31,2,3,1,-164,2,1,2,-6,119,133,0,2
"10598","3",364,5,3,1,1,-4,-78,0,0,-56,4,0,-1,2,-3,52,-82,0,1
"10599","3",210,3,4,1,2,-4,1,0,-2,24,-111,1,0,2,-1,-28,112,-1,-2
"10600","3",171,5,1,1,1,-10,14,0,0,35,17,0,0,2,-3,-45,-3,0,0
"10601","3",168,6,1,0,3,97,-84,0,1,87,-70,-1,1,2,-4,10,-14,1,0
"10602","3",338,1,3,1,2,-218,-225,-4,-4,-222,-230,-4,-4,2,1,4,5,0,0
"10603","3",87,6,4,1,3,0,-2,2,1,249,0,1,1,2,-4,-249,-2,1,0
"10604","3",439,6,2,1,1,1,0,1,1,-4,2,0,0,2,-4,5,-2,1,1
"10605","3",410,2,1,0,0,-192,-24,-2,-3,-216,-17,-3,-4,2,0,24,-7,1,1
"10606","3",258,1,3,0,0,46,1,-4,-4,-103,1,-4,-4,2,1,149,0,0,0
"10607","3",181,6,4,1,3,-77,53,1,1,209,50,0,0,2,-4,-286,3,1,1
"10608","3",411,9,2,1,2,242,234,4,4,219,221,4,4,2,-7,23,13,0,0
"10609","3",259,2,3,1,1,-57,1,3,-3,55,118,1,2,2,0,-112,-117,2,-5
"10610","3",170,1,2,0,0,-241,-240,-4,-4,11,16,0,0,2,1,-252,-256,-4,-4
"10611","3",202,4,1,0,1,-8,9,-2,-1,-20,56,-2,1,2,-2,12,-47,0,-2
"10612","3",2,5,4,1,1,-88,-54,0,0,70,-91,1,1,2,-3,-158,37,-1,-1
"10613","3",61,1,1,0,3,245,3,4,-4,-95,2,4,-4,2,1,340,1,0,0
"10614","3",58,3,4,1,1,-246,-3,1,-2,247,0,4,4,2,-1,-493,-3,-3,-6
"10615","3",365,1,3,1,1,-220,-2,0,-4,-249,6,0,-4,2,1,29,-8,0,0
"10616","3",211,4,3,1,1,-43,-32,-4,-1,145,170,-2,2,2,-2,-188,-202,-2,-3
"10617","3",135,1,1,1,1,-229,206,-4,-4,-230,122,-3,-3,2,1,1,84,-1,-1
"10618","3",204,5,3,1,1,79,-35,0,0,102,-18,0,0,2,-3,-23,-17,0,0
"10619","3",25,3,4,1,2,-1,-10,-1,-2,-4,-4,-1,-1,2,-1,3,-6,0,-1
"10620","3",173,5,4,1,3,-212,6,0,0,225,5,0,0,2,-3,-437,1,0,0
"10621","3",403,4,1,0,0,-2,-3,0,-1,-11,-26,1,-1,2,-2,9,23,-1,0
"10622","3",247,4,3,0,0,-190,-10,-1,-1,212,-12,1,1,2,-2,-402,2,-2,-2
"10623","3",322,7,4,1,3,163,-175,2,2,106,-79,1,1,2,-5,57,-96,1,1
"10624","3",57,1,4,1,1,47,-243,1,-4,-1,-238,0,-4,2,1,48,-5,1,0
"10625","3",412,9,1,0,0,-244,-38,-4,4,-239,-117,4,4,2,-7,-5,79,-8,0
"10626","3",26,1,1,0,0,-210,17,-4,-4,-174,31,-4,-4,2,1,-36,-14,0,0
"10627","3",183,5,4,0,1,-121,-54,0,0,98,145,1,0,2,-3,-219,-199,-1,0
"10628","3",203,9,4,1,3,-15,-35,4,4,-12,-23,4,4,2,-7,-3,-12,0,0
"10629","3",20,9,3,1,0,-78,-67,-3,4,237,232,4,4,2,-7,-315,-299,-7,0
"10630","3",172,5,2,1,3,-148,-44,0,0,170,157,3,3,2,-3,-318,-201,-3,-3
"10631","3",169,1,3,1,0,-201,223,-4,-4,-240,218,-4,-4,2,1,39,5,0,0
"10632","3",339,1,3,1,1,153,25,1,-4,-68,-62,-4,-4,2,1,221,87,5,0
"10633","3",88,1,4,1,2,-229,-14,-4,-4,213,-220,4,4,2,1,-442,206,-8,-8
"10634","3",44,1,2,0,2,-88,38,0,-4,154,-93,0,-2,2,1,-242,131,0,-2
"10635","3",367,4,3,1,1,-15,-13,2,-1,-210,-80,2,-1,2,-2,195,67,0,0
"10636","3",213,6,2,1,1,-1,-2,0,1,40,3,-1,-1,2,-4,-41,-5,1,2
"10637","3",137,3,1,0,1,-188,66,-3,-2,-205,-80,-2,0,2,-1,17,146,-1,-2
"10638","3",404,4,1,0,1,57,-51,-1,-1,58,-59,1,1,2,-2,-1,8,-2,-2
"10639","3",251,5,3,1,1,-54,-17,-4,0,3,9,0,-3,2,-3,-57,-26,-4,3
"10640","3",345,4,1,0,0,-169,169,-4,-1,226,-216,-1,0,2,-2,-395,385,-3,-1
"10641","3",341,9,1,1,3,244,-10,4,4,246,-23,4,4,2,-7,-2,13,0,0
"10642","3",418,1,2,0,2,53,-30,-1,-4,62,33,1,-4,2,1,-9,-63,-2,0
"10643","3",62,9,2,0,3,-234,-6,-4,4,232,224,4,4,2,-7,-466,-230,-8,0
"10644","3",122,9,1,0,0,180,201,4,4,-77,-42,0,0,2,-7,257,243,4,4
"10645","3",366,7,4,0,3,108,19,1,2,104,-69,1,1,2,-5,4,88,0,1
"10646","3",212,1,1,1,1,-221,30,0,-4,-98,48,0,0,2,1,-123,-18,0,-4
"10647","3",136,1,1,0,0,-249,246,-4,-4,78,-56,-4,-3,2,1,-327,302,0,-1
"10648","3",205,5,1,1,2,0,0,2,0,239,0,4,3,2,-3,-239,0,-2,-3
"10649","3",250,6,1,0,3,57,27,1,1,85,26,1,1,2,-4,-28,1,0,0
"10650","3",174,5,4,1,3,77,35,1,0,145,26,1,0,2,-3,-68,9,0,0
"10651","3",167,7,1,0,3,-92,145,2,2,-141,75,2,2,2,-5,49,70,0,0
"10652","3",340,5,1,0,1,-77,-38,0,0,65,15,0,0,2,-3,-142,-53,0,0
"10653","3",9,4,4,1,2,14,140,-1,-1,-143,89,-2,-3,2,-2,157,51,1,2
"10654","3",32,5,1,0,1,-2,5,0,0,144,-102,4,-4,2,-3,-146,107,-4,4
"10655","3",413,3,1,1,1,-224,-13,-2,-2,-246,0,-4,-4,2,-1,22,-13,2,2
"10656","3",260,2,3,1,0,-210,-218,-3,-3,-218,-213,-2,-2,2,0,8,-5,-1,-1
"10657","3",184,4,3,1,3,98,2,1,-1,98,2,0,1,2,-2,0,0,1,-2
"10658","3",406,7,2,1,2,-31,-32,1,2,193,46,-2,1,2,-5,-224,-78,3,1
"10659","3",200,2,3,1,0,-53,12,-3,-3,-226,-36,-4,-4,2,0,173,48,1,1
"10660","3",347,8,1,1,3,194,-81,2,3,158,-97,2,2,2,-6,36,16,0,1
"10661","3",17,1,3,1,0,26,0,-1,-4,163,138,-1,-4,2,1,-137,-138,0,0
"10662","3",34,3,4,0,2,-120,56,-2,-2,-47,25,-3,-2,2,-1,-73,31,1,0
"10663","3",89,1,3,1,0,-244,0,0,-4,-248,3,-4,-3,2,1,4,-3,4,-1
"10664","3",440,4,3,1,0,-18,1,-1,-1,-48,2,-3,-3,2,-2,30,-1,2,2
"10665","3",368,1,3,0,3,-102,-112,-4,-4,-149,111,4,4,2,1,47,-223,-8,-8
"10666","3",214,9,1,1,3,209,-4,3,4,212,4,3,4,2,-7,-3,-8,0,0
"10667","3",138,4,3,1,1,122,-25,-1,-1,154,-42,1,1,2,-2,-32,17,-2,-2
"10668","3",405,5,4,1,1,-87,82,-2,0,70,70,0,0,2,-3,-157,12,-2,0
"10669","3",252,4,4,1,1,-129,-80,-2,-1,142,-91,1,1,2,-2,-271,11,-3,-2
"10670","3",346,7,3,1,0,-245,-81,-3,2,232,17,0,3,2,-5,-477,-98,-3,-1
"10671","3",342,4,3,1,1,-100,-46,0,-1,-158,33,-1,-3,2,-2,58,-79,1,2
"10672","3",419,6,4,1,3,9,7,-1,1,56,70,2,1,2,-4,-47,-63,-3,0
"10673","3",63,5,4,0,1,-1,4,0,0,122,4,1,1,2,-3,-123,0,-1,-1
"10674","3",123,2,4,0,2,-171,37,-3,-3,-76,-45,-2,-3,2,0,-95,82,-1,0
"10675","3",415,4,2,1,2,6,-7,0,-1,124,135,0,1,2,-2,-118,-142,0,-2
"10676","3",262,7,4,1,3,93,13,1,2,61,37,1,1,2,-5,32,-24,0,1
"10677","3",186,2,2,1,2,-70,-42,0,-3,-8,-15,0,-2,2,0,-62,-27,0,-1
"10678","3",287,9,4,0,3,248,-3,4,4,12,-6,3,-4,2,-7,236,3,1,8
"10679","3",283,6,1,0,1,-122,-91,-3,1,-112,-103,-2,1,2,-4,-10,12,-1,0
"10680","3",175,6,4,1,1,13,-9,0,1,-5,64,1,-1,2,-4,18,-73,-1,2
"10681","3",328,6,3,1,1,11,6,1,1,40,13,1,1,2,-4,-29,-7,0,0
"10682","3",324,4,2,1,0,-129,-3,-1,-1,-210,0,-3,-3,2,-2,81,-3,2,2
"10683","3",90,1,4,0,0,-227,29,-4,-4,226,19,4,4,2,1,-453,10,-8,-8
"10684","3",320,3,2,0,2,-221,163,-3,-2,-188,154,-2,-2,2,-1,-33,9,-1,0
"10685","3",414,3,1,0,0,-136,-116,-2,-2,6,6,1,1,2,-1,-142,-122,-3,-3
"10686","3",261,7,1,1,3,-55,-42,2,2,162,189,4,4,2,-5,-217,-231,-2,-2
"10687","3",185,5,4,1,2,-26,-11,-1,0,23,-45,1,-1,2,-3,-49,34,-2,1
"10688","3",111,1,1,0,0,-183,-117,-2,-4,-98,30,-1,1,2,1,-85,-147,-1,-5
"10689","3",201,1,3,1,1,-200,-1,-3,-4,137,-1,1,-4,2,1,-337,0,-4,0
"10690","3",348,2,3,0,1,-61,3,0,-3,40,40,0,-2,2,0,-101,-37,0,-1
"10691","3",327,6,4,1,3,108,7,1,1,42,-119,1,-1,2,-4,66,126,0,2
"10692","3",323,1,4,1,1,6,-66,0,-4,135,-3,-1,-1,2,1,-129,-63,1,-3
"10693","3",65,7,1,0,3,-45,22,1,2,-80,25,2,2,2,-5,35,-3,-1,0
"10694","3",441,2,4,0,2,-169,122,-4,-3,-129,38,-2,-3,2,0,-40,84,-2,0
"10695","3",369,3,4,0,0,-22,1,-2,-2,161,0,2,1,2,-1,-183,1,-4,-3
"10696","3",215,2,1,0,0,-130,25,-2,-3,-26,28,-2,-3,2,0,-104,-3,0,0
"10697","3",139,1,4,0,2,-249,-2,4,-4,-168,1,-4,-4,2,1,-81,-3,8,0
"10698","3",289,9,1,0,3,228,235,4,4,-239,-18,-4,-4,2,-7,467,253,8,8
"10699","3",253,8,3,0,3,241,-20,3,3,230,239,4,4,2,-6,11,-259,-1,-1
"10700","3",177,2,4,1,1,46,177,3,-3,-179,148,-1,-3,2,0,225,29,4,0
"10701","3",343,4,2,0,2,-54,2,-1,-1,-25,2,-1,-1,2,-2,-29,0,0,0
"10702","3",42,4,3,0,1,-2,4,0,-1,10,7,0,0,2,-2,-12,-3,0,-1
"10703","3",64,9,1,0,1,217,-203,4,4,-222,1,4,4,2,-7,439,-204,0,0
"10704","3",124,6,1,0,3,208,4,2,1,-230,1,-3,-1,2,-4,438,3,5,2
"10705","3",416,1,4,1,0,-81,36,-4,-4,-231,218,-4,-4,2,1,150,-182,0,0
"10706","3",263,3,4,1,0,-194,4,-2,-2,-150,-1,-2,-2,2,-1,-44,5,0,0
"10707","3",187,3,4,0,2,-172,-1,-2,-2,-69,-64,-2,-4,2,-1,-103,63,0,2
"10708","3",288,4,2,1,2,-172,-1,-2,-1,-110,61,-2,-2,2,-2,-62,-62,0,1
"10709","3",284,1,3,1,1,173,125,-3,-4,62,69,0,1,2,1,111,56,-3,-5
"10710","3",176,7,1,0,1,-59,1,-1,2,200,77,-2,0,2,-5,-259,-76,1,2
"10711","3",329,6,4,0,3,65,90,-2,1,104,-66,1,1,2,-4,-39,156,-3,0
"10712","3",325,8,1,1,1,-39,-29,0,3,-18,-17,0,4,2,-6,-21,-12,0,-1
"10713","3",91,7,2,1,3,104,-14,2,2,69,3,1,1,2,-5,35,-17,1,1
"10714","3",395,8,3,1,1,229,23,-2,3,195,33,-2,3,2,-6,34,-10,0,0
"10715","3",460,3,1,0,0,-149,9,-2,-2,210,55,-3,1,2,-1,-359,-46,1,-3
"10716","3",165,4,1,0,1,84,13,0,-1,73,50,1,1,2,-2,11,-37,-1,-2
"10717","3",234,7,3,1,3,104,72,1,2,121,38,1,0,2,-5,-17,34,0,2
"10718","3",112,9,4,1,3,218,4,4,4,235,6,3,3,2,-7,-17,-2,1,1
"10719","3",388,1,4,0,0,-228,-1,-4,-4,-233,-2,-1,-1,2,1,5,1,-3,-3
"10720","3",28,2,4,1,1,-137,43,-2,-3,184,152,-3,-2,2,0,-321,-109,1,-1
"10721","3",425,5,4,1,2,-17,-22,0,0,60,-3,0,0,2,-3,-77,-19,0,0
"10722","3",421,6,3,1,1,3,10,0,1,0,0,0,0,2,-4,3,10,0,1
"10723","3",13,3,4,1,1,1,2,0,-2,-1,-88,0,-2,2,-1,2,90,0,0
"10724","3",442,7,4,1,1,66,48,1,2,79,55,3,3,2,-5,-13,-7,-2,-1
"10725","3",37,1,1,1,0,-212,24,-3,-4,-186,13,-3,-4,2,1,-26,11,0,0
"10726","3",216,5,3,1,1,-9,-1,0,0,-182,-12,-3,-2,2,-3,173,11,3,2
"10727","3",14,2,3,1,1,3,0,-2,-3,48,-10,0,0,2,0,-45,10,-2,-3
"10728","3",29,1,4,1,0,-192,197,-3,-4,-235,216,-4,-4,2,1,43,-19,1,0
"10729","3",286,6,1,0,3,81,5,1,1,44,0,1,1,2,-4,37,5,0,0
"10730","3",108,9,2,0,3,223,36,4,4,228,23,3,4,2,-7,-5,13,1,0
"10731","3",344,7,4,1,3,224,11,2,2,226,-27,-4,2,2,-5,-2,38,6,0
"10732","3",420,5,4,0,3,1,3,0,0,3,1,0,1,2,-3,-2,2,0,-1
"10733","3",93,6,1,0,1,-81,41,-2,1,-149,109,-2,0,2,-4,68,-68,0,1
"10734","3",125,5,4,1,0,-50,-27,-2,0,247,-244,-4,-3,2,-3,-297,217,2,3
"10735","3",417,1,2,0,2,-171,-167,-3,-4,-141,-146,-4,-4,2,1,-30,-21,1,0
"10736","3",264,1,4,1,2,-128,-121,-2,-4,14,56,-1,-4,2,1,-142,-177,-1,0
"10737","3",188,8,2,1,3,200,1,3,3,126,5,2,2,2,-6,74,-4,1,1
"10738","3",114,2,4,1,1,5,7,1,-3,82,100,1,-3,2,0,-77,-93,0,0
"10739","3",285,2,2,0,1,91,-142,-4,-3,97,-57,-4,-4,2,0,-6,-85,0,1
"10740","3",281,1,4,1,2,-246,4,-4,-4,-235,-2,4,-4,2,1,-11,6,-8,0
"10741","3",33,5,3,1,1,31,-34,1,0,132,-114,-2,2,2,-3,-101,80,3,-2
"10742","3",326,5,4,1,2,69,40,0,0,-157,-143,0,0,2,-3,226,183,0,0
"10743","3",92,4,4,0,2,-52,-38,-1,-1,-199,-205,0,0,2,-2,147,167,-1,-1
"10744","3",396,1,1,0,1,-242,244,4,-4,239,-246,-4,4,2,1,-481,490,8,-8
"10745","3",461,2,4,1,2,-17,23,-2,-3,-18,21,-2,-3,2,0,1,2,0,0
"10746","3",166,1,4,1,2,-172,133,-2,-4,194,196,0,0,2,1,-366,-63,-2,-4
"10747","3",235,9,3,1,0,249,0,4,4,-109,0,-1,-1,2,-7,358,0,5,5
"10748","3",113,4,2,0,2,-27,32,-1,-1,221,244,0,-1,2,-2,-248,-212,-1,0
"10749","3",389,1,3,1,2,231,4,-4,-4,-177,2,-1,-1,2,1,408,2,-3,-3
"10750","3",280,7,2,0,1,46,22,1,2,14,-11,2,-1,2,-5,32,33,-1,3
"10751","3",426,4,4,1,3,0,0,-1,-1,240,3,4,2,2,-2,-240,-3,-5,-3
"10752","3",422,3,3,1,1,-96,-239,4,-2,-96,-241,3,-1,2,-1,0,2,1,-1
"10753","3",130,2,1,1,3,95,-37,3,-3,-124,-79,-4,-4,2,0,219,42,7,1
"10754","3",443,3,1,0,0,-84,-30,-2,-2,54,50,0,0,2,-1,-138,-80,-2,-2
"10755","3",370,1,1,0,3,-235,-14,-4,-4,47,62,0,-4,2,1,-282,-76,-4,0
"10756","3",217,2,4,0,2,-69,21,-1,-3,23,16,1,-1,2,0,-92,5,-2,-2
"10757","3",140,4,1,0,1,-29,32,0,-1,-34,42,-1,-2,2,-2,5,-10,1,1
"10758","3",290,4,1,0,1,-195,-124,1,-1,139,80,1,-1,2,-2,-334,-204,0,0
"10759","3",318,1,2,0,2,-206,84,-4,-4,192,73,-2,1,2,1,-398,11,-2,-5
"10760","3",109,1,1,0,1,1,-202,2,-4,3,-199,2,-4,2,1,-2,-3,0,0
"10761","3",105,1,1,0,0,-199,-35,-4,-4,-171,-35,-3,-4,2,1,-28,0,-1,0
"10762","3",101,2,3,1,0,-214,217,-3,-3,233,237,-3,-3,2,0,-447,-20,0,0
"10763","3",94,1,4,0,1,-182,92,0,-4,-130,-8,0,-4,2,1,-52,100,0,0
"10764","3",126,3,2,1,2,14,30,-2,-2,-83,-93,-2,-2,2,-1,97,123,0,0
"10765","3",269,2,4,0,2,-250,183,2,-3,250,110,0,0,2,0,-500,73,2,-3
"10766","3",265,6,1,0,3,95,0,0,1,-1,1,0,0,2,-4,96,-1,0,1
"10767","3",189,3,1,0,1,-212,48,3,-2,-107,68,2,-3,2,-1,-105,-20,1,1
"10768","3",115,5,3,1,3,76,-2,0,0,68,-1,-2,0,2,-3,8,-1,2,0
"10769","3",390,2,2,0,2,-169,-21,-3,-3,25,-103,0,1,2,0,-194,82,-3,-4
"10770","3",282,9,3,1,3,235,-66,0,4,221,49,0,4,2,-7,14,-115,0,0
"10771","3",104,1,1,1,0,244,4,4,-4,242,2,1,-4,2,1,2,2,3,0
"10772","3",100,8,4,1,3,221,0,3,3,2,2,0,3,2,-6,219,-2,3,0
"10773","3",132,5,4,1,1,9,-219,-1,0,2,-36,2,1,2,-3,7,-183,-3,-1
"10774","3",445,6,4,1,3,101,-38,1,1,116,-77,1,1,2,-4,-15,39,0,0
"10775","3",372,1,3,1,0,-116,-91,0,-4,131,116,-1,-2,2,1,-247,-207,1,-2
"10776","3",24,3,2,0,2,-147,9,0,-2,160,-1,0,2,2,-1,-307,10,0,-4
"10777","3",236,5,1,0,1,30,-28,0,0,17,-22,0,0,2,-3,13,-6,0,0
"10778","3",232,1,1,0,0,-7,-52,0,-4,-176,-32,0,-4,2,1,169,-20,0,0
"10779","3",39,5,3,1,1,101,116,1,0,137,131,3,3,2,-3,-36,-15,-2,-3
"10780","3",110,7,1,0,1,-85,53,-4,2,91,47,3,0,2,-5,-176,6,-7,2
"10781","3",427,1,4,1,1,-191,18,4,-4,-199,-27,4,-4,2,1,8,45,0,0
"10782","3",423,6,1,1,3,172,-53,2,1,-197,8,1,-2,2,-4,369,-61,1,3
"10783","3",131,8,4,1,3,-1,0,3,3,131,40,3,3,2,-6,-132,-40,0,0
"10784","3",444,2,2,0,2,-167,0,-3,-3,-124,-1,-3,-3,2,0,-43,1,0,0
"10785","3",371,1,3,1,0,-186,-179,-1,-4,55,-161,-1,0,2,1,-241,-18,0,-4
"10786","3",218,8,4,1,3,-54,-27,4,3,-143,-33,4,3,2,-6,89,6,0,0
"10787","3",141,2,1,0,0,-24,17,-4,-3,-242,10,-4,-4,2,0,218,7,0,1
"10788","3",291,1,4,0,2,-78,69,-3,-4,-85,-37,-2,-2,2,1,7,106,-1,-2
"10789","3",319,6,1,0,1,5,-76,2,1,-117,-1,4,3,2,-4,122,-75,-2,-2
"10790","3",11,5,4,1,1,89,8,0,0,63,41,1,1,2,-3,26,-33,-1,-1
"10791","3",106,5,2,1,1,33,30,1,0,-56,28,2,2,2,-3,89,2,-1,-2
"10792","3",102,8,4,1,3,46,40,1,3,-177,56,4,4,2,-6,223,-16,-3,-1
"10793","3",95,3,4,1,2,-188,6,-2,-2,-232,2,-3,-3,2,-1,44,4,1,1
"10794","3",127,3,1,1,0,-106,-1,-1,-2,-51,1,-2,-2,2,-1,-55,-2,1,0
"10795","3",27,5,2,1,2,31,-28,0,0,-72,-90,0,0,2,-3,103,62,0,0
"10796","3",266,5,1,0,1,-1,0,0,0,1,-1,0,0,2,-3,-2,1,0,0
"10797","3",19,3,2,0,2,-75,-47,1,-2,-107,-52,0,1,2,-1,32,5,1,-3
"10798","3",116,3,2,1,3,-74,-11,0,-2,10,-7,2,-2,2,-1,-84,-4,-2,0
"10799","3",424,4,2,0,2,129,79,0,-1,138,87,1,-1,2,-2,-9,-8,-1,0
"10800","3",97,2,1,1,1,-77,49,1,-3,208,182,3,1,2,0,-285,-133,-2,-4
"10801","3",230,5,1,0,0,-194,31,-3,0,-163,42,-3,1,2,-3,-31,-11,0,-1
"10802","3",276,7,4,1,3,187,-2,2,2,132,-2,3,3,2,-5,55,0,-1,-1
"10803","3",98,1,3,1,0,-80,58,-4,-4,225,225,4,4,2,1,-305,-167,-8,-8
"10804","3",446,3,4,1,1,-52,-15,0,-2,40,78,0,0,2,-1,-92,-93,0,-2
"10805","3",373,1,3,1,0,-208,-22,0,-4,-239,-39,1,-3,2,1,31,17,-1,-1
"10806","3",240,1,2,1,1,-219,31,2,-4,238,-227,-2,-2,2,1,-457,258,4,-2
"10807","3",237,4,2,0,2,-250,0,0,-1,86,3,1,0,2,-2,-336,-3,-1,-1
"10808","3",233,5,2,0,2,-52,17,0,0,-35,14,-1,0,2,-3,-17,3,1,0
"10809","3",103,6,2,1,3,55,0,1,1,13,-3,1,-2,2,-4,42,3,0,3
"10810","3",387,4,3,1,1,151,126,0,-1,131,135,2,1,2,-2,20,-9,-2,-2
"10811","3",428,1,1,0,0,-239,-208,-4,-4,-228,-101,-4,-4,2,1,-11,-107,0,0
"10812","3",270,4,3,0,1,0,-174,-1,-1,246,2,4,4,2,-2,-246,-176,-5,-5
"10813","3",267,5,3,1,1,-31,-4,-1,0,82,-12,1,1,2,-3,-113,8,-2,-1
"10814","3",129,5,4,1,1,90,3,0,0,108,7,1,1,2,-3,-18,-4,-1,-1
"10815","3",271,6,3,1,1,29,5,1,1,210,0,4,4,2,-4,-181,5,-3,-3
"10816","3",219,5,4,1,3,247,0,4,0,249,1,4,0,2,-3,-2,-1,0,0
"10817","3",142,2,2,0,2,-25,-6,4,-3,-62,12,1,-1,2,0,37,-18,3,-2
"10818","3",292,5,3,1,1,51,-1,0,0,1,-58,0,0,2,-3,50,57,0,0
"10819","3",277,1,4,1,1,-31,-16,3,-4,-68,40,3,-4,2,1,37,-56,0,0
"10820","3",386,2,1,0,0,-171,-41,-1,-3,218,218,4,3,2,0,-389,-259,-5,-6
"10821","3",107,3,2,1,3,-127,88,3,-2,-133,55,-1,2,2,-1,6,33,4,-4
"10822","3",374,6,4,1,2,42,11,1,1,10,12,0,0,2,-4,32,-1,1,1
"10823","3",96,4,1,0,0,-217,4,-3,-1,-17,-4,-1,-1,2,-2,-200,8,-2,0
"10824","3",128,6,1,0,3,99,34,1,1,134,-115,1,1,2,-4,-35,149,0,0
"10825","3",391,5,2,1,3,74,-55,0,0,177,111,0,0,2,-3,-103,-166,0,0
"10826","3",279,7,4,1,3,33,-31,2,2,34,81,3,2,2,-5,-1,-112,-1,0
"10827","3",190,7,4,1,3,213,158,2,2,195,177,2,2,2,-5,18,-19,0,0
"10828","3",117,3,4,1,2,-173,2,-2,-2,-226,1,-4,-4,2,-1,53,1,2,2
"10829","3",384,1,1,1,0,-249,0,2,-4,-90,65,0,-4,2,1,-159,-65,2,0
"10830","3",310,1,4,0,2,-235,6,-4,-4,27,-1,0,-2,2,1,-262,7,-4,-2
"10831","3",231,5,4,1,0,-82,3,-4,0,15,70,0,0,2,-3,-97,-67,-4,0
"10832","3",272,5,4,0,2,1,1,-1,0,22,16,-1,-2,2,-3,-21,-15,0,2
"10833","3",99,8,4,1,3,226,-32,4,3,222,31,4,4,2,-6,4,-63,0,-1
"10834","3",447,3,4,1,2,41,3,0,-2,92,44,2,2,2,-1,-51,-41,-2,-4
"10835","3",293,1,4,1,0,-205,19,-4,-4,-215,28,-4,-4,2,1,10,-9,0,0
"10836","3",1,3,1,0,1,-72,-57,-2,-2,7,73,-1,0,2,-1,-79,-130,-1,-2
"10837","3",238,2,3,1,1,3,4,-1,-3,-140,74,-4,-4,2,0,143,-70,3,1
"10838","3",317,3,4,0,2,-117,-80,-2,-2,-120,105,-2,-2,2,-1,3,-185,0,0
"10839","3",375,5,3,1,1,-2,0,0,0,-2,0,0,0,2,-3,0,0,0,0
"10840","3",31,9,1,0,0,68,84,4,4,-141,113,-4,-4,2,-7,209,-29,8,8
"10841","3",449,6,4,1,3,-37,54,1,1,-161,65,2,-1,2,-4,124,-11,-1,2
"10842","3",376,4,4,1,1,25,-130,-1,-1,-46,-124,-2,-2,2,-2,71,-6,1,1
"10843","3",268,7,4,1,3,93,119,2,2,158,54,3,2,2,-5,-65,65,-1,0
"10844","3",45,1,3,1,0,52,-35,-1,-4,-126,114,-4,-4,2,1,178,-149,3,0
"10845","3",118,5,3,1,1,-51,21,-2,0,-26,-17,-1,0,2,-3,-25,38,-1,0
"10846","3",22,3,3,1,1,-148,-27,-2,-2,229,17,1,1,2,-1,-377,-44,-3,-3
"10847","3",143,7,1,1,3,176,37,2,2,213,6,2,2,2,-5,-37,31,0,0
"10848","3",316,3,3,1,0,-165,-92,-2,-2,-212,-126,-2,-2,2,-1,47,34,0,0
"10849","3",278,1,4,1,1,-227,-233,4,-4,58,1,4,0,2,1,-285,-234,0,-4
"10850","3",309,4,4,1,2,59,20,-1,-1,209,44,1,-1,2,-2,-150,-24,-2,0
"10851","3",448,1,2,1,2,-42,-2,-2,-4,1,101,-1,-4,2,1,-43,-103,-1,0
"10852","3",294,7,1,0,3,191,0,2,2,157,0,2,2,2,-5,34,0,0,0
"10853","3",10,3,3,1,1,-96,1,-2,-2,46,7,0,0,2,-1,-142,-6,-2,-2
"10854","3",239,3,1,1,1,-35,0,-2,-2,225,5,3,3,2,-1,-260,-5,-5,-5
"10855","3",392,2,1,1,0,-222,193,-3,-3,-129,-105,-1,-1,2,0,-93,298,-2,-2
"10856","3",314,1,4,1,1,-244,10,4,-4,-245,5,4,-4,2,1,1,5,0,0
"10857","3",191,3,1,0,0,-209,-35,-2,-2,-207,-29,-3,-3,2,-1,-2,-6,1,1
"10858","3",453,4,4,1,2,-1,0,1,-1,-172,9,0,-2,2,-2,171,-9,1,1
"10859","3",385,4,4,1,1,-122,-119,-2,-1,-96,-181,-2,1,2,-2,-26,62,0,-2
"10860","3",311,1,2,1,2,-81,-9,-4,-4,222,6,4,-4,2,1,-303,-15,-8,0
"10861","3",450,6,4,0,3,149,3,1,1,-1,2,0,1,2,-4,150,1,1,0
"10862","3",273,5,1,1,0,-53,-1,0,0,113,8,2,1,2,-3,-166,-9,-2,-1
"10863","3",220,1,4,1,2,-200,71,-4,-4,72,86,-2,-2,2,1,-272,-15,-2,-2
"10864","3",144,4,3,1,0,-132,4,3,-1,88,14,2,1,2,-2,-220,-10,1,-2
"10865","3",451,2,1,0,0,55,-82,-3,-3,-157,-165,-2,-2,2,0,212,83,-1,-1
"10866","3",313,2,3,1,0,-32,-27,-3,-3,-242,-234,-4,-4,2,0,210,207,1,1
"10867","3",46,3,1,0,0,-39,-243,-3,-2,-99,-240,-4,-3,2,-1,60,-3,1,1
"10868","3",452,2,3,1,1,-146,4,-2,-3,9,-50,0,0,2,0,-155,54,-2,-3
"10869","3",275,2,4,1,2,-243,1,2,-3,-247,6,-2,-2,2,0,4,-5,4,-1
"10870","3",222,2,1,0,0,-124,1,-2,-3,-239,1,-3,-3,2,0,115,0,1,0
"10871","3",146,2,2,0,0,-160,-170,-3,-3,-172,-157,-3,-3,2,0,12,-13,0,0
"10872","3",377,1,1,0,0,-244,8,-4,-4,-132,7,-4,-4,2,1,-112,1,0,0
"10873","3",196,1,3,1,0,-142,-179,-3,-4,231,244,4,4,2,1,-373,-423,-7,-8
"10874","3",192,6,4,1,1,98,1,1,1,0,124,0,2,2,-4,98,-123,1,-1
"10875","3",119,6,3,1,3,159,70,2,1,-106,136,0,0,2,-4,265,-66,2,1
"10876","3",312,5,4,1,1,123,140,0,0,89,137,4,4,2,-3,34,3,-4,-4
"10877","3",459,1,3,1,1,-141,-160,-1,-4,34,-34,2,-4,2,1,-175,-126,-3,0
"10878","3",193,1,1,0,0,-203,-44,-4,-4,-223,-35,-4,-4,2,1,20,-9,0,0
"10879","3",274,4,4,1,2,104,95,-2,-1,77,78,-2,-2,2,-2,27,17,0,1
"10880","3",221,5,4,0,1,-10,-5,0,0,8,4,1,0,2,-3,-18,-9,-1,0
"10881","3",145,6,1,0,1,43,57,1,1,95,131,0,0,2,-4,-52,-74,1,1
"10882","3",295,5,1,0,1,5,-3,0,0,-3,1,0,0,2,-3,8,-4,0,0
"10883","3",38,9,4,1,3,0,0,4,4,68,235,4,4,2,-7,-68,-235,0,0
"10884","3",199,3,4,1,2,-95,34,-2,-2,109,-35,0,0,2,-1,-204,69,-2,-2
"10885","3",393,1,1,0,0,-153,-77,-4,-4,114,-136,0,-4,2,1,-267,59,-4,0
"10886","3",315,9,3,1,3,238,29,4,4,247,27,4,4,2,-7,-9,2,0,0
"10887","3",223,5,1,0,1,-2,-1,0,0,173,-1,-1,0,2,-3,-175,0,1,0
"10888","3",454,9,4,1,3,249,1,4,4,249,1,4,4,2,-7,0,0,0,0
"10889","3",378,3,4,1,1,-90,-8,-4,-2,-163,-6,-3,-3,2,-1,73,-2,-1,1
"10890","3",197,9,4,1,3,135,-125,0,4,129,-123,-3,4,2,-7,6,-2,3,0
"10891","3",224,3,2,0,2,-121,-22,-2,-2,171,68,2,1,2,-1,-292,-90,-4,-3
"10892","3",12,9,4,1,3,0,1,4,4,-1,2,4,4,2,-7,1,-1,0,0
"10893","3",379,2,3,1,1,-66,37,1,-3,177,124,2,1,2,0,-243,-87,-1,-4
"10894","3",198,4,1,1,1,-74,56,0,-1,78,80,1,3,2,-2,-152,-24,-1,-4
"10895","3",456,1,1,0,0,-205,-198,-2,-4,128,129,1,-3,2,1,-333,-327,-3,-1
"10896","3",120,3,3,1,1,-152,-51,-2,-2,-166,-171,-3,-3,2,-1,14,120,1,1
"10897","3",383,5,4,1,1,103,-43,0,0,-2,249,2,2,2,-3,105,-292,-2,-2
"10898","3",457,2,3,1,1,-224,0,-4,-3,131,-198,1,0,2,0,-355,198,-5,-3
"10899","3",380,1,4,1,1,-209,-143,3,-4,-221,-154,3,-4,2,1,12,11,0,0
"10900","3",161,1,2,0,2,-236,76,-3,-4,79,75,1,-3,2,1,-315,1,-4,-1
"10901","3",147,3,2,1,3,-112,-179,1,-2,175,187,3,3,2,-1,-287,-366,-2,-5
"10902","3",394,1,3,0,0,130,-127,-4,-4,-247,2,-4,-4,2,1,377,-129,0,0
"10903","3",381,1,2,0,2,-216,-242,-4,-4,232,240,4,4,2,1,-448,-482,-8,-8
"10904","3",162,9,3,0,3,90,109,2,4,178,139,1,2,2,-7,-88,-30,1,2
"10905","3",455,2,2,1,2,-244,2,-3,-3,2,244,4,3,2,0,-246,-242,-7,-6
"10906","3",298,1,1,0,0,-132,11,-1,-4,-35,12,-1,-2,2,1,-97,-1,0,-2
"10907","3",382,6,4,1,2,53,7,1,1,128,-10,2,1,2,-4,-75,17,-1,0
"10908","3",194,9,1,0,0,-218,26,-4,4,-201,44,-4,4,2,-7,-17,-18,0,0
"10909","3",149,6,3,1,1,-75,1,-2,1,216,-49,-2,0,2,-4,-291,50,0,1
"10910","3",299,7,4,0,1,214,-49,2,2,28,217,2,2,2,-5,186,-266,0,0
"10911","3",195,2,1,0,1,-174,163,3,-3,25,-21,2,0,2,0,-199,184,1,-3
"10912","3",296,6,1,0,3,-3,105,1,1,218,-2,-2,2,2,-4,-221,107,3,-1
"10913","3",121,1,1,0,0,-240,231,-4,-4,234,-237,4,-4,2,1,-474,468,-8,0
"10914","3",227,6,3,1,3,29,17,1,1,7,-5,2,1,2,-4,22,22,-1,0
"10915","3",458,2,1,0,1,-53,-42,-1,-3,77,74,-3,-2,2,0,-130,-116,2,-1
"10916","3",297,1,3,1,2,-234,26,1,-4,235,201,4,4,2,1,-469,-175,-3,-8
"10917","3",30,6,2,0,2,150,-19,2,1,128,10,1,2,2,-4,22,-29,1,-1
"10918","3",148,1,1,0,1,-185,-1,3,-4,-247,-36,1,-4,2,1,62,35,2,0
"10919","3",151,1,2,1,1,-207,19,4,-4,-246,9,4,-4,2,1,39,10,0,0
"10920","3",300,2,1,0,0,-205,25,-2,-3,22,23,1,1,2,0,-227,2,-3,-4
"10921","3",225,6,2,0,2,118,-56,1,1,81,-124,1,1,2,-4,37,68,0,0
"10922","3",229,2,1,1,1,-234,-64,-3,-3,-237,231,0,-4,2,0,3,-295,-3,1
"10923","3",152,2,1,0,0,-145,-5,-1,-3,233,3,0,-3,2,0,-378,-8,-1,0
"10924","3",226,2,1,0,0,-82,0,-1,-3,221,4,3,-2,2,0,-303,-4,-4,-1
"10925","3",15,8,4,1,3,64,36,2,3,103,66,3,2,2,-6,-39,-30,-1,1
"10926","3",153,6,1,0,3,15,11,2,1,-49,20,-1,1,2,-4,64,-9,3,0
"10927","3",3,1,3,0,0,-134,115,-4,-4,-183,194,-4,-4,2,1,49,-79,0,0
"10928","3",150,5,3,1,1,164,5,-1,0,-3,-34,0,0,2,-3,167,39,-1,0
"10929","3",154,5,4,1,3,29,-18,0,0,-44,-21,0,0,2,-3,73,3,0,0
"10930","3",158,2,3,0,0,-239,-17,-4,-3,-241,-240,-4,-4,2,0,2,223,0,1
"10931","3",228,5,4,1,2,-50,52,0,0,40,239,4,4,2,-3,-90,-187,-4,-4
"10932","3",308,1,4,0,0,-248,-246,-4,-4,189,189,0,0,2,1,-437,-435,-4,-4
"10933","3",155,3,2,1,1,-152,-81,0,-2,7,3,0,0,2,-1,-159,-84,0,-2
"10934","3",163,7,3,1,1,-206,-7,1,2,91,40,3,2,2,-5,-297,-47,-2,0
"10935","3",160,7,2,1,0,-221,0,-4,2,-1,-203,-4,2,2,-5,-220,203,0,0
"10936","3",16,2,1,0,0,-204,146,1,-3,64,17,1,-2,2,0,-268,129,0,-1
"10937","3",164,6,2,1,2,31,-1,1,1,-220,-46,-3,-3,2,-4,251,45,4,4
"10938","3",23,9,1,0,3,211,211,4,4,216,206,4,4,2,-7,-5,5,0,0
"10939","3",304,6,2,1,2,60,-37,1,1,-57,-30,2,2,2,-4,117,-7,-1,-1
"10940","3",157,1,3,1,2,-66,-54,-3,-4,174,75,-2,0,2,1,-240,-129,-1,-4
"10941","3",307,2,4,1,2,59,120,-3,-3,-246,236,-4,-4,2,0,305,-116,1,1
"10942","3",306,4,3,1,3,94,91,1,-1,126,177,1,0,2,-2,-32,-86,0,-1
"10943","3",305,6,4,1,3,35,47,1,1,-243,-7,2,2,2,-4,278,54,-1,-1
"10944","3",303,2,3,1,2,-133,-108,-3,-3,-140,-25,-2,-3,2,0,7,-83,-1,0
"10945","3",301,6,4,1,1,1,0,1,1,-50,1,0,0,2,-4,51,-1,1,1
"10946","3",156,5,2,1,1,14,10,0,0,82,44,1,1,2,-3,-68,-34,-1,-1
"10947","3",159,2,3,1,2,-3,-218,-1,-3,225,1,3,3,2,0,-228,-219,-4,-6
"10948","3",302,3,1,1,0,-26,-20,-3,-2,208,64,-2,-2,2,-1,-234,-84,-1,0
"10949","30",206,6,4,1,0,14,20,-1,1,241,245,4,4,4,-2,-227,-225,-5,-3
"10950","30",114,2,4,1,1,-12,-238,0,-3,84,95,1,-3,4,2,-96,-333,-1,0
"10951","30",336,3,4,1,3,170,186,3,-2,145,168,3,-2,4,1,25,18,0,0
"10952","30",101,1,3,1,0,-237,240,-4,-4,229,234,-3,-3,4,3,-466,6,-1,-1
"10953","30",115,6,3,0,3,-6,-2,1,1,53,-1,-1,0,4,-2,-59,-1,2,1
"10954","30",113,6,2,1,2,65,-34,1,1,-112,124,1,1,4,-2,177,-158,0,0
"10955","30",77,4,3,0,1,-88,9,-1,-1,-3,50,-1,-1,4,0,-85,-41,0,0
"10956","30",111,5,1,0,0,2,-5,0,0,-180,171,-2,-3,4,-1,182,-176,2,3
"10957","30",335,5,2,1,1,64,25,1,0,124,-98,1,0,4,-1,-60,123,0,0
"10958","30",80,6,4,1,3,-151,-1,3,1,197,-1,3,-3,4,-2,-348,0,0,4
"10959","30",112,8,4,1,3,225,36,3,3,228,-7,4,4,4,-4,-3,43,-1,-1
"10960","30",429,6,2,1,0,-44,20,-1,1,58,20,0,-4,4,-2,-102,0,-1,5
"10961","30",117,3,4,1,2,-13,7,-2,-2,57,13,-2,-3,4,1,-70,-6,0,1
"10962","30",207,4,1,0,0,-246,-31,-2,-1,0,241,4,4,4,0,-246,-272,-6,-5
"10963","30",331,2,1,1,0,105,54,-4,-3,46,-243,-4,-3,4,2,59,297,0,0
"10964","30",79,5,4,0,2,118,-6,0,0,114,-9,1,1,4,-1,4,3,-1,-1
"10965","30",337,9,2,1,3,244,210,4,4,243,49,4,4,4,-5,1,161,0,0
"10966","30",208,9,4,1,2,-59,62,-4,4,-244,194,-4,4,4,-5,185,-132,0,0
"10967","30",334,1,4,1,0,-130,106,-4,-4,-197,-72,-4,-4,4,3,67,178,0,0
"10968","30",8,5,3,1,1,17,-2,0,0,50,39,0,0,4,-1,-33,-41,0,0
"10969","30",330,6,2,1,2,126,203,1,1,148,212,1,1,4,-2,-22,-9,0,0
"10970","30",116,5,2,1,3,130,23,-1,0,110,2,1,1,4,-1,20,21,-2,-1
"10971","30",432,4,2,1,1,43,-43,0,-1,84,-100,0,0,4,0,-41,57,0,-1
"10972","30",339,4,3,1,1,-84,-37,-2,-1,-54,-29,-2,-2,4,0,-30,-8,0,1
"10973","30",78,4,4,1,0,73,-4,-1,-1,-22,1,1,1,4,0,95,-5,-2,-2
"10974","30",179,5,1,0,1,222,1,2,0,-1,-2,0,2,4,-1,223,3,2,-2
"10975","30",81,8,1,0,0,-230,214,4,3,-221,203,4,4,4,-4,-9,11,0,-1
"10976","30",430,5,2,1,1,209,-145,0,0,211,-99,1,-2,4,-1,-2,-46,-1,2
"10977","30",118,6,3,0,1,-120,34,-2,1,24,18,-1,1,4,-2,-144,16,-1,0
"10978","30",102,9,4,1,3,-168,111,2,4,-177,-102,1,1,4,-5,9,213,1,3
"10979","30",82,1,4,1,2,-214,19,-4,-4,192,225,4,4,4,3,-406,-206,-8,-8
"10980","30",431,5,3,0,0,-16,3,-1,0,56,47,-1,0,4,-1,-72,-44,0,0
"10981","30",119,4,3,1,3,-52,89,-1,-1,45,75,1,1,4,0,-97,14,-2,-2
"10982","30",338,2,3,1,2,46,-187,-3,-3,-117,-187,-2,-1,4,2,163,0,-1,-2
"10983","30",209,7,4,1,3,156,4,2,2,167,-2,3,2,4,-3,-11,6,-1,0
"10984","30",178,1,1,1,1,-232,-2,-4,-4,1,3,0,0,4,3,-233,-5,-4,-4
"10985","30",100,7,4,1,3,244,1,3,2,247,3,4,2,4,-3,-3,-2,-1,0
"10986","30",43,1,3,1,0,-47,14,-4,-4,129,14,-4,-4,4,3,-176,0,0,0
"10987","30",186,5,2,1,2,58,55,0,0,144,160,0,2,4,-1,-86,-105,0,-2
"10988","30",105,1,1,0,0,-224,-17,-4,-4,-215,-21,-4,-4,4,3,-9,4,0,0
"10989","30",332,5,1,0,0,-249,-2,0,0,-248,51,-2,-2,4,-1,-1,-53,2,2
"10990","30",210,2,4,1,2,151,59,3,-3,208,-110,2,-1,4,2,-57,169,1,-2
"10991","30",434,6,4,0,3,113,-77,1,1,229,-30,2,2,4,-2,-116,-47,-1,-1
"10992","30",106,6,2,1,1,102,-77,1,1,166,-155,1,1,4,-2,-64,78,0,0
"10993","30",333,6,4,1,1,76,0,1,1,52,-112,1,1,4,-2,24,112,0,0
"10994","30",180,9,2,1,2,238,3,3,4,1,242,4,4,4,-5,237,-239,-1,0
"10995","30",103,5,2,0,3,23,3,2,0,-236,7,-4,-4,4,-1,259,-4,6,4
"10996","30",83,6,1,0,3,112,-121,1,1,111,-110,2,1,4,-2,1,-11,-1,0
"10997","30",185,5,4,1,2,44,-8,-2,0,197,-16,-1,3,4,-1,-153,8,-1,-3
"10998","30",12,9,4,1,3,-2,-1,4,4,-2,3,4,4,4,-5,0,-4,0,0
"10999","30",21,4,4,1,2,100,55,2,-1,132,53,2,-1,4,0,-32,2,0,0
"11000","30",40,8,1,0,2,-156,-43,2,3,181,51,2,2,4,-4,-337,-94,0,1
"11001","30",433,1,1,0,0,-211,-218,-4,-4,227,241,3,4,4,3,-438,-459,-7,-8
"11002","30",34,6,4,1,2,100,-48,0,1,148,-46,2,1,4,-2,-48,-2,-2,0
"11003","30",400,4,4,1,2,24,-108,-1,-1,81,-79,-1,-1,4,0,-57,-29,0,0
"11004","30",18,2,3,1,1,0,26,1,-3,38,-29,1,-3,4,2,-38,55,0,0
"11005","30",121,1,1,0,0,-37,33,-4,-4,231,19,-2,-4,4,3,-268,14,-2,0
"11006","30",340,5,1,1,1,13,12,0,0,82,10,0,0,4,-1,-69,2,0,0
"11007","30",211,7,3,1,1,13,17,1,2,54,86,-2,-1,4,-3,-41,-69,3,3
"11008","30",435,4,4,0,1,-63,4,-1,-1,-5,5,0,0,4,0,-58,-1,-1,-1
"11009","30",107,4,2,1,3,203,168,-1,-1,56,-56,2,-1,4,0,147,224,-3,0
"11010","30",402,3,3,1,0,-232,-65,-2,-2,-237,1,-3,-4,4,1,5,-66,1,2
"11011","30",181,2,4,1,3,-82,-121,-3,-3,132,71,1,1,4,2,-214,-192,-4,-4
"11012","30",460,1,1,0,0,-216,8,-4,-4,221,174,-4,3,4,3,-437,-166,0,-7
"11013","30",84,8,4,1,3,211,5,3,3,211,1,3,3,4,-4,0,4,0,0
"11014","30",133,2,2,1,1,-225,13,0,-3,249,14,4,0,4,2,-474,-1,-4,-3
"11015","30",202,4,1,0,1,-38,68,-2,-1,85,26,-2,-1,4,0,-123,42,0,0
"11016","30",461,4,4,1,2,74,41,1,-1,47,57,0,0,4,0,27,-16,1,-1
"11017","30",187,7,4,1,2,54,72,2,2,178,163,3,3,4,-3,-124,-91,-1,-1
"11018","30",134,5,2,1,2,43,12,1,0,118,18,2,1,4,-1,-75,-6,-1,-1
"11019","30",203,9,4,1,3,-17,-232,4,4,-13,-48,4,4,4,-5,-4,-184,0,0
"11020","30",401,4,2,1,1,-19,17,3,-1,91,14,0,-2,4,0,-110,3,3,1
"11021","30",135,5,1,0,1,-146,-47,1,0,-133,-17,0,0,4,-1,-13,-30,1,0
"11022","30",122,1,1,0,0,-217,-225,-4,-4,228,234,0,0,4,3,-445,-459,-4,-4
"11023","30",341,9,1,0,3,249,-37,4,4,250,-45,3,4,4,-5,-1,8,1,0
"11024","30",212,5,1,0,1,-177,-139,3,0,-185,-142,3,0,4,-1,8,3,0,0
"11025","30",104,1,1,0,0,-235,1,-4,-4,-235,0,-3,-3,4,3,0,1,-1,-1
"11026","30",108,9,2,1,3,226,190,4,4,240,212,4,4,4,-5,-14,-22,0,0
"11027","30",213,5,2,0,1,-100,1,-1,0,117,-8,1,1,4,-1,-217,9,-2,-1
"11028","30",120,6,3,0,1,79,10,1,1,118,52,1,1,4,-2,-39,-42,0,0
"11029","30",109,1,1,0,1,-42,-1,4,-4,-22,6,3,-4,4,3,-20,-7,1,0
"11030","30",2,4,4,1,1,23,25,0,-1,122,-150,-2,1,4,0,-99,175,2,-2
"11031","30",398,9,4,1,2,249,240,4,4,245,249,4,4,4,-5,4,-9,0,0
"11032","30",243,6,2,1,2,247,-186,1,1,209,246,0,-1,4,-2,38,-432,1,2
"11033","30",462,9,3,1,3,240,25,4,4,227,210,4,4,4,-5,13,-185,0,0
"11034","30",188,9,2,1,3,239,-1,4,4,235,4,4,4,4,-5,4,-5,0,0
"11035","30",184,6,3,1,3,128,1,4,1,127,7,1,1,4,-2,1,-6,3,0
"11036","30",204,5,3,1,1,69,-41,1,0,102,-66,0,0,4,-1,-33,25,1,0
"11037","30",200,1,3,1,0,-226,-201,-4,-4,-230,-142,-4,-4,4,3,4,-59,0,0
"11038","30",436,4,4,1,3,35,-224,1,-1,111,-135,2,0,4,0,-76,-89,-1,-1
"11039","30",123,4,4,1,2,-27,-28,-2,-1,-37,-28,-2,-2,4,0,10,0,0,1
"11040","30",403,2,1,0,0,-242,-10,-1,-3,-82,-18,2,0,4,2,-160,8,-3,-3
"11041","30",182,8,4,0,3,-4,-129,2,3,0,-131,2,2,4,-4,-4,2,0,1
"11042","30",437,3,1,0,0,-186,0,-2,-2,-144,-1,-3,-3,4,1,-42,1,1,1
"11043","30",85,5,2,1,2,113,155,2,0,114,119,4,4,4,-1,-1,36,-2,-4
"11044","30",214,9,1,0,3,227,5,4,4,247,5,4,4,4,-5,-20,0,0,0
"11045","30",183,2,4,1,1,-190,19,1,-3,51,76,1,-2,4,2,-241,-57,0,-1
"11046","30",11,4,4,1,1,190,84,3,-1,-130,102,-1,2,4,0,320,-18,4,-3
"11047","30",20,6,3,0,0,-201,-200,-4,1,70,77,0,2,4,-2,-271,-277,-4,-1
"11048","30",399,7,4,1,3,64,-62,1,2,116,32,1,1,4,-3,-52,-94,0,1
"11049","30",244,4,4,1,2,-31,-106,-1,-1,119,-56,1,1,4,0,-150,-50,-2,-2
"11050","30",463,7,4,0,3,-53,-27,-1,2,222,-3,0,-3,4,-3,-275,-24,-1,5
"11051","30",136,1,1,0,0,-249,249,-4,-4,-245,236,-4,-4,4,3,-4,13,0,0
"11052","30",55,5,4,1,1,-138,233,0,0,101,-103,0,-1,4,-1,-239,336,0,1
"11053","30",342,2,3,1,1,-88,-234,-1,-3,-87,-216,-2,-3,4,2,-1,-18,1,0
"11054","30",19,5,2,1,2,116,-70,1,0,116,73,1,0,4,-1,0,-143,0,0
"11055","30",137,3,1,0,1,-241,237,3,-2,45,-32,0,-1,4,1,-286,269,3,-1
"11056","30",363,8,3,1,3,249,-48,3,3,250,-1,3,3,4,-4,-1,-47,0,0
"11057","30",404,4,1,0,1,33,-40,1,-1,39,-51,1,0,4,0,-6,11,0,-1
"11058","30",175,2,4,1,1,-204,-6,-2,-3,-183,-94,-1,-2,4,2,-21,88,-1,-1
"11059","30",171,5,1,0,1,25,18,3,0,28,35,0,0,4,-1,-3,-17,3,0
"11060","30",86,8,4,1,3,148,-4,2,3,173,1,2,3,4,-4,-25,-5,0,0
"11061","30",215,2,1,0,0,-153,77,-2,-3,-161,67,-2,-3,4,2,8,10,0,0
"11062","30",139,9,4,1,2,235,4,4,4,12,201,2,4,4,-5,223,-197,2,0
"11063","30",110,7,1,0,1,-120,95,-3,2,46,-124,-4,2,4,-3,-166,219,1,0
"11064","30",189,2,1,0,1,-220,24,3,-3,-184,34,2,-2,4,2,-36,-10,1,-1
"11065","30",4,7,3,1,1,223,137,2,2,214,227,2,4,4,-3,9,-90,0,-2
"11066","30",205,6,1,0,2,-9,1,0,1,4,-234,4,4,4,-2,-13,235,-4,-3
"11067","30",201,7,3,1,1,178,-2,-2,2,68,2,1,-3,4,-3,110,-4,-3,5
"11068","30",397,7,4,1,3,139,9,2,2,119,62,1,1,4,-3,20,-53,1,1
"11069","30",124,8,1,0,3,184,-1,2,3,180,1,2,2,4,-4,4,-2,0,1
"11070","30",343,7,2,1,2,1,-90,2,2,3,-105,2,2,4,-3,-2,15,0,0
"11071","30",190,7,4,1,3,200,158,2,2,214,163,2,2,4,-3,-14,-5,0,0
"11072","30",438,5,4,1,3,170,0,4,0,151,0,4,0,4,-1,19,0,0,0
"11073","30",364,3,3,1,1,-146,-2,-2,-2,-105,-5,0,0,4,1,-41,3,-2,-2
"11074","30",405,4,4,1,1,78,66,0,-1,123,111,0,-1,4,0,-45,-45,0,0
"11075","30",176,7,1,0,1,-59,0,-2,2,230,8,-2,2,4,-3,-289,-8,0,0
"11076","30",172,4,2,1,3,2,53,-1,-1,138,139,-2,-2,4,0,-136,-86,1,1
"11077","30",406,8,2,1,2,125,85,2,3,227,84,2,1,4,-4,-102,1,0,2
"11078","30",1,4,1,0,1,-168,-86,-1,-1,-135,-102,-2,-1,4,0,-33,16,1,0
"11079","30",245,1,1,0,0,-240,-2,-4,-4,-245,2,-4,-4,4,3,5,-4,0,0
"11080","30",464,6,1,0,1,-43,17,1,1,-31,29,1,1,4,-2,-12,-12,0,0
"11081","30",321,1,1,0,0,-219,-203,-4,-4,-244,-220,-4,-4,4,3,25,17,0,0
"11082","30",56,4,3,1,1,14,-33,-2,-1,27,-65,-2,0,4,0,-13,32,0,-1
"11083","30",411,9,2,1,2,226,232,4,4,200,208,4,4,4,-5,26,24,0,0
"11084","30",36,8,3,1,3,-123,-77,3,3,-154,66,4,-3,4,-4,31,-143,-1,6
"11085","30",138,4,3,0,1,-92,-51,-1,-1,81,-22,1,1,4,0,-173,-29,-2,-2
"11086","30",352,4,2,0,1,11,-117,0,-1,10,-154,0,-1,4,0,1,37,0,0
"11087","30",168,6,1,0,3,66,-93,2,1,147,-92,1,2,4,-2,-81,-1,1,-1
"11088","30",126,2,2,0,2,132,184,-1,-3,162,230,-1,-1,4,2,-30,-46,0,-2
"11089","30",439,3,2,1,1,204,-5,-2,-2,212,7,2,2,4,1,-8,-12,-4,-4
"11090","30",87,8,4,1,3,80,0,3,3,0,0,0,1,4,-4,80,0,3,2
"11091","30",216,7,3,1,1,-90,-30,1,2,-75,-77,1,1,4,-3,-15,47,0,1
"11092","30",14,5,3,0,1,-5,1,0,0,173,-87,2,4,4,-1,-178,88,-2,-4
"11093","30",410,2,1,0,0,-30,-9,1,-3,-35,-15,0,-4,4,2,5,6,1,1
"11094","30",407,7,2,1,2,77,-52,2,2,242,-6,3,3,4,-3,-165,-46,-1,-1
"11095","30",174,7,4,1,3,140,65,0,2,132,84,1,0,4,-3,8,-19,-1,2
"11096","30",170,3,2,1,0,125,122,-2,-2,133,130,0,0,4,1,-8,-8,-2,-2
"11097","30",167,3,1,0,3,-64,93,-2,-2,-190,133,3,3,4,1,126,-40,-5,-5
"11098","30",356,4,4,1,1,33,1,1,-1,78,1,1,1,4,0,-45,0,0,-2
"11099","30",125,3,4,1,0,-200,4,-4,-2,-181,-30,-3,-1,4,1,-19,34,-1,-1
"11100","30",344,8,4,1,3,181,186,2,3,-120,127,2,3,4,-4,301,59,0,0
"11101","30",191,3,1,0,0,-190,-46,-2,-2,-170,-46,-2,-2,4,1,-20,0,0,0
"11102","30",58,6,4,1,1,-240,23,-3,1,-8,246,4,2,4,-2,-232,-223,-7,-1
"11103","30",365,1,3,1,1,-218,-2,0,-4,-217,-4,0,-4,4,3,-1,2,0,0
"11104","30",361,1,1,0,0,-249,7,-4,-4,-248,0,-3,-4,4,3,-1,7,-1,0
"11105","30",177,5,4,1,1,-74,83,-4,0,-121,91,-3,3,4,-1,47,-8,-1,-3
"11106","30",173,7,4,1,3,104,19,2,2,173,22,0,0,4,-3,-69,-3,2,2
"11107","30",17,1,3,1,0,15,2,0,-4,166,124,-2,-4,4,3,-151,-122,2,0
"11108","30",10,4,3,0,1,-133,1,-1,-1,-128,1,-1,-1,4,0,-5,0,0,0
"11109","30",246,7,4,1,3,220,5,3,2,247,-3,4,4,4,-3,-27,8,-1,-2
"11110","30",465,7,4,1,3,13,-230,1,2,25,-236,1,2,4,-3,-12,6,0,0
"11111","30",322,5,4,1,3,-1,-1,0,0,221,-208,3,3,4,-1,-222,207,-3,-3
"11112","30",57,1,4,1,1,122,-236,0,-4,169,-206,-1,-4,4,3,-47,-30,1,0
"11113","30",412,9,1,0,0,-249,2,-4,4,244,0,4,4,4,-5,-493,2,-8,0
"11114","30",360,1,3,1,0,-179,-143,-3,-4,91,103,1,-4,4,3,-270,-246,-4,0
"11115","30",357,7,4,1,2,87,-24,0,2,-71,72,2,-4,4,-3,158,-96,-2,6
"11116","30",353,6,2,1,2,232,100,-4,1,246,126,-4,-1,4,-2,-14,-26,0,2
"11117","30",169,5,3,1,0,68,-43,0,0,-35,29,-4,-4,4,-1,103,-72,4,4
"11118","30",127,1,1,0,0,-238,3,-4,-4,-2,1,-4,-4,4,3,-236,2,0,0
"11119","30",44,1,2,1,2,-15,14,-1,-4,230,153,1,2,4,3,-245,-139,-2,-6
"11120","30",88,8,4,1,2,171,115,3,3,225,219,4,4,4,-4,-54,-104,-1,-1
"11121","30",217,4,4,1,2,90,44,1,-1,77,48,1,-1,4,0,13,-4,0,0
"11122","30",140,4,1,0,1,-30,62,1,-1,6,-50,-1,-1,4,0,-36,112,2,0
"11123","30",367,5,3,0,1,-88,-80,1,0,-106,-98,1,0,4,-1,18,18,0,0
"11124","30",408,3,1,1,0,-54,-2,-1,-2,-160,8,-2,-3,4,1,106,-10,1,1
"11125","30",255,5,3,1,1,-113,-150,0,0,-84,-132,0,0,4,-1,-29,-18,0,0
"11126","30",474,1,1,0,0,3,-81,0,-4,4,-69,0,-4,4,3,-1,-12,0,0
"11127","30",66,3,1,0,1,64,4,1,-2,125,-1,1,-2,4,1,-61,5,0,0
"11128","30",248,5,4,1,3,12,84,0,0,13,118,1,-1,4,-1,-1,-34,-1,1
"11129","30",349,9,4,1,1,72,68,2,4,41,57,3,2,4,-5,31,11,-1,2
"11130","30",345,8,1,0,0,-229,3,-4,3,-215,3,-4,3,4,-4,-14,0,0,0
"11131","30",192,6,4,0,1,79,-26,1,1,-2,92,1,0,4,-2,81,-118,0,1
"11132","30",59,2,1,0,0,-97,94,-3,-3,-35,-23,-1,-1,4,2,-62,117,-2,-2
"11133","30",366,9,4,1,3,149,-59,3,4,201,-63,2,3,4,-5,-52,4,1,1
"11134","30",362,7,4,1,3,172,-217,4,2,141,124,3,1,4,-3,31,-341,1,1
"11135","30",254,4,2,1,3,113,-34,-2,-1,168,-188,-4,-1,4,0,-55,154,2,0
"11136","30",473,3,3,1,0,-207,-29,-2,-2,-221,-20,-3,-3,4,1,14,-9,1,1
"11137","30",250,6,1,0,3,68,17,1,1,79,22,1,1,4,-2,-11,-5,0,0
"11138","30",247,5,3,0,0,-201,-1,-2,0,118,-8,0,0,4,-1,-319,7,-2,0
"11139","30",47,6,4,1,3,177,-63,2,1,79,-1,0,1,4,-2,98,-62,2,0
"11140","30",466,2,3,0,0,-100,46,-3,-3,-108,-76,-2,-2,4,2,8,122,-1,-1
"11141","30",323,5,4,1,1,-3,-83,0,0,234,8,3,-4,4,-1,-237,-91,-3,4
"11142","30",32,5,1,0,1,2,4,0,0,161,-177,2,-4,4,-1,-159,181,-2,4
"11143","30",413,7,1,0,1,240,8,2,2,-126,-25,-2,-3,4,-3,366,33,4,5
"11144","30",41,6,2,1,3,93,98,3,1,83,94,3,1,4,-2,10,4,0,0
"11145","30",358,4,4,1,2,186,68,0,-1,223,58,0,1,4,0,-37,10,0,-2
"11146","30",354,4,1,0,0,-239,33,0,-1,244,243,4,4,4,0,-483,-210,-4,-5
"11147","30",68,1,4,1,0,59,4,-1,-4,131,6,-2,-4,4,3,-72,-2,1,0
"11148","30",128,7,1,0,3,154,-15,2,2,8,-101,1,1,4,-3,146,86,1,1
"11149","30",440,2,3,1,0,-184,0,-3,-3,-140,-1,-3,-3,4,2,-44,1,0,0
"11150","30",89,1,3,1,0,-246,0,-3,-4,-78,0,-4,-4,4,3,-168,0,1,0
"11151","30",218,9,4,1,3,162,31,4,4,166,43,4,3,4,-5,-4,-12,0,1
"11152","30",141,1,1,0,0,-195,16,-4,-4,-138,-235,-3,-4,4,3,-57,251,-1,0
"11153","30",368,9,3,1,3,-95,153,4,4,-179,149,4,4,4,-5,84,4,0,0
"11154","30",409,6,4,1,2,70,76,1,1,118,127,2,2,4,-2,-48,-51,-1,-1
"11155","30",256,6,3,1,1,132,0,1,1,116,92,1,1,4,-2,16,-92,0,0
"11156","30",475,5,3,0,3,59,-37,1,0,-166,30,-2,-3,4,-1,225,-67,3,3
"11157","30",67,3,1,0,0,-50,34,0,-2,166,-161,1,1,4,1,-216,195,-1,-3
"11158","30",249,1,3,1,0,-97,-76,-3,-4,-55,-50,-3,-4,4,3,-42,-26,0,0
"11159","30",35,2,1,0,3,42,118,1,-3,133,124,2,-1,4,2,-91,-6,-1,-2
"11160","30",346,8,3,0,0,-1,1,0,3,247,-1,4,4,4,-4,-248,2,-4,-1
"11161","30",193,1,1,0,0,-239,-64,-4,-4,138,45,1,1,4,3,-377,-109,-5,-5
"11162","30",6,7,4,1,2,139,-1,2,2,215,0,2,2,4,-3,-76,-1,0,0
"11163","30",415,5,2,1,2,1,2,0,0,203,211,0,4,4,-1,-202,-209,0,-4
"11164","30",290,3,1,1,1,53,-61,1,-2,101,-82,0,-3,4,1,-48,21,1,1
"11165","30",287,3,4,1,3,69,14,1,-2,-102,16,-1,2,4,1,171,-2,2,-4
"11166","30",73,4,4,1,2,-34,19,-1,-1,-81,-63,0,0,4,0,47,82,-1,-1
"11167","30",251,2,3,1,1,90,12,0,-3,-23,-148,-2,-2,4,2,113,160,2,-1
"11168","30",13,3,4,1,1,97,-78,1,-2,33,-81,1,-2,4,1,64,3,0,0
"11169","30",470,6,1,1,1,-52,17,1,1,-50,26,-1,-1,4,-2,-2,-9,2,2
"11170","30",467,2,1,0,3,-214,164,4,-3,137,124,4,0,4,2,-351,40,0,-3
"11171","30",324,2,2,1,0,105,0,-3,-3,50,3,-3,-3,4,2,55,-3,0,0
"11172","30",320,7,2,1,2,181,70,2,2,226,125,2,3,4,-3,-45,-55,0,-1
"11173","30",414,3,1,0,0,-129,-112,-2,-2,16,20,0,0,4,1,-145,-132,-2,-2
"11174","30",261,9,1,0,3,130,74,4,4,94,80,4,4,4,-5,36,-6,0,0
"11175","30",359,9,4,1,3,221,20,4,4,206,29,4,4,4,-5,15,-9,0,0
"11176","30",355,4,2,1,2,4,-41,-3,-1,102,105,-3,-3,4,0,-98,-146,0,2
"11177","30",69,3,4,1,1,-28,43,1,-2,-132,15,-1,-2,4,1,104,28,2,0
"11178","30",129,5,4,1,1,194,4,0,0,188,-3,2,2,4,-1,6,7,-2,-2
"11179","30",441,9,4,1,2,38,28,3,4,148,59,3,2,4,-5,-110,-31,0,2
"11180","30",9,5,4,1,2,101,57,1,0,74,37,1,-1,4,-1,27,20,0,1
"11181","30",219,5,4,1,3,247,-13,4,0,249,1,4,0,4,-1,-2,-14,0,0
"11182","30",142,5,2,1,2,30,-9,-1,0,230,-187,1,0,4,-1,-200,178,-2,0
"11183","30",369,4,4,1,0,-127,1,-2,-1,-1,2,0,0,4,0,-126,-1,-2,-1
"11184","30",292,5,3,0,1,9,-68,0,0,-3,-114,0,1,4,-1,12,46,0,-1
"11185","30",257,1,1,1,0,-139,46,0,-4,97,22,1,-4,4,3,-236,24,-1,0
"11186","30",476,5,3,1,0,-197,-185,0,0,-171,-187,0,0,4,-1,-26,2,0,0
"11187","30",253,9,3,1,3,222,230,4,4,233,229,4,4,4,-5,-11,1,0,0
"11188","30",25,4,4,1,2,-13,-4,-1,-1,78,103,-1,0,4,0,-91,-107,0,-1
"11189","30",350,9,4,1,1,243,3,4,4,244,7,3,0,4,-5,-1,-4,1,4
"11190","30",347,8,1,0,3,-102,-178,-2,3,-185,155,3,4,4,-4,83,-333,-5,-1
"11191","30",194,7,1,1,0,-116,38,-4,2,-207,10,-4,2,4,-3,91,28,0,0
"11192","30",60,5,1,0,3,-3,25,0,0,1,10,3,3,4,-1,-4,15,-3,-3
"11193","30",416,1,4,1,0,-205,-218,-4,-4,-194,109,-4,-4,4,3,-11,-327,0,0
"11194","30",291,4,4,1,2,57,-45,-1,-1,244,249,4,4,4,0,-187,-294,-5,-5
"11195","30",288,8,2,0,2,-14,-43,-2,3,89,18,2,2,4,-4,-103,-61,-4,1
"11196","30",74,4,3,0,0,-247,-205,-4,-1,225,225,3,0,4,0,-472,-430,-7,-1
"11197","30",252,4,4,0,1,-109,-162,-1,-1,145,-93,1,1,4,0,-254,-69,-2,-2
"11198","30",130,9,1,0,3,208,27,4,4,118,45,4,4,4,-5,90,-18,0,0
"11199","30",471,6,3,1,2,72,-1,0,1,-190,147,1,-2,4,-2,262,-148,-1,3
"11200","30",468,6,1,0,3,63,63,-1,1,60,32,-1,0,4,-2,3,31,0,1
"11201","30",325,9,1,0,1,-107,-137,-3,4,-106,-93,-4,3,4,-5,-1,-44,1,1
"11202","30",241,5,4,1,2,174,150,2,0,196,165,2,0,4,-1,-22,-15,0,0
"11203","30",165,3,1,0,1,-190,-33,-2,-2,128,124,2,1,4,1,-318,-157,-4,-3
"11204","30",262,6,4,1,3,95,1,1,1,35,37,1,1,4,-2,60,-36,0,0
"11205","30",259,2,3,1,1,1,2,4,-3,48,24,4,-2,4,2,-47,-22,0,-1
"11206","30",49,7,4,1,1,192,46,-1,2,204,51,3,3,4,-3,-12,-5,-4,-1
"11207","30",7,6,1,1,3,85,29,1,1,89,56,1,1,4,-2,-4,-27,0,0
"11208","30",283,4,1,0,1,-122,61,-3,-1,-91,-92,-3,-1,4,0,-31,153,0,0
"11209","30",442,6,4,1,1,20,29,0,1,28,31,1,1,4,-2,-8,-2,-1,0
"11210","30",90,2,4,1,0,-210,4,-4,-3,-216,-3,-2,-2,4,2,6,7,-2,-1
"11211","30",22,5,3,0,1,-13,-12,0,0,234,6,2,2,4,-1,-247,-18,-2,-2
"11212","30",143,8,1,0,3,137,-14,3,3,136,-134,3,3,4,-4,1,120,0,0
"11213","30",37,1,1,0,0,-227,119,-4,-4,-232,88,-4,-4,4,3,5,31,0,0
"11214","30",293,1,4,1,0,-237,29,-4,-4,-210,12,-4,-4,4,3,-27,17,0,0
"11215","30",258,1,3,1,0,-34,-3,-4,-4,-17,-1,1,-1,4,3,-17,-2,-5,-3
"11216","30",48,1,3,1,0,7,-8,-4,-4,87,-92,-4,-4,4,3,-80,84,0,0
"11217","30",72,2,1,0,0,-152,14,-1,-3,211,215,3,3,4,2,-363,-201,-4,-6
"11218","30",132,6,4,1,1,-27,-126,0,1,-76,90,-1,1,4,-2,49,-216,1,0
"11219","30",351,5,1,0,0,-246,-245,0,0,244,247,-4,-4,4,-1,-490,-492,4,4
"11220","30",348,3,3,1,1,21,26,-2,-2,79,76,0,-2,4,1,-58,-50,-2,0
"11221","30",195,1,1,1,1,-233,235,4,-4,-236,230,4,-4,4,3,3,5,0,0
"11222","30",61,2,1,0,3,248,-9,4,-3,-128,113,3,-4,4,2,376,-122,1,1
"11223","30",417,5,2,0,2,0,-1,0,0,157,144,2,2,4,-1,-157,-145,-2,-2
"11224","30",264,6,4,1,2,100,33,1,1,218,239,4,1,4,-2,-118,-206,-3,0
"11225","30",289,8,1,0,3,219,220,3,3,231,210,3,3,4,-4,-12,10,0,0
"11226","30",75,1,4,1,2,216,48,-2,-4,235,158,3,-4,4,3,-19,-110,-5,0
"11227","30",71,4,3,1,1,-71,24,-1,-1,28,18,-1,0,4,0,-99,6,0,-1
"11228","30",131,8,4,1,3,127,-44,-1,3,116,-44,-1,3,4,-4,11,0,0,0
"11229","30",472,1,1,0,0,-238,239,-4,-4,-234,217,-4,-4,4,3,-4,22,0,0
"11230","30",469,1,4,1,0,35,29,-3,-4,69,29,-3,-3,4,3,-34,0,0,-1
"11231","30",326,7,4,1,2,155,120,2,2,160,93,2,2,4,-3,-5,27,0,0
"11232","30",242,4,4,1,2,125,-1,1,-1,145,166,1,-2,4,0,-20,-167,0,1
"11233","30",166,2,4,1,2,215,211,-2,-3,217,211,-2,-2,4,2,-2,0,0,-1
"11234","30",263,1,4,1,0,-241,-4,-4,-4,-238,1,-4,-4,4,3,-3,-5,0,0
"11235","30",26,1,1,0,0,-242,-200,-4,-4,-93,-80,-3,-3,4,3,-149,-120,-1,-1
"11236","30",5,5,2,1,2,159,93,1,0,139,92,2,1,4,-1,20,1,-1,-1
"11237","30",70,1,2,1,2,13,73,-2,-4,135,174,0,-3,4,3,-122,-101,-2,-1
"11238","30",284,1,3,1,1,-144,-132,-2,-4,-159,-144,-3,-4,4,3,15,12,1,0
"11239","30",443,3,1,0,0,-211,26,-1,-2,83,64,1,1,4,1,-294,-38,-2,-3
"11240","30",91,5,2,0,3,-5,0,0,0,242,2,4,4,4,-1,-247,-2,-4,-4
"11241","30",220,3,4,1,2,121,115,-4,-2,146,160,-4,-2,4,1,-25,-45,0,0
"11242","30",144,1,3,0,0,-235,6,-4,-4,1,-2,0,0,4,3,-236,8,-4,-4
"11243","30",370,9,1,0,3,232,59,4,4,-237,-18,-4,-4,4,-5,469,77,8,8
"11244","30",294,7,1,0,3,185,2,2,2,-1,0,2,2,4,-3,186,2,0,0
"11245","30",318,4,2,1,2,-48,-196,-4,-1,185,-185,-4,0,4,0,-233,-11,0,-1
"11246","30",52,2,3,0,0,-129,3,-2,-3,106,3,2,0,4,2,-235,0,-4,-3
"11247","30",234,5,3,1,3,114,46,-1,0,79,33,0,1,4,-1,35,13,-1,-1
"11248","30",45,3,3,1,0,-90,-46,-1,-2,74,-50,-2,-3,4,1,-164,4,1,1
"11249","30",28,4,4,1,1,12,-40,-1,-1,6,-9,-1,-1,4,0,6,-31,0,0
"11250","30",276,7,4,1,3,180,-1,2,2,186,1,2,2,4,-3,-6,-2,0,0
"11251","30",196,2,3,1,0,176,-1,0,-3,139,218,2,2,4,2,37,-219,-2,-5
"11252","30",62,9,2,0,3,234,21,4,4,238,218,4,4,4,-5,-4,-197,0,0
"11253","30",418,5,2,1,2,140,-225,1,0,179,-203,1,0,4,-1,-39,-22,0,0
"11254","30",265,9,1,0,3,212,1,4,4,2,-1,0,0,4,-5,210,2,4,4
"11255","30",29,1,4,1,0,-245,245,-4,-4,-247,239,-4,-4,4,3,2,6,0,0
"11256","30",76,6,4,1,3,4,1,1,1,4,1,1,0,4,-2,0,0,0,1
"11257","30",456,1,1,0,0,-131,-158,-2,-4,99,20,0,-4,4,3,-230,-178,-2,0
"11258","30",286,9,1,0,3,82,0,3,4,59,-4,3,1,4,-5,23,4,0,3
"11259","30",445,7,4,1,3,183,-31,2,2,192,-65,2,2,4,-3,-9,34,0,0
"11260","30",93,5,1,0,1,-128,88,-2,0,-114,80,-2,0,4,-1,-14,8,0,0
"11261","30",327,6,4,1,3,214,12,2,1,197,5,1,1,4,-2,17,7,1,0
"11262","30",146,2,2,1,0,-160,-183,-3,-3,-147,-141,-3,-3,4,2,-13,-42,0,0
"11263","30",372,1,3,1,0,-242,-231,-4,-4,-34,-54,-4,-2,4,3,-208,-177,0,-2
"11264","30",24,8,2,1,2,124,1,1,3,230,-191,0,4,4,-4,-106,192,1,-1
"11265","30",260,2,3,1,0,-248,-249,-3,-3,-238,-234,-3,-3,4,2,-10,-15,0,0
"11266","30",50,3,2,1,1,66,-9,0,-2,112,-54,2,-2,4,1,-46,45,-2,0
"11267","30",455,3,2,1,2,-228,-74,-2,-2,230,-2,3,3,4,1,-458,-72,-5,-5
"11268","30",285,6,2,1,1,-43,-129,-2,1,-2,-151,-2,1,4,-2,-41,22,0,0
"11269","30",444,5,2,1,2,1,-4,0,0,51,46,1,1,4,-1,-50,-50,-1,-1
"11270","30",92,5,4,1,2,8,6,0,0,-3,-3,0,0,4,-1,11,9,0,0
"11271","30",221,6,4,0,1,-4,23,1,1,-5,4,1,1,4,-2,1,19,0,0
"11272","30",145,6,1,0,1,126,6,0,1,-17,14,0,1,4,-2,143,-8,0,0
"11273","30",371,2,3,0,0,-200,119,-3,-3,46,-7,-4,-3,4,2,-246,126,1,0
"11274","30",295,5,1,0,1,-4,-1,0,0,1,3,0,0,4,-1,-5,-4,0,0
"11275","30",319,7,1,0,1,114,0,2,2,-161,-6,1,1,4,-3,275,6,1,1
"11276","30",53,7,4,1,3,174,-2,2,2,6,-33,1,1,4,-3,168,31,1,1
"11277","30",235,1,3,0,0,-242,-238,-4,-4,233,1,4,4,4,3,-475,-239,-8,-8
"11278","30",450,3,4,0,3,70,-1,1,-2,-1,168,1,-2,4,1,71,-169,0,0
"11279","30",280,5,2,1,1,97,101,1,0,-33,24,0,-1,4,-1,130,77,1,1
"11280","30",277,3,4,1,1,-17,-76,2,-2,55,-145,0,0,4,1,-72,69,2,-2
"11281","30",197,6,4,1,3,137,-6,1,1,64,-37,3,1,4,-2,73,31,-2,0
"11282","30",63,4,4,1,1,-2,1,-1,-1,-2,1,0,0,4,0,0,0,-1,-1
"11283","30",419,5,4,1,3,116,102,0,0,110,100,1,0,4,-1,6,2,-1,0
"11284","30",266,5,1,0,1,-75,4,0,0,-69,-2,-2,-2,4,-1,-6,6,2,2
"11285","30",452,4,3,0,1,-65,4,-1,-1,-159,4,-2,-2,4,0,94,0,1,1
"11286","30",457,2,3,0,1,-47,-8,-2,-3,152,-80,2,2,4,2,-199,72,-4,-5
"11287","30",279,8,4,1,3,162,90,1,3,171,88,0,2,4,-4,-9,2,1,1
"11288","30",453,8,4,1,2,207,-11,3,3,221,0,3,3,4,-4,-14,-11,0,0
"11289","30",446,5,4,1,1,80,7,0,0,12,14,0,0,4,-1,68,-7,0,0
"11290","30",94,3,4,1,1,86,-86,4,-2,110,-81,4,-2,4,1,-24,-5,0,0
"11291","30",328,4,3,1,1,-49,14,-1,-1,17,12,1,1,4,0,-66,2,-2,-2
"11292","30",147,6,2,1,3,85,165,4,1,168,123,4,4,4,-2,-83,42,0,-3
"11293","30",373,1,3,1,0,-207,-218,1,-4,-221,-177,-1,-4,4,3,14,-41,2,0
"11294","30",240,2,2,0,1,195,6,2,-3,209,-214,3,-3,4,2,-14,220,-1,0
"11295","30",451,2,1,0,0,-177,-169,-3,-3,-204,-162,-3,-3,4,2,27,-7,0,0
"11296","30",51,7,4,1,1,7,16,1,2,-64,65,-1,1,4,-3,71,-49,2,1
"11297","30",237,5,2,1,2,107,3,1,0,132,3,0,2,4,-1,-25,0,1,-2
"11298","30",198,4,1,0,1,-22,-148,1,-1,44,-208,0,1,4,0,-66,60,1,-2
"11299","30",282,9,3,1,3,-85,-41,0,4,179,33,0,4,4,-5,-264,-74,0,0
"11300","30",42,3,3,1,1,-7,6,2,-2,-25,17,2,-3,4,1,18,-11,0,1
"11301","30",222,2,1,0,0,0,0,-3,-3,-239,2,-3,-3,4,2,239,-2,0,0
"11302","30",65,7,1,0,3,72,57,2,2,52,40,1,2,4,-3,20,17,1,0
"11303","30",420,9,4,1,3,1,-142,3,4,-2,-1,0,0,4,-5,3,-141,3,4
"11304","30",296,6,1,0,3,101,3,1,1,167,60,1,1,4,-2,-66,-57,0,0
"11305","30",454,7,4,0,3,176,1,2,2,176,1,2,2,4,-3,0,0,0,0
"11306","30",54,6,4,1,1,9,-7,1,1,135,53,1,1,4,-2,-126,-60,0,0
"11307","30",236,5,1,0,1,-4,-10,0,0,-17,-18,0,0,4,-1,13,8,0,0
"11308","30",329,5,4,1,3,-123,133,-1,0,-165,64,-3,-1,4,-1,42,69,2,1
"11309","30",281,1,4,1,2,-1,-247,-4,-4,-12,-245,-4,-4,4,3,11,-2,0,0
"11310","30",278,1,4,1,1,-35,-236,4,-4,239,-235,4,-4,4,3,-274,-1,0,0
"11311","30",395,3,3,1,1,-204,14,3,-2,163,30,-2,3,4,1,-367,-16,5,-5
"11312","30",64,9,1,0,1,224,-221,4,4,233,-3,4,4,4,-5,-9,-218,0,0
"11313","30",238,7,3,1,1,-76,-86,-4,2,110,67,2,2,4,-3,-186,-153,-6,0
"11314","30",267,5,3,1,1,-1,-1,0,0,-1,-1,0,0,4,-1,0,0,0,0
"11315","30",199,8,4,1,2,216,154,3,3,219,153,1,3,4,-4,-3,1,2,0
"11316","30",458,2,1,0,1,-56,-70,-1,-3,72,81,-1,-2,4,2,-128,-151,0,-1
"11317","30",98,1,3,0,0,-241,-38,-4,-4,-231,62,-2,-3,4,3,-10,-100,-2,-1
"11318","30",223,5,1,0,1,-4,0,0,0,1,1,0,0,4,-1,-5,-1,0,0
"11319","30",447,7,4,1,2,225,103,0,2,176,127,-1,3,4,-3,49,-24,1,-1
"11320","30",95,6,4,1,2,76,4,1,1,-1,-10,1,1,4,-2,77,14,0,0
"11321","30",297,2,3,1,2,-228,21,-3,-3,-240,14,-3,-3,4,2,12,7,0,0
"11322","30",148,1,1,0,1,-198,-81,2,-4,-197,-98,2,-4,4,3,-1,17,0,0
"11323","30",374,7,4,1,2,119,64,2,2,177,140,3,3,4,-3,-58,-76,-1,-1
"11324","30",96,2,1,0,0,-238,-15,-3,-3,-225,7,-3,-3,4,2,-13,-22,0,0
"11325","30",233,5,2,1,2,26,52,0,0,56,60,0,0,4,-1,-30,-8,0,0
"11326","30",449,6,4,1,3,90,-11,1,1,149,-9,1,1,4,-2,-59,-2,0,0
"11327","30",97,2,1,0,1,-203,22,2,-3,68,10,3,-1,4,2,-271,12,-1,-2
"11328","30",396,1,1,0,1,-250,247,4,-4,-244,243,4,-4,4,3,-6,4,0,0
"11329","30",158,6,3,1,0,130,-115,-1,1,-165,-21,-2,-2,4,-2,295,-94,1,3
"11330","30",376,4,4,1,1,-33,-166,-1,-1,24,-155,-1,-1,4,0,-57,-11,0,0
"11331","30",268,8,4,0,3,94,-172,3,3,103,-101,3,3,4,-4,-9,-71,0,0
"11332","30",425,4,4,1,2,-11,26,0,-1,2,23,1,0,4,0,-13,3,-1,-1
"11333","30",421,3,3,0,1,-143,38,-2,-2,85,70,0,-1,4,1,-228,-32,-2,-1
"11334","30",99,8,4,1,3,213,-15,1,3,236,-8,2,3,4,-4,-23,-7,-1,0
"11335","30",232,1,1,0,0,-234,-224,-4,-4,-243,-242,-4,-4,4,3,9,18,0,0
"11336","30",46,1,1,0,0,-110,-245,-4,-4,-9,-234,-2,-3,4,3,-101,-11,-2,-1
"11337","30",422,1,3,1,1,-121,-201,4,-4,-2,-213,3,0,4,3,-119,12,1,-4
"11338","30",33,6,3,0,1,61,-50,-4,1,-39,64,-1,1,4,-2,100,-114,-3,0
"11339","30",149,6,3,1,1,186,-7,-2,1,242,6,-3,1,4,-2,-56,-13,1,0
"11340","30",375,4,3,1,1,-11,1,-1,-1,0,-1,0,0,4,0,-11,2,-1,-1
"11341","30",157,1,3,1,2,-96,-121,-4,-4,144,104,-2,0,4,3,-240,-225,-2,-4
"11342","30",15,6,4,1,3,-42,23,2,1,-59,24,1,2,4,-2,17,-1,1,-1
"11343","30",239,7,1,0,1,-108,-25,1,2,125,-95,1,2,4,-3,-233,70,0,0
"11344","30",388,3,4,1,0,224,1,1,-2,-2,-245,1,-1,4,1,226,246,0,-1
"11345","30",227,7,3,1,3,-156,-131,1,2,44,18,1,2,4,-3,-200,-149,0,0
"11346","30",459,1,3,1,1,-174,-202,3,-4,-182,-178,2,-4,4,3,8,-24,1,0
"11347","30",377,1,1,0,0,-243,6,-4,-4,-246,10,-4,-4,4,3,3,-4,0,0
"11348","30",224,7,2,1,2,127,66,2,2,87,66,2,2,4,-3,40,0,0,0
"11349","30",448,6,2,1,2,239,2,2,1,246,-4,-3,2,4,-2,-7,6,5,-1
"11350","30",16,1,1,0,0,-226,233,-1,-4,94,16,1,-2,4,3,-320,217,-2,-2
"11351","30",298,3,1,0,0,-242,1,-1,-2,-1,-240,0,-2,4,1,-241,241,-1,0
"11352","30",225,9,2,1,2,198,17,4,4,36,237,4,4,4,-5,162,-220,0,0
"11353","30",160,7,2,0,0,-132,27,-4,2,-46,26,-4,2,4,-3,-86,1,0,0
"11354","30",423,8,1,0,3,117,9,-1,3,-50,22,1,0,4,-4,167,-13,-2,3
"11355","30",226,1,1,0,0,-235,-1,-3,-4,122,-4,2,-4,4,3,-357,3,-5,0
"11356","30",161,3,2,1,2,93,76,1,-2,108,67,1,-2,4,1,-15,9,0,0
"11357","30",424,6,2,0,2,-22,-10,1,1,161,157,2,1,4,-2,-183,-167,-1,0
"11358","30",3,4,3,1,0,162,2,-2,-1,-56,0,-3,-3,4,0,218,2,1,2
"11359","30",159,1,3,0,2,-240,15,-4,-4,218,4,4,4,4,3,-458,11,-8,-8
"11360","30",162,8,3,1,3,143,138,-3,3,116,109,3,4,4,-4,27,29,-6,-1
"11361","30",269,6,4,1,2,104,1,1,1,250,74,1,1,4,-2,-146,-73,0,0
"11362","30",426,8,4,1,3,244,4,3,3,238,2,3,3,4,-4,6,2,0,0
"11363","30",151,1,2,1,1,-28,11,0,-4,10,11,0,-4,4,3,-38,0,0,0
"11364","30",156,6,2,0,1,33,-1,1,1,35,2,1,1,4,-2,-2,-3,0,0
"11365","30",27,5,2,1,2,115,69,1,0,75,81,1,0,4,-1,40,-12,0,0
"11366","30",427,3,4,1,1,51,10,2,-2,220,24,2,-1,4,1,-169,-14,0,-1
"11367","30",164,8,2,1,2,169,207,2,3,148,-186,2,2,4,-4,21,393,0,1
"11368","30",299,7,4,0,1,192,-15,2,2,77,158,2,2,4,-3,115,-173,0,0
"11369","30",428,1,1,0,0,-241,243,-4,-4,-239,241,-4,-4,4,3,-2,2,0,0
"11370","30",153,5,1,0,3,-197,-30,3,0,-177,-125,1,1,4,-1,-20,95,2,-1
"11371","30",391,6,2,1,3,177,200,0,1,131,108,0,0,4,-2,46,92,0,1
"11372","30",150,5,3,0,1,-2,2,0,0,-2,2,0,0,4,-1,0,0,0,0
"11373","30",154,6,4,1,3,98,-3,0,1,129,10,1,1,4,-2,-31,-13,-1,0
"11374","30",389,9,3,1,2,200,2,-4,4,45,-31,1,1,4,-5,155,33,-5,3
"11375","30",228,7,4,1,2,0,-6,2,2,114,77,3,3,4,-3,-114,-83,-1,-1
"11376","30",231,3,4,1,0,-79,-75,0,-2,-1,3,-1,-2,4,1,-78,-78,1,0
"11377","30",378,4,4,1,1,-116,-7,1,-1,-162,-4,-2,-2,4,0,46,-3,3,1
"11378","30",39,6,3,1,1,119,26,2,1,182,190,3,3,4,-2,-63,-164,-1,-2
"11379","30",229,3,1,0,1,-164,-43,-2,-2,-197,-75,-2,-3,4,1,33,32,0,1
"11380","30",152,1,1,0,0,-237,-2,-4,-4,99,-11,0,-4,4,3,-336,9,-4,0
"11381","30",390,8,2,1,2,101,-16,2,3,180,164,4,4,4,-4,-79,-180,-2,-1
"11382","30",23,9,1,0,3,216,195,4,4,214,205,4,4,4,-5,2,-10,0,0
"11383","30",387,1,3,1,1,-199,-187,-3,-4,178,131,1,0,4,3,-377,-318,-4,-4
"11384","30",38,9,4,1,3,0,0,4,4,140,5,4,4,4,-5,-140,-5,0,0
"11385","30",230,6,1,1,0,-141,-16,-3,1,-213,-4,-3,0,4,-2,72,-12,0,1
"11386","30",314,1,4,0,1,-236,11,4,-4,-239,12,4,-4,4,3,3,-1,0,0
"11387","30",380,2,4,1,1,211,-48,3,-3,-111,-34,3,-3,4,2,322,-14,0,0
"11388","30",30,6,2,1,2,-1,-10,2,1,172,-6,2,2,4,-2,-173,-4,0,-1
"11389","30",272,4,4,1,2,58,-22,0,-1,157,35,1,1,4,0,-99,-57,-1,-2
"11390","30",163,6,3,0,1,129,78,-1,1,51,-61,2,1,4,-2,78,139,-3,0
"11391","30",381,9,2,0,2,217,211,4,4,170,170,2,2,4,-5,47,41,2,2
"11392","30",300,2,1,0,0,-193,38,-2,-3,-25,33,0,0,4,2,-168,5,-2,-3
"11393","30",386,1,1,0,0,-237,208,-4,-4,20,30,0,-1,4,3,-257,178,-4,-3
"11394","30",379,1,3,1,1,-56,-127,3,-4,128,59,2,0,4,3,-184,-186,1,-4
"11395","30",270,6,3,1,1,77,3,1,1,249,4,4,4,4,-2,-172,-1,-3,-3
"11396","30",301,6,4,1,1,43,0,2,1,33,3,1,2,4,-2,10,-3,1,-1
"11397","30",31,1,1,0,0,-136,104,-4,-4,-128,106,-4,-4,4,3,-8,-2,0,0
"11398","30",271,4,3,1,1,112,2,-4,-1,98,-5,3,4,4,0,14,7,-7,-5
"11399","30",302,3,1,0,0,-188,-24,-3,-2,218,30,-2,-2,4,1,-406,-54,-1,0
"11400","30",310,4,4,1,2,102,23,0,-1,158,56,1,1,4,0,-56,-33,-1,-2
"11401","30",392,2,1,1,0,-232,235,-3,-3,-136,0,-1,-1,4,2,-96,235,-2,-2
"11402","30",273,4,1,0,0,0,-5,-1,-1,-29,-13,1,0,4,0,29,8,-2,-1
"11403","30",155,6,2,1,1,221,230,4,1,238,242,1,1,4,-2,-17,-12,3,0
"11404","30",311,1,2,1,2,179,17,2,-4,197,22,4,-4,4,3,-18,-5,-2,0
"11405","30",393,1,1,0,0,-233,-23,-4,-4,-59,-96,-4,-4,4,3,-174,73,0,0
"11406","30",317,4,4,0,2,-28,23,-1,-1,-96,104,-2,-2,4,0,68,-81,1,1
"11407","30",309,7,4,1,2,232,-37,0,2,205,85,-1,-1,4,-3,27,-122,1,3
"11408","30",394,9,3,1,0,47,3,4,4,-179,-2,4,4,4,-5,226,5,0,0
"11409","30",275,7,4,1,2,245,3,2,2,243,0,3,3,4,-3,2,3,-1,-1
"11410","30",384,2,1,0,0,-93,1,-3,-3,0,14,-2,-3,4,2,-93,-13,-1,0
"11411","30",383,5,4,1,1,-2,3,0,0,2,-4,0,0,4,-1,-4,7,0,0
"11412","30",315,8,3,0,3,244,9,4,3,10,214,3,3,4,-4,234,-205,1,0
"11413","30",307,7,4,1,2,167,105,2,2,96,41,3,3,4,-3,71,64,-1,-1
"11414","30",385,4,4,0,1,75,55,1,-1,144,174,3,1,4,0,-69,-119,-2,-2
"11415","30",274,8,4,1,2,179,109,3,3,194,145,2,2,4,-4,-15,-36,1,1
"11416","30",316,3,3,1,0,-146,-18,-2,-2,-109,-42,-2,-2,4,1,-37,24,0,0
"11417","30",382,6,4,1,2,4,-1,1,1,185,19,3,3,4,-2,-181,-20,-2,-2
"11418","30",312,4,4,1,1,-183,96,0,-1,121,-111,4,4,4,0,-304,207,-4,-5
"11419","30",306,5,3,1,3,134,118,1,0,142,111,1,0,4,-1,-8,7,0,0
"11420","30",313,2,3,1,0,-201,-250,-3,-3,-215,-192,-3,-3,4,2,14,-58,0,0
"11421","30",303,4,3,1,2,-24,-68,-1,-1,79,-42,2,1,4,0,-103,-26,-3,-2
"11422","30",308,3,4,1,0,-115,-98,-4,-2,-1,2,0,1,4,1,-114,-100,-4,-3
"11423","30",304,6,2,1,2,100,-23,1,1,104,-24,1,1,4,-2,-4,1,0,0
"11424","30",305,9,4,1,3,239,240,4,4,235,239,4,4,4,-5,4,1,0,0
"11425","4",77,5,3,0,1,-109,17,-1,0,-115,1,-1,-1,1,-4,6,16,0,1
"11426","4",55,5,4,1,1,-9,2,0,0,1,7,1,1,1,-4,-10,-5,-1,-1
"11427","4",43,5,3,0,0,-121,1,-3,0,105,-3,0,0,1,-4,-226,4,-3,0
"11428","4",48,1,3,1,0,11,-11,-4,-4,89,-83,-4,-4,1,0,-78,72,0,0
"11429","4",136,1,1,0,0,0,0,-4,-4,0,-1,-3,-3,1,0,0,1,-1,-1
"11430","4",8,5,3,0,1,7,-17,0,0,146,97,-1,0,1,-4,-139,-114,1,0
"11431","4",78,3,4,1,0,-142,0,-2,-2,50,-6,-2,-3,1,-2,-192,6,0,1
"11432","4",474,1,1,0,0,2,-85,-4,-4,3,-90,-2,-4,1,0,-1,5,-2,0
"11433","4",79,2,4,0,2,-234,33,-3,-3,-240,14,-3,-3,1,-1,6,19,0,0
"11434","4",49,7,4,1,1,86,42,2,2,113,50,1,1,1,-6,-27,-8,1,1
"11435","4",429,1,2,0,0,-231,-181,-4,-4,-143,-75,0,-4,1,0,-88,-106,-4,0
"11436","4",58,7,4,1,1,-236,-1,-2,2,-9,239,4,4,1,-6,-227,-240,-6,-2
"11437","4",50,4,2,0,1,-7,-1,0,-1,49,-78,0,-1,1,-3,-56,77,0,0
"11438","4",135,2,1,0,1,-206,154,-3,-3,-160,96,-3,-3,1,-1,-46,58,0,0
"11439","4",134,2,2,0,2,-97,-18,0,-3,-96,-20,0,-4,1,-1,-1,2,0,1
"11440","4",59,3,1,0,0,-35,48,-2,-2,76,-82,2,2,1,-2,-111,130,-4,-4
"11441","4",320,2,2,0,2,-246,138,-3,-3,-210,134,-3,-2,1,-1,-36,4,0,-1
"11442","4",56,3,3,1,1,36,-133,-2,-2,38,-127,-2,-2,1,-2,-2,-6,0,0
"11443","4",430,5,2,0,1,50,-54,0,0,182,-118,1,1,1,-4,-132,64,-1,-1
"11444","4",133,1,2,0,1,-86,-204,0,-4,60,-209,1,-1,1,0,-146,5,-1,-3
"11445","4",52,5,3,0,0,-223,3,-2,0,70,4,2,-1,1,-4,-293,-1,-4,1
"11446","4",57,1,4,1,1,-2,-233,1,-4,2,-213,1,-4,1,0,-4,-20,0,0
"11447","4",80,7,4,1,3,213,5,3,2,226,1,3,-2,1,-6,-13,4,0,4
"11448","4",331,2,1,0,0,-221,-33,-4,-3,230,229,-4,-2,1,-1,-451,-262,0,-1
"11449","4",475,5,3,0,3,79,-61,0,0,45,-159,0,0,1,-4,34,98,0,0
"11450","4",32,1,1,1,1,-236,-19,-4,-4,0,2,0,0,1,0,-236,-21,-4,-4
"11451","4",82,1,4,1,2,-238,-14,-4,-4,16,-237,4,-4,1,0,-254,223,-8,0
"11452","4",139,1,4,1,2,-227,-43,-4,-4,18,226,4,4,1,0,-245,-269,-8,-8
"11453","4",476,4,3,1,0,-197,-182,-1,-1,-72,-100,0,0,1,-3,-125,-82,-1,-1
"11454","4",41,6,2,0,3,32,72,2,1,42,67,2,1,1,-5,-10,5,0,0
"11455","4",51,9,4,1,1,114,88,4,4,110,128,-2,1,1,-8,4,-40,6,3
"11456","4",473,4,3,1,0,-172,-10,1,-1,-151,-47,0,0,1,-3,-21,37,1,-1
"11457","4",6,4,4,1,2,-136,0,-1,-1,-90,0,-2,-2,1,-3,-46,0,1,1
"11458","4",137,4,1,0,1,-208,-208,-3,-1,146,146,1,-1,1,-3,-354,-354,-4,0
"11459","4",408,3,1,0,0,-218,9,-2,-2,-101,-6,0,0,1,-2,-117,15,-2,-2
"11460","4",5,1,2,0,2,-224,7,-2,-4,-239,107,-2,-3,1,0,15,-100,0,-1
"11461","4",60,8,1,0,3,217,-1,3,3,222,1,3,3,1,-7,-5,-2,0,0
"11462","4",53,7,4,1,3,201,0,2,2,68,8,2,2,1,-6,133,-8,0,0
"11463","4",409,6,4,0,2,-153,-179,3,1,104,109,2,2,1,-5,-257,-288,1,-1
"11464","4",210,1,4,1,2,-227,-27,2,-4,-102,-85,3,-3,1,0,-125,58,-1,-1
"11465","4",332,1,1,0,0,-248,9,-3,-4,-246,60,-2,-2,1,0,-2,-51,-1,-2
"11466","4",54,3,4,1,1,-11,-6,-2,-2,230,-8,0,0,1,-2,-241,2,-2,-2
"11467","4",434,7,4,1,3,200,-6,3,2,204,-8,2,2,1,-6,-4,2,1,0
"11468","4",265,8,1,0,3,112,1,2,3,1,-3,0,0,1,-7,111,4,2,3
"11469","4",431,3,3,1,0,-215,22,-3,-2,4,9,0,0,1,-2,-219,13,-3,-2
"11470","4",407,1,2,0,2,-210,140,-4,-4,126,99,2,2,1,0,-336,41,-6,-6
"11471","4",321,5,1,0,0,-33,-29,0,0,-33,-29,0,0,1,-4,0,0,0,0
"11472","4",432,5,2,1,1,8,-4,0,0,25,-26,0,0,1,-4,-17,22,0,0
"11473","4",81,3,1,0,0,-59,36,-2,-2,-98,83,-3,-3,1,-2,39,-47,1,1
"11474","4",411,1,2,0,2,-238,-237,-4,-4,228,231,2,4,1,0,-466,-468,-6,-8
"11475","4",138,6,3,0,1,132,-24,1,1,68,-46,1,1,1,-5,64,22,0,0
"11476","4",433,1,1,0,0,-186,-236,-4,-4,198,187,4,-3,1,0,-384,-423,-8,-1
"11477","4",190,7,4,1,3,207,232,2,2,180,128,2,2,1,-6,27,104,0,0
"11478","4",61,1,1,0,3,222,-25,4,-4,1,3,4,-4,1,0,221,-28,0,0
"11479","4",268,8,4,1,3,129,-135,2,3,99,134,2,2,1,-7,30,-269,0,1
"11480","4",18,4,3,0,1,-82,-100,1,-1,21,16,1,0,1,-3,-103,-116,0,-1
"11481","4",83,6,1,0,3,93,-134,2,1,125,-133,2,1,1,-5,-32,-1,0,0
"11482","4",14,5,3,0,1,-47,-3,0,0,210,-29,2,2,1,-4,-257,26,-2,-2
"11483","4",189,3,1,0,1,-224,46,3,-2,-47,59,2,-3,1,-2,-177,-13,1,1
"11484","4",410,1,1,0,0,-224,-13,-2,-4,-37,-8,-1,-4,1,0,-187,-5,-1,0
"11485","4",266,5,1,0,1,3,-9,0,0,0,0,0,0,1,-4,3,-9,0,0
"11486","4",21,2,4,0,2,-159,-136,-3,-3,196,203,-1,0,1,-1,-355,-339,-2,-3
"11487","4",436,5,4,1,3,58,-197,2,0,14,-237,2,-1,1,-4,44,40,0,1
"11488","4",73,1,4,0,2,-180,69,-4,-4,-190,116,-4,-4,1,0,10,-47,0,0
"11489","4",179,5,1,0,1,-1,-1,2,0,2,-1,0,1,1,-4,-3,0,2,-1
"11490","4",7,6,1,0,3,149,118,2,1,72,68,1,2,1,-5,77,50,1,-1
"11491","4",412,9,1,0,0,-243,90,-3,4,242,4,4,4,1,-8,-485,86,-7,0
"11492","4",74,1,3,0,0,-213,-68,-4,-4,-41,-28,-1,0,1,0,-172,-40,-3,-4
"11493","4",324,5,2,0,0,-11,5,0,0,-158,-23,-2,-2,1,-4,147,28,2,2
"11494","4",211,7,3,0,1,-24,-20,-1,2,112,151,-2,1,1,-6,-136,-171,1,1
"11495","4",333,5,4,1,1,26,-26,0,0,-52,-104,0,0,1,-4,78,78,0,0
"11496","4",269,2,4,1,2,-248,216,-3,-3,249,147,0,-2,1,-1,-497,69,-3,-1
"11497","4",435,4,4,1,1,-1,-1,-1,-1,224,3,-1,0,1,-3,-225,-4,0,-1
"11498","4",330,2,2,1,2,-234,1,0,-3,190,164,2,2,1,-1,-424,-163,-2,-5
"11499","4",19,4,2,0,2,-115,-32,0,-1,-97,-23,0,-1,1,-3,-18,-9,0,0
"11500","4",178,5,1,0,1,-1,6,0,0,161,7,2,2,1,-4,-162,-1,-2,-2
"11501","4",322,6,4,0,3,179,-214,0,1,229,-238,2,2,1,-5,-50,24,-2,-1
"11502","4",267,4,3,1,1,-75,3,-1,-1,82,-14,1,1,1,-3,-157,17,-2,-2
"11503","4",323,1,4,1,1,0,-43,-4,-4,191,2,0,-4,1,0,-191,-45,-4,0
"11504","4",66,4,1,1,1,-235,1,-1,-1,172,0,-1,1,1,-3,-407,1,0,-2
"11505","4",328,4,3,1,1,-28,8,-1,-1,5,8,1,1,1,-3,-33,0,-2,-2
"11506","4",462,9,3,0,3,0,88,4,4,190,202,-4,-4,1,-8,-190,-114,8,8
"11507","4",191,2,1,0,0,-206,-30,-2,-3,-183,-54,-2,-3,1,-1,-23,24,0,0
"11508","4",62,9,2,1,3,-217,-10,-4,4,220,247,4,4,1,-8,-437,-257,-8,0
"11509","4",75,4,4,0,2,231,27,0,-1,245,239,4,-2,1,-3,-14,-212,-4,1
"11510","4",180,1,2,0,2,-60,-33,-2,-4,-111,2,-2,-2,1,0,51,-35,0,-2
"11511","4",84,6,4,1,3,133,3,1,1,125,8,2,1,1,-5,8,-5,-1,0
"11512","4",140,6,1,0,1,11,-38,1,1,6,54,-1,-1,1,-5,5,-92,2,2
"11513","4",326,5,4,1,2,0,-1,0,0,-40,-33,0,0,1,-4,40,32,0,0
"11514","4",213,4,2,1,1,-104,1,-1,-1,99,1,1,-1,1,-3,-203,0,-2,0
"11515","4",335,6,2,0,1,44,17,1,1,133,38,2,2,1,-5,-89,-21,-1,-1
"11516","4",141,1,1,0,0,-12,-16,-4,-4,77,12,1,1,1,0,-89,-28,-5,-5
"11517","4",437,3,1,0,0,-216,0,-2,-2,-195,-3,-2,-2,1,-2,-21,3,0,0
"11518","4",100,8,4,1,3,228,-1,3,3,181,-3,3,3,1,-7,47,2,0,0
"11519","4",336,3,4,1,3,175,164,2,-2,180,145,2,-3,1,-2,-5,19,0,1
"11520","4",70,1,2,0,2,-235,-170,1,-4,238,235,4,2,1,0,-473,-405,-3,-6
"11521","4",413,7,1,0,1,-195,3,0,2,-221,2,-2,-2,1,-6,26,1,2,4
"11522","4",329,6,4,1,3,-197,-21,-1,1,121,-101,2,2,1,-5,-318,80,-3,-1
"11523","4",325,8,1,0,1,-15,-12,-1,3,14,16,2,4,1,-7,-29,-28,-3,-1
"11524","4",212,1,1,1,1,-237,31,0,-4,-237,35,0,-3,1,0,0,-4,0,-1
"11525","4",334,1,4,1,0,-247,129,-4,-4,-242,117,-4,-4,1,0,-5,12,0,0
"11526","4",27,5,2,1,2,-21,-34,0,0,24,12,0,0,1,-4,-45,-46,0,0
"11527","4",193,1,1,0,0,-221,-63,-4,-4,191,-38,1,1,1,0,-412,-25,-5,-5
"11528","4",85,1,2,0,2,-112,-107,-4,-4,-140,-101,-3,-4,1,0,28,-6,-1,0
"11529","4",363,8,3,1,3,250,-8,3,3,248,-1,3,3,1,-7,2,-7,0,0
"11530","4",182,9,4,1,3,60,-28,4,4,-4,-215,0,2,1,-8,64,187,4,2
"11531","4",214,9,1,0,3,129,2,4,4,127,-1,3,4,1,-8,2,3,1,0
"11532","4",400,5,4,1,2,19,23,-2,0,34,28,2,2,1,-4,-15,-5,-4,-2
"11533","4",398,2,4,0,2,-243,7,-3,-3,148,141,2,2,1,-1,-391,-134,-5,-5
"11534","4",67,1,1,0,0,-21,26,-4,-4,123,-150,1,1,1,0,-144,176,-5,-5
"11535","4",101,1,3,1,0,-242,242,-4,-4,227,229,-3,-3,1,0,-469,13,-1,-1
"11536","4",463,9,4,1,3,249,-5,4,4,232,-17,4,4,1,-8,17,12,0,0
"11537","4",192,7,4,1,1,136,5,2,2,2,111,1,2,1,-6,134,-106,1,0
"11538","4",63,1,4,0,1,-242,4,-4,-4,1,1,0,0,1,0,-243,3,-4,-4
"11539","4",76,5,4,1,3,0,-3,4,0,0,-3,0,0,1,-4,0,0,4,0
"11540","4",181,6,4,1,3,-26,-103,1,1,148,155,0,0,1,-5,-174,-258,1,1
"11541","4",415,5,2,0,2,-1,-3,0,0,111,171,0,1,1,-4,-112,-174,0,-1
"11542","4",327,4,4,1,3,24,-166,1,-1,97,118,1,-1,1,-3,-73,-284,0,0
"11543","4",397,8,4,1,3,120,-134,3,3,155,-148,3,3,1,-7,-35,14,0,0
"11544","4",404,5,1,1,1,58,-61,1,0,49,-45,1,0,1,-4,9,-16,0,0
"11545","4",86,7,4,0,3,172,8,2,2,123,-125,2,3,1,-6,49,133,0,-1
"11546","4",142,2,2,1,2,-88,88,-3,-3,32,14,1,0,1,-1,-120,74,-4,-3
"11547","4",438,5,4,1,3,1,-1,0,0,0,-1,4,0,1,-4,1,0,-4,0
"11548","4",215,2,1,0,0,-172,31,-2,-3,55,25,-2,-3,1,-1,-227,6,0,0
"11549","4",337,4,2,0,3,-132,33,-1,-1,242,-17,4,4,1,-3,-374,50,-5,-5
"11550","4",71,4,3,1,1,-66,14,-1,-1,34,16,0,0,1,-3,-100,-2,-1,-1
"11551","4",414,2,1,0,0,-179,-175,-3,-3,3,4,0,0,1,-1,-182,-179,-3,-3
"11552","4",33,4,3,1,1,15,-9,0,-1,-218,-106,-3,2,1,-3,233,97,3,-3
"11553","4",4,5,3,0,1,235,-13,0,0,23,-13,1,1,1,-4,212,0,-1,-1
"11554","4",403,2,1,1,0,-105,-25,0,-3,17,-5,1,0,1,-1,-122,-20,-1,-3
"11555","4",64,9,1,0,1,229,-75,4,4,228,-64,4,4,1,-8,1,-11,0,0
"11556","4",270,5,3,1,1,70,5,0,0,105,-2,1,1,1,-4,-35,7,-1,-1
"11557","4",194,9,1,0,0,-232,11,-4,4,-219,12,-4,4,1,-8,-13,-1,0,0
"11558","4",416,1,4,1,0,-238,229,-4,-4,-202,223,-4,-4,1,0,-36,6,0,0
"11559","4",364,5,3,1,1,-12,33,0,0,1,69,-3,0,1,-4,-13,-36,3,0
"11560","4",183,5,4,1,1,-37,20,0,0,93,165,1,0,1,-4,-130,-145,-1,0
"11561","4",405,4,4,0,1,0,-1,0,-1,85,-60,0,1,1,-3,-85,59,0,-2
"11562","4",401,3,2,0,1,-106,39,0,-2,95,-3,0,-2,1,-2,-201,42,0,0
"11563","4",399,4,4,1,3,152,4,-1,-1,-124,7,-1,-1,1,-3,276,-3,0,0
"11564","4",68,1,4,0,0,-219,4,-3,-4,200,22,2,-3,1,0,-419,-18,-5,-1
"11565","4",102,8,4,1,3,67,97,-1,3,-98,-35,-1,3,1,-7,165,132,0,0
"11566","4",464,6,1,0,1,68,29,1,1,74,12,1,1,1,-5,-6,17,0,0
"11567","4",395,4,3,1,1,-149,59,-2,-1,215,38,3,3,1,-3,-364,21,-5,-4
"11568","4",460,4,1,0,0,-157,8,-3,-1,137,24,-2,1,1,-3,-294,-16,-1,-2
"11569","4",339,4,3,1,1,96,82,-1,-1,59,43,-3,-3,1,-3,37,39,2,2
"11570","4",287,1,4,1,3,-214,-19,-4,-4,156,1,2,3,1,0,-370,-20,-6,-7
"11571","4",206,1,4,0,0,196,3,-3,-4,194,38,-2,2,1,0,2,-35,-1,-6
"11572","4",202,4,1,0,1,-83,42,-2,-1,82,-43,-2,0,1,-3,-165,85,0,-1
"11573","4",2,7,4,1,1,-118,-28,-1,2,-211,-99,-2,-1,1,-6,93,71,1,3
"11574","4",467,9,1,0,3,-39,-36,4,4,126,161,4,0,1,-8,-165,-197,0,4
"11575","4",87,5,4,1,3,248,1,1,0,-8,-244,0,1,1,-4,256,245,1,-1
"11576","4",143,6,1,0,3,-9,12,4,1,61,-102,2,2,1,-5,-70,114,2,-1
"11577","4",439,5,2,1,1,3,4,0,0,9,-1,0,0,1,-4,-6,5,0,0
"11578","4",216,4,3,1,1,33,-7,0,-1,-76,-9,-2,-3,1,-3,109,2,2,2
"11579","4",338,1,3,1,2,12,-18,-4,-4,78,43,-4,-4,1,0,-66,-61,0,0
"11580","4",72,2,1,0,0,-179,-74,-2,-3,136,138,2,2,1,-1,-315,-212,-4,-5
"11581","4",69,2,4,1,1,73,52,2,-3,-109,-79,-1,-1,1,-1,182,131,3,-2
"11582","4",40,2,1,0,2,-149,60,3,-3,228,85,3,3,1,-1,-377,-25,0,-6
"11583","4",254,8,2,0,3,80,-25,3,3,157,-124,-2,0,1,-7,-77,99,5,3
"11584","4",466,3,3,0,0,-135,-99,-2,-2,-96,-106,-1,-1,1,-2,-39,7,-1,-1
"11585","4",65,7,1,0,3,-73,86,1,2,-117,26,1,2,1,-6,44,60,0,0
"11586","4",271,6,3,1,1,9,0,1,1,243,-2,4,4,1,-5,-234,2,-3,-3
"11587","4",195,1,1,0,1,-213,210,4,-4,161,-131,3,-2,1,0,-374,341,1,-2
"11588","4",417,5,2,0,2,0,0,0,0,-68,-69,-2,-2,1,-4,68,69,2,2
"11589","4",365,5,3,1,1,-196,-5,0,0,-233,3,-4,-4,1,-4,37,-8,4,4
"11590","4",184,6,3,0,3,59,-5,1,1,63,-2,1,1,1,-5,-4,-3,0,0
"11591","4",406,4,2,1,2,-160,-71,-1,-1,15,-18,2,1,1,-3,-175,-53,-3,-2
"11592","4",402,1,3,1,0,-245,-1,-4,-4,188,1,1,1,1,0,-433,-2,-5,-5
"11593","4",200,1,3,1,0,-201,-25,-4,-4,-153,-36,-4,-4,1,0,-48,11,0,0
"11594","4",469,1,4,0,0,-226,0,-4,-4,37,72,-2,-4,1,0,-263,-72,-2,0
"11595","4",103,5,2,1,3,-4,-3,0,0,-4,-3,1,0,1,-4,0,0,-1,0
"11596","4",465,7,4,1,3,12,220,0,2,19,-244,4,4,1,-6,-7,464,-4,-2
"11597","4",396,1,1,0,1,-242,239,4,-4,235,-239,-4,4,1,0,-477,478,8,-8
"11598","4",461,1,4,1,2,-40,20,-2,-4,17,14,-2,-3,1,0,-57,6,0,-1
"11599","4",34,3,4,0,2,-118,61,-2,-2,-43,24,-1,-2,1,-2,-75,37,-1,0
"11600","4",288,5,2,0,2,-3,-3,0,0,-121,57,-2,-3,1,-4,118,-60,2,3
"11601","4",207,5,1,0,0,-249,0,-4,0,-249,4,1,-3,1,-4,0,-4,-5,3
"11602","4",203,8,4,1,3,-11,-12,4,3,-10,-40,4,4,1,-7,-1,28,0,-1
"11603","4",20,9,3,1,0,-216,-212,-4,4,-222,-223,-4,4,1,-8,6,11,0,0
"11604","4",468,6,1,1,3,114,40,0,1,55,48,0,1,1,-5,59,-8,0,0
"11605","4",88,1,4,1,2,-244,-7,-4,-4,229,-229,4,4,1,0,-473,222,-8,-8
"11606","4",144,3,3,1,0,-238,3,1,-2,123,-111,2,0,1,-2,-361,114,-1,-2
"11607","4",44,3,2,0,2,-216,122,0,-2,205,-229,0,-3,1,-2,-421,351,0,1
"11608","4",217,2,4,0,2,-54,20,-1,-3,16,20,1,-3,1,-1,-70,0,-2,0
"11609","4",367,4,3,1,1,-88,-72,2,-1,-58,-47,2,-2,1,-3,-30,-25,0,1
"11610","4",186,6,2,0,2,26,21,0,1,-20,21,0,-2,1,-5,46,0,0,3
"11611","4",112,7,4,1,3,-3,-242,1,2,247,1,3,2,1,-6,-250,-243,-2,0
"11612","4",259,1,3,1,1,-171,0,4,-4,-5,0,0,-3,1,0,-166,0,4,-1
"11613","4",255,1,3,0,1,-80,-131,-4,-4,166,135,1,1,1,0,-246,-266,-5,-5
"11614","4",470,4,1,1,1,-54,2,-1,-1,11,46,-1,-1,1,-3,-65,-44,0,0
"11615","4",276,6,4,1,3,194,-2,2,1,130,-2,1,2,1,-5,64,0,1,-1
"11616","4",272,3,4,1,2,-23,5,-2,-2,22,12,-2,-2,1,-2,-45,-7,0,0
"11617","4",196,2,3,0,0,-211,-25,-3,-3,227,243,4,4,1,-1,-438,-268,-7,-7
"11618","4",418,3,2,0,2,-192,195,-3,-2,-80,200,-2,-1,1,-2,-112,-5,-1,-1
"11619","4",366,8,4,1,3,75,-46,1,3,95,56,1,2,1,-7,-20,-102,0,1
"11620","4",185,1,4,1,2,-113,-20,-3,-4,23,-41,-2,-1,1,0,-136,21,-1,-3
"11621","4",111,2,1,0,0,-223,-210,-4,-3,-88,137,0,1,1,-1,-135,-347,-4,-4
"11622","4",258,2,3,1,0,-126,3,-3,-3,-127,3,1,-3,1,-1,1,0,-4,0
"11623","4",201,1,3,1,1,-246,2,-4,-4,38,1,-2,-4,1,0,-284,1,-2,0
"11624","4",47,8,4,1,3,153,-104,2,3,121,1,1,2,1,-7,32,-105,1,1
"11625","4",104,1,1,0,0,-235,-2,-3,-4,239,-3,2,-4,1,0,-474,1,-5,0
"11626","4",174,6,4,0,3,133,27,1,1,67,60,1,1,1,-5,66,-33,0,0
"11627","4",170,1,2,0,0,-239,-239,-4,-4,18,15,0,0,1,0,-257,-254,-4,-4
"11628","4",167,4,1,0,3,-101,51,3,-1,-116,-126,3,3,1,-3,15,177,0,-4
"11629","4",340,4,1,0,1,-60,-32,0,-1,59,19,0,0,1,-3,-119,-51,0,-1
"11630","4",289,8,1,0,3,194,175,3,3,214,211,2,3,1,-7,-20,-36,1,0
"11631","4",208,5,4,0,2,-96,213,0,0,161,55,2,2,1,-4,-257,158,-2,-2
"11632","4",204,5,3,0,1,40,-94,0,0,111,-50,0,0,1,-4,-71,-44,0,0
"11633","4",257,1,1,1,0,-233,-60,-4,-4,225,117,-4,-4,1,0,-458,-177,0,0
"11634","4",472,1,1,0,0,-237,179,-4,-4,-231,35,-4,-4,1,0,-6,144,0,0
"11635","4",89,1,3,1,0,-126,-1,-4,-4,-172,2,-4,-1,1,0,46,-3,0,-3
"11636","4",145,4,1,0,1,-116,-5,-1,-1,-192,-113,0,1,1,-3,76,108,-1,-2
"11637","4",440,2,3,1,0,-130,2,-3,-3,-12,0,-2,-2,1,-1,-118,2,-1,-1
"11638","4",218,8,4,1,3,-35,-24,4,3,-71,-28,4,3,1,-7,36,4,0,0
"11639","4",368,9,3,1,3,-145,140,4,4,-119,102,4,4,1,-8,-26,38,0,0
"11640","4",187,4,4,1,2,-90,-12,-3,-1,-124,-37,-2,-2,1,-3,34,25,-1,1
"11641","4",113,4,2,0,2,-15,16,0,-1,-18,41,0,-2,1,-3,3,-25,0,1
"11642","4",26,1,1,0,0,-227,-57,-4,-4,132,133,-3,-4,1,0,-359,-190,-1,0
"11643","4",256,5,3,1,1,99,0,0,0,114,120,1,1,1,-4,-15,-120,-1,-1
"11644","4",471,8,3,1,2,-143,140,-2,3,-232,92,1,1,1,-7,89,48,-3,2
"11645","4",277,1,4,1,1,-71,69,4,-4,-26,19,3,-4,1,0,-45,50,1,0
"11646","4",273,1,1,0,0,-228,5,-3,-4,215,152,3,2,1,0,-443,-147,-6,-6
"11647","4",197,9,4,1,3,69,-234,-2,4,125,-121,0,4,1,-8,-56,-113,-2,0
"11648","4",419,6,4,1,3,27,22,0,1,42,40,-2,1,1,-5,-15,-18,2,0
"11649","4",342,2,3,0,1,-151,12,-1,-3,-46,9,-1,-2,1,-1,-105,3,0,-1
"11650","4",290,2,1,1,1,-208,166,-2,-3,161,125,1,-3,1,-1,-369,41,-3,0
"11651","4",116,8,2,0,3,172,-14,3,3,104,-21,1,-1,1,-7,68,7,2,4
"11652","4",262,6,4,1,3,96,12,1,1,143,16,2,2,1,-5,-47,-4,-1,-1
"11653","4",283,6,1,0,1,-110,35,-3,1,-72,-121,-2,1,1,-5,-38,156,-1,0
"11654","4",28,6,4,0,1,-101,67,-3,1,48,57,-2,-3,1,-5,-149,10,-1,4
"11655","4",105,1,1,0,0,-235,-52,-4,-4,-195,-25,-4,-4,1,0,-40,-27,0,0
"11656","4",175,5,4,1,1,-182,-33,-2,0,6,10,-1,-2,1,-4,-188,-43,-1,2
"11657","4",171,5,1,1,1,10,12,0,0,21,12,0,0,1,-4,-11,0,0,0
"11658","4",168,7,1,0,3,176,-116,2,2,122,-23,2,2,1,-6,54,-93,0,0
"11659","4",341,9,1,0,3,0,0,4,4,241,-26,4,4,1,-8,-241,26,0,0
"11660","4",29,1,4,1,0,-169,191,-4,-4,155,118,-2,-1,1,0,-324,73,-2,-3
"11661","4",209,8,4,0,3,193,-1,2,3,195,-13,2,2,1,-7,-2,12,0,1
"11662","4",205,3,1,1,2,123,26,-2,-2,238,-3,4,3,1,-2,-115,29,-6,-5
"11663","4",286,6,1,0,3,95,-1,1,1,64,-3,0,1,1,-5,31,2,1,0
"11664","4",108,9,2,0,3,198,39,4,4,211,67,2,4,1,-8,-13,-28,2,0
"11665","4",9,4,4,1,2,25,82,-1,-1,21,105,-1,-1,1,-3,4,-23,0,0
"11666","4",146,2,2,1,0,-181,-180,-3,-3,-137,-127,-3,-3,1,-1,-44,-53,0,0
"11667","4",441,2,4,0,2,-182,192,-4,-3,-138,53,-3,-3,1,-1,-44,139,-1,0
"11668","4",219,5,4,1,3,249,1,4,0,249,1,4,0,1,-4,0,0,0,0
"11669","4",369,2,4,1,0,-145,-1,-1,-3,118,0,1,1,1,-1,-263,-1,-2,-4
"11670","4",188,8,2,0,3,196,6,2,3,96,1,3,3,1,-7,100,5,-1,0
"11671","4",114,2,4,1,1,6,4,0,-3,85,96,1,-3,1,-1,-79,-92,-1,0
"11672","4",260,3,3,0,0,-223,-224,-2,-2,-212,-203,-2,-2,1,-2,-11,-21,0,0
"11673","4",285,7,2,0,1,-98,-1,2,2,30,1,-2,-2,1,-6,-128,-2,4,4
"11674","4",281,1,4,1,2,0,0,0,-4,-3,-246,0,-4,1,0,3,246,0,0
"11675","4",278,1,4,1,1,-231,-233,4,-4,-184,-177,4,-4,1,0,-47,-56,0,0
"11676","4",274,5,4,0,2,-35,26,-2,0,24,77,-3,-2,1,-4,-59,-51,1,2
"11677","4",198,6,1,0,1,147,-150,1,1,69,99,2,1,1,-5,78,-249,-1,0
"11678","4",42,3,3,0,1,-47,2,2,-2,2,-13,1,-1,1,-2,-49,15,1,-1
"11679","4",343,4,2,0,2,-86,5,-1,-1,-44,6,-1,-1,1,-3,-42,-1,0,0
"11680","4",291,1,4,0,2,-245,-246,-4,-4,249,247,4,4,1,0,-494,-493,-8,-8
"11681","4",117,2,4,1,2,-229,-4,-3,-3,-213,2,-2,-2,1,-1,-16,-6,-1,-1
"11682","4",263,2,4,1,0,-205,-12,-3,-3,-221,-5,-2,-3,1,-1,16,-7,-1,0
"11683","4",284,5,3,0,1,83,113,0,0,92,44,0,-3,1,-4,-9,69,0,3
"11684","4",280,6,2,0,1,-110,8,-1,1,59,-38,1,1,1,-5,-169,46,-2,0
"11685","4",106,4,2,0,1,-171,-30,-1,-1,33,14,2,2,1,-3,-204,-44,-3,-3
"11686","4",176,8,1,0,1,-144,-25,-1,3,212,50,0,1,1,-7,-356,-75,-1,2
"11687","4",172,9,2,0,3,137,122,4,4,108,142,-2,-2,1,-8,29,-20,6,6
"11688","4",169,1,3,0,0,-242,224,-4,-4,-144,80,-4,-4,1,0,-98,144,0,0
"11689","4",165,3,1,0,1,-110,17,-2,-2,70,63,1,1,1,-2,-180,-46,-3,-3
"11690","4",12,9,4,1,3,1,0,4,4,1,1,4,4,1,-8,0,-1,0,0
"11691","4",318,1,2,0,2,-216,120,-4,-4,200,148,-2,1,1,0,-416,-28,-2,-5
"11692","4",161,1,2,0,2,-244,113,-4,-4,96,62,1,-3,1,0,-340,51,-5,-1
"11693","4",158,3,3,0,0,-239,-17,-4,-2,-236,-26,-4,-2,1,-2,-3,9,0,0
"11694","4",109,1,1,0,1,43,-229,3,-4,1,-204,2,-4,1,0,42,-25,1,0
"11695","4",90,5,4,0,0,-235,18,-4,0,114,17,3,4,1,-4,-349,1,-7,-4
"11696","4",147,3,2,1,3,-175,-188,-2,-2,105,97,2,3,1,-2,-280,-285,-4,-5
"11697","4",442,6,4,1,1,23,52,1,1,78,57,2,2,1,-5,-55,-5,-1,-1
"11698","4",22,5,3,0,1,136,17,0,0,112,20,2,2,1,-4,24,-3,-2,-2
"11699","4",37,3,1,0,0,-164,-23,-3,-2,-174,-14,-3,-3,1,-2,10,-9,0,1
"11700","4",119,5,3,1,3,81,137,1,0,58,-102,1,1,1,-4,23,239,0,-1
"11701","4",115,5,3,0,3,1,-1,0,0,1,-4,0,0,1,-4,0,3,0,0
"11702","4",261,9,1,1,3,-88,-113,4,4,110,101,4,4,1,-8,-198,-214,0,0
"11703","4",157,9,3,0,2,194,203,4,4,161,104,-2,0,1,-8,33,99,6,4
"11704","4",282,9,3,0,3,125,-74,1,4,234,51,1,4,1,-8,-109,-125,0,0
"11705","4",279,6,4,1,3,-84,-20,2,1,-59,-15,2,2,1,-5,-25,-5,0,-1
"11706","4",275,9,4,1,2,-220,5,4,4,-244,11,3,-3,1,-8,24,-6,1,7
"11707","4",199,3,4,1,2,-222,56,-3,-2,19,33,0,0,1,-2,-241,23,-3,-2
"11708","4",420,6,4,1,3,115,1,1,1,1,-1,0,0,1,-5,114,2,1,1
"11709","4",344,7,4,0,3,230,-25,2,2,-65,-44,-1,0,1,-6,295,19,3,2
"11710","4",292,5,3,1,1,-14,-30,0,0,-1,-64,0,0,1,-4,-13,34,0,0
"11711","4",118,5,3,1,1,-65,20,-2,0,122,39,1,1,1,-4,-187,-19,-3,-1
"11712","4",264,1,4,1,2,-238,-235,-4,-4,236,243,0,2,1,0,-474,-478,-4,-6
"11713","4",156,5,2,0,1,58,-25,0,0,56,37,1,1,1,-4,2,-62,-1,-1
"11714","4",110,6,1,0,1,-119,61,-3,1,76,69,3,-1,1,-5,-195,-8,-6,2
"11715","4",107,3,2,1,3,-137,36,2,-2,202,186,0,4,1,-2,-339,-150,2,-6
"11716","4",177,3,4,1,1,-95,161,0,-2,27,199,2,-4,1,-2,-122,-38,-2,2
"11717","4",173,5,4,0,3,-182,4,0,0,219,2,0,0,1,-4,-401,2,0,0
"11718","4",17,1,3,1,0,13,0,-1,-4,134,79,0,-4,1,0,-121,-79,-1,0
"11719","4",166,1,4,1,2,-207,209,-3,-4,197,192,0,0,1,0,-404,17,-3,-4
"11720","4",120,2,3,1,1,-169,-51,-3,-3,-235,-92,-3,-3,1,-1,66,41,0,0
"11721","4",319,4,1,0,1,59,1,-2,-1,76,1,-2,1,1,-3,-17,0,0,-2
"11722","4",162,9,3,0,3,73,91,2,4,139,190,3,4,1,-8,-66,-99,-1,0
"11723","4",159,2,3,1,2,-141,2,-3,-3,211,2,4,4,1,-1,-352,0,-7,-7
"11724","4",11,5,4,0,1,2,1,-2,0,77,40,1,1,1,-4,-75,-39,-3,-1
"11725","4",91,7,2,0,3,83,-2,1,2,110,15,2,2,1,-6,-27,-17,-1,0
"11726","4",148,1,1,0,1,-232,-72,3,-4,-235,-43,2,-4,1,0,3,-29,1,0
"11727","4",443,4,1,0,0,-61,-13,-1,-1,50,58,1,1,1,-3,-111,-71,-2,-2
"11728","4",220,1,4,0,2,-245,57,-4,-4,127,98,-2,-2,1,0,-372,-41,-2,-2
"11729","4",370,1,1,1,3,-229,-11,-4,-4,-222,-18,0,0,1,0,-7,7,-4,-4
"11730","4",294,7,1,0,3,67,0,2,2,0,3,0,2,1,-6,67,-3,2,0
"11731","4",245,1,1,0,0,-221,144,-4,-4,-223,4,-3,-4,1,0,2,140,-1,0
"11732","4",241,1,4,0,2,-198,-175,-2,-4,191,183,2,-1,1,0,-389,-358,-4,-3
"11733","4",15,7,4,1,3,188,32,2,2,45,25,1,2,1,-6,143,7,1,0
"11734","4",98,1,3,0,0,-182,43,-4,-4,100,-148,1,1,1,0,-282,191,-5,-5
"11735","4",36,8,3,1,3,160,120,3,3,163,122,0,3,1,-7,-3,-2,3,0
"11736","4",356,4,4,1,1,2,-1,0,-1,80,-3,1,1,1,-3,-78,2,-1,-2
"11737","4",425,6,4,1,2,52,41,1,1,-1,-2,1,1,1,-5,53,43,0,0
"11738","4",421,5,3,1,1,-10,22,-2,0,112,69,0,2,1,-4,-122,-47,-2,-2
"11739","4",345,5,1,0,0,-174,44,-3,0,-17,-33,-1,-3,1,-4,-157,77,-2,3
"11740","4",293,1,4,1,0,-237,4,-4,-4,-171,12,-4,-4,1,0,-66,-8,0,0
"11741","4",244,1,4,0,2,-146,-184,0,-4,65,-46,1,1,1,0,-211,-138,-1,-5
"11742","4",164,5,2,1,2,1,-1,0,0,73,59,2,1,1,-4,-72,-60,-2,-1
"11743","4",160,7,2,0,0,81,-1,-4,2,-8,-222,-4,2,1,-6,89,221,0,0
"11744","4",97,2,1,0,1,-239,29,3,-3,65,25,3,-2,1,-1,-304,4,0,-1
"11745","4",93,5,1,0,1,-122,69,-2,0,-151,94,-2,0,1,-4,29,-25,0,0
"11746","4",371,2,3,0,0,-199,79,-4,-3,154,-98,-2,-2,1,-1,-353,177,-2,-1
"11747","4",445,6,4,1,3,99,-20,1,1,103,-69,1,1,1,-5,-4,49,0,0
"11748","4",250,6,1,0,3,77,20,1,1,86,25,1,1,1,-5,-9,-5,0,0
"11749","4",247,3,3,1,0,-233,-11,-2,-2,130,-8,1,1,1,-2,-363,-3,-3,-3
"11750","4",121,1,1,0,0,-241,237,-4,-4,243,-238,4,-4,1,0,-484,475,-8,0
"11751","4",243,5,2,0,2,-244,-162,-4,0,-247,-205,-2,0,1,-4,3,43,-2,0
"11752","4",163,4,3,0,1,-201,15,-2,-1,89,-9,2,1,1,-3,-290,24,-4,-2
"11753","4",16,1,1,0,0,-224,17,0,-4,98,17,2,-2,1,0,-322,0,-2,-2
"11754","4",96,4,1,0,0,-27,3,-1,-1,-8,1,-3,-2,1,-3,-19,2,2,1
"11755","4",92,4,4,1,2,-67,-43,-1,-1,-182,-101,-1,-1,1,-3,115,58,0,0
"11756","4",149,6,3,0,1,-240,74,-4,1,226,11,-2,2,1,-5,-466,63,-2,-1
"11757","4",444,2,2,0,2,-169,-1,-3,-3,-178,1,-3,-3,1,-1,9,-2,0,0
"11758","4",221,2,4,1,1,-214,3,-4,-3,6,11,1,2,1,-1,-220,-8,-5,-5
"11759","4",362,2,4,1,3,-77,-104,4,-3,84,108,3,3,1,-1,-161,-212,1,-6
"11760","4",295,5,1,0,1,5,-1,0,0,1,9,0,0,1,-4,4,-10,0,0
"11761","4",246,6,4,1,3,-33,-3,2,1,68,1,3,3,1,-5,-101,-4,-1,-2
"11762","4",242,3,4,0,2,-16,-1,-1,-2,-28,3,1,-1,1,-2,12,-4,-2,-1
"11763","4",150,5,3,1,1,-4,-1,0,0,53,1,0,0,1,-4,-57,-2,0,0
"11764","4",99,7,4,1,3,32,41,3,2,245,8,3,3,1,-6,-213,33,0,-1
"11765","4",360,1,3,1,0,-163,-156,-4,-4,24,17,0,-4,1,0,-187,-173,-4,0
"11766","4",357,3,4,0,2,-225,-33,-4,-2,86,46,1,-1,1,-2,-311,-79,-5,-1
"11767","4",426,4,4,1,3,16,3,0,-1,191,-5,2,2,1,-3,-175,8,-2,-3
"11768","4",422,1,3,0,1,-137,-102,3,-4,-99,-236,2,-2,1,0,-38,134,1,-2
"11769","4",346,7,3,0,0,-249,1,0,2,207,1,0,3,1,-6,-456,0,0,-1
"11770","4",123,2,4,0,2,-203,0,-3,-3,-94,19,-3,-2,1,-1,-109,-19,0,-1
"11771","4",313,4,3,1,0,-45,-46,-1,-1,85,87,2,2,1,-3,-130,-133,-3,-3
"11772","4",423,8,1,0,3,-195,20,0,3,198,18,1,-2,1,-7,-393,2,-1,5
"11773","4",359,7,4,0,3,-75,-70,2,2,165,196,4,4,1,-6,-240,-266,-2,-2
"11774","4",314,1,4,0,1,-242,10,4,-4,-241,4,4,-4,1,0,-1,6,0,0
"11775","4",94,1,4,0,1,-201,198,0,-4,239,237,4,-4,1,0,-440,-39,-4,0
"11776","4",372,1,3,0,0,-179,-231,-4,-4,100,102,0,-1,1,0,-279,-333,-4,-3
"11777","4",446,5,4,1,1,3,-20,0,0,29,46,0,0,1,-4,-26,-66,0,0
"11778","4",251,7,3,0,1,-7,2,0,2,-6,1,-1,1,1,-6,-1,1,1,1
"11779","4",248,6,4,1,3,45,59,1,1,162,182,3,2,1,-5,-117,-123,-2,-1
"11780","4",122,1,1,0,0,-128,-140,-4,-4,-52,-44,0,0,1,0,-76,-96,-4,-4
"11781","4",312,5,4,1,1,74,73,0,0,-101,-80,0,0,1,-4,175,153,0,0
"11782","4",361,1,1,0,0,-249,1,-3,-4,249,-15,4,4,1,0,-498,16,-7,-8
"11783","4",358,1,4,0,2,-235,183,-3,-4,200,69,0,-4,1,0,-435,114,-3,0
"11784","4",427,1,4,0,1,-248,-27,4,-4,-202,-31,3,-3,1,0,-46,4,1,-1
"11785","4",317,2,4,1,2,-189,88,-3,-3,-133,85,-2,-2,1,-1,-56,3,-1,-1
"11786","4",347,9,1,0,3,-118,-127,2,4,145,110,0,1,1,-8,-263,-237,2,3
"11787","4",428,1,1,0,0,-232,-211,-4,-4,-228,-203,-4,-4,1,0,-4,-8,0,0
"11788","4",222,2,1,0,0,-233,5,-3,-3,-228,-1,-3,-3,1,-1,-5,6,0,0
"11789","4",310,1,4,1,2,-239,-3,-4,-4,17,-1,0,-3,1,0,-256,-2,-4,-1
"11790","4",296,6,1,0,3,137,4,1,1,190,-1,0,-1,1,-5,-53,5,1,2
"11791","4",315,9,3,0,3,238,22,4,4,242,18,4,4,1,-8,-4,4,0,0
"11792","4",95,1,4,1,2,-240,1,-4,-4,-104,-1,-1,-1,1,0,-136,2,-3,-3
"11793","4",151,1,2,0,1,-232,7,0,-4,-235,10,0,-4,1,0,3,-3,0,0
"11794","4",447,3,4,1,2,-98,5,-2,-2,105,44,2,1,1,-2,-203,-39,-4,-3
"11795","4",252,5,4,0,1,-91,-126,-1,0,104,153,-1,1,1,-4,-195,-279,0,-1
"11796","4",249,1,3,1,0,-230,-231,-4,-4,51,-45,1,-4,1,0,-281,-186,-5,0
"11797","4",1,4,1,1,1,-171,-90,-1,-1,-76,-22,0,0,1,-3,-95,-68,-1,-1
"11798","4",448,1,2,1,2,-204,1,-3,-4,1,-1,0,-4,1,0,-205,2,-3,0
"11799","4",31,4,1,0,0,-182,-190,-1,-1,-216,104,-4,-4,1,-3,34,-294,3,3
"11800","4",124,8,1,0,3,232,-6,3,3,243,6,2,0,1,-7,-11,-12,1,3
"11801","4",449,6,4,1,3,0,85,1,1,1,106,2,0,1,-5,-1,-21,-1,1
"11802","4",424,3,2,0,2,-95,-10,-2,-2,133,80,1,-1,1,-2,-228,-90,-3,-1
"11803","4",154,5,4,1,3,-1,15,0,0,-45,105,0,0,1,-4,44,-90,0,0
"11804","4",45,1,3,1,0,-72,-33,-2,-4,35,53,1,-1,1,0,-107,-86,-3,-3
"11805","4",223,5,1,0,1,-3,-1,0,0,114,-38,-1,0,1,-4,-117,37,1,0
"11806","4",373,1,3,1,0,-236,-36,0,-4,-224,-22,0,-4,1,0,-12,-14,0,0
"11807","4",297,2,3,1,2,194,119,3,-3,216,100,4,-3,1,-1,-22,19,-1,0
"11808","4",316,2,3,1,0,-164,-77,-3,-3,-133,-103,-3,-3,1,-1,-31,26,0,0
"11809","4",309,2,4,1,2,-47,17,-1,-3,165,72,1,-1,1,-1,-212,-55,-2,-2
"11810","4",152,1,1,0,0,-129,0,-1,-4,-27,-1,0,-3,1,0,-102,1,-1,-1
"11811","4",298,2,1,0,0,-246,12,-1,-3,-123,12,-1,-2,1,-1,-123,0,0,-1
"11812","4",253,9,3,0,3,211,230,4,4,227,227,4,4,1,-8,-16,3,0,0
"11813","4",153,6,1,0,3,-3,4,1,1,-27,23,1,2,1,-5,24,-19,0,-1
"11814","4",10,6,3,1,1,153,-7,0,1,235,-1,-2,-1,1,-5,-82,-6,2,2
"11815","4",452,2,3,1,1,-169,2,-3,-3,-6,-37,0,0,1,-1,-163,39,-3,-3
"11816","4",348,3,3,0,1,-132,3,0,-2,79,57,0,-2,1,-2,-211,-54,0,0
"11817","4",125,4,4,1,0,-118,-22,-4,-1,244,-243,-4,-2,1,-3,-362,221,0,1
"11818","4",453,4,4,1,2,15,-2,0,-1,-163,-1,0,-1,1,-3,178,-1,0,0
"11819","4",311,1,2,0,2,-187,21,-4,-4,163,6,4,-4,1,0,-350,15,-8,0
"11820","4",155,3,2,0,1,-138,-146,0,-2,-94,-81,0,0,1,-2,-44,-65,0,-2
"11821","4",450,4,4,1,3,-1,103,-1,-1,-2,7,0,-1,1,-3,1,96,-1,0
"11822","4",224,2,2,0,2,-120,-24,-3,-3,162,75,2,1,1,-1,-282,-99,-5,-4
"11823","4",374,5,4,0,2,-13,9,0,0,51,15,1,1,1,-4,-64,-6,-1,-1
"11824","4",455,1,2,0,2,-249,0,-4,-4,237,-2,4,4,1,0,-486,2,-8,-8
"11825","4",451,3,1,0,0,-244,-128,-2,-2,-233,-186,-2,-2,1,-2,-11,58,0,0
"11826","4",25,3,4,1,2,-27,-75,-2,-2,1,1,-2,-2,1,-2,-28,-76,0,0
"11827","4",456,2,1,1,0,-193,94,-1,-3,157,161,2,-1,1,-1,-350,-67,-3,-2
"11828","4",299,3,4,0,1,-161,-150,-1,-2,30,221,3,2,1,-2,-191,-371,-4,-4
"11829","4",238,5,3,0,1,-148,-2,2,0,68,-23,0,-2,1,-4,-216,21,2,2
"11830","4",457,7,3,0,1,76,-48,2,2,-130,-135,1,0,1,-6,206,87,1,2
"11831","4",3,1,3,0,0,-186,181,-4,-4,-43,103,-4,-4,1,0,-143,78,0,0
"11832","4",352,5,2,0,1,10,-10,0,0,14,-17,0,0,1,-4,-4,7,0,0
"11833","4",349,8,4,1,1,101,37,2,3,-45,-138,1,0,1,-7,146,175,1,3
"11834","4",126,3,2,0,2,-190,-152,-2,-2,-11,11,-2,-2,1,-2,-179,-163,0,0
"11835","4",454,8,4,1,3,244,1,3,3,248,1,4,4,1,-7,-4,0,-1,-1
"11836","4",459,1,3,1,1,-35,44,1,-4,-197,-219,-1,-4,1,0,162,263,2,0
"11837","4",35,3,1,0,3,106,163,3,-2,151,174,3,-2,1,-2,-45,-11,0,0
"11838","4",127,2,1,0,0,-189,-75,-3,-3,-107,-1,-2,-3,1,-1,-82,-74,-1,0
"11839","4",46,2,1,0,0,-10,-247,-4,-3,-18,-241,-3,-3,1,-1,8,-6,-1,0
"11840","4",375,5,3,1,1,1,-1,0,0,0,1,0,0,1,-4,1,-2,0,0
"11841","4",237,5,2,0,2,-248,0,-2,0,-1,0,0,0,1,-4,-247,0,-2,0
"11842","4",226,2,1,0,0,-42,1,-1,-3,132,0,2,-2,1,-1,-174,1,-3,-1
"11843","4",376,4,4,1,1,20,-140,-1,-1,47,-134,-1,-1,1,-3,-27,-6,0,0
"11844","4",351,1,1,0,0,-246,-241,-4,-4,136,123,-4,-4,1,0,-382,-364,0,0
"11845","4",234,5,3,1,3,120,28,1,0,84,83,0,1,1,-4,36,-55,1,-1
"11846","4",239,9,1,0,1,202,-5,4,4,-22,7,1,1,1,-8,224,-12,3,3
"11847","4",458,3,1,0,1,-73,-62,-1,-2,76,83,-2,-2,1,-2,-149,-145,1,0
"11848","4",30,3,2,1,2,131,-10,-1,-2,165,-51,2,1,1,-2,-34,41,-3,-3
"11849","4",353,4,2,0,2,-127,70,-4,-1,240,135,-4,0,1,-3,-367,-65,0,-1
"11850","4",24,1,2,0,2,-245,1,0,-4,149,1,0,3,1,0,-394,0,0,-7
"11851","4",236,5,1,0,1,-25,-16,0,0,20,-21,0,0,1,-4,-45,5,0,0
"11852","4",225,7,2,0,2,144,27,2,2,42,137,2,2,1,-6,102,-110,0,0
"11853","4",240,5,2,1,1,15,-15,0,0,246,13,-3,-3,1,-4,-231,-28,3,3
"11854","4",350,5,4,0,1,-240,8,0,0,3,-243,3,-1,1,-4,-243,251,-3,1
"11855","4",233,3,2,0,2,-216,43,-3,-2,-33,14,0,0,1,-2,-183,29,-3,-2
"11856","4",355,1,2,0,2,-199,187,-4,-4,98,142,0,0,1,0,-297,45,-4,-4
"11857","4",23,9,1,0,3,213,215,4,4,200,205,4,4,1,-8,13,10,0,0
"11858","4",129,4,4,1,1,84,6,1,-1,112,-1,1,2,1,-3,-28,7,0,-3
"11859","4",227,7,3,0,3,-88,-9,3,2,-12,43,1,1,1,-6,-76,-52,2,1
"11860","4",377,1,1,0,0,-248,8,-4,-4,-246,6,-4,-4,1,0,-2,2,0,0
"11861","4",380,1,4,1,1,-223,-113,3,-4,-213,-35,3,-4,1,0,-10,-78,0,0
"11862","4",235,1,3,0,0,-249,5,-4,-4,170,-3,2,2,1,0,-419,8,-6,-6
"11863","4",228,1,4,1,2,-33,-20,-3,-4,-52,55,4,4,1,0,19,-75,-7,-8
"11864","4",378,3,4,1,1,-159,-2,-2,-2,-174,-4,4,-2,1,-2,15,2,-6,0
"11865","4",232,1,1,0,0,-133,-19,-2,-4,-229,-4,-2,-4,1,0,96,-15,0,0
"11866","4",354,3,1,0,0,-234,226,-2,-2,22,22,1,1,1,-2,-256,204,-3,-3
"11867","4",229,2,1,0,1,-234,74,-3,-3,-230,-92,-3,-3,1,-1,-4,166,0,0
"11868","4",128,5,1,0,3,51,-100,0,0,131,-189,2,2,1,-4,-80,89,-2,-2
"11869","4",394,1,3,0,0,-247,136,-4,-4,-247,93,-4,-4,1,0,0,43,0,0
"11870","4",131,7,4,0,3,-116,103,3,2,137,53,3,3,1,-6,-253,50,0,-1
"11871","4",38,9,4,0,3,236,-1,4,4,224,22,2,4,1,-8,12,-23,2,0
"11872","4",302,3,1,0,0,-177,-27,-3,-2,216,50,-2,-2,1,-2,-393,-77,-1,0
"11873","4",230,5,1,0,0,-233,122,-4,0,-216,22,-3,0,1,-4,-17,100,-1,0
"11874","4",388,2,4,1,0,-157,10,-4,-3,-229,8,-1,-1,1,-1,72,2,-3,-2
"11875","4",13,1,4,0,1,-109,-22,1,-4,81,-72,2,2,1,0,-190,50,-1,-6
"11876","4",303,1,3,1,2,-220,-175,-4,-4,-180,-30,-2,-2,1,0,-40,-145,-2,-2
"11877","4",231,4,4,1,0,-207,-4,-4,-1,20,90,0,0,1,-3,-227,-94,-4,-1
"11878","4",300,2,1,0,0,-202,37,-2,-3,24,46,1,2,1,-1,-226,-9,-3,-5
"11879","4",393,1,1,0,0,-130,-175,-4,-4,130,-116,2,-3,1,0,-260,-59,-6,-1
"11880","4",304,3,2,0,2,-205,9,-2,-2,105,-23,2,2,1,-2,-310,32,-4,-4
"11881","4",379,3,3,0,1,-44,-39,1,-2,-4,-8,1,0,1,-2,-40,-31,0,-2
"11882","4",301,7,4,0,1,52,-1,2,2,3,0,2,2,1,-6,49,-1,0,0
"11883","4",306,5,3,1,3,104,101,1,0,142,159,1,0,1,-4,-38,-58,0,0
"11884","4",387,3,3,0,1,113,112,-3,-2,105,100,2,3,1,-2,8,12,-5,-5
"11885","4",383,7,4,1,1,-249,0,2,2,-2,-1,0,0,1,-6,-247,1,2,2
"11886","4",132,7,4,1,1,21,-127,1,2,-12,56,0,1,1,-6,33,-183,1,1
"11887","4",381,1,2,0,2,-234,12,-4,-4,234,195,4,4,1,0,-468,-183,-8,-8
"11888","4",384,1,1,1,0,-227,-1,4,-4,-122,55,0,-4,1,0,-105,-56,4,0
"11889","4",305,6,4,1,3,-80,36,0,1,30,44,1,1,1,-5,-110,-8,-1,0
"11890","4",307,1,4,1,2,-243,243,-4,-4,-180,241,-3,-3,1,0,-63,2,-1,-1
"11891","4",382,4,4,1,2,61,-3,-1,-1,41,-2,1,1,1,-3,20,-1,-2,-2
"11892","4",130,1,1,0,3,107,56,4,-4,114,37,3,-2,1,0,-7,19,1,-2
"11893","4",391,5,2,0,3,205,205,0,0,132,134,0,0,1,-4,73,71,0,0
"11894","4",386,1,1,0,0,-248,125,-2,-4,11,8,0,-1,1,0,-259,117,-2,-3
"11895","4",308,1,4,0,0,-247,-249,-4,-4,157,177,0,2,1,0,-404,-426,-4,-6
"11896","4",389,1,3,1,2,-243,6,-4,-4,38,-30,0,0,1,0,-281,36,-4,-4
"11897","4",385,6,4,1,1,79,30,1,1,127,51,1,1,1,-5,-48,-21,0,0
"11898","4",390,1,2,0,2,-131,-18,-4,-4,17,-122,0,0,1,0,-148,104,-4,-4
"11899","4",39,5,3,1,1,17,16,0,0,157,175,3,3,1,-4,-140,-159,-3,-3
"11900","4",392,3,1,0,0,-59,91,-2,-2,-125,107,-2,-2,1,-2,66,-16,0,0
"11901","5",430,5,2,0,1,62,-48,0,0,143,-107,2,-1,0,-5,-81,59,-2,1
"11902","5",474,1,1,0,0,0,-52,0,-4,0,-87,0,-4,0,-1,0,35,0,0
"11903","5",431,2,3,0,0,-212,39,-3,-3,22,32,-1,-1,0,-2,-234,7,-2,-2
"11904","5",215,1,1,0,0,-208,54,-2,-4,-175,26,-2,-3,0,-1,-33,28,0,-1
"11905","5",475,4,3,0,3,160,114,-1,-1,77,-74,0,0,0,-4,83,188,-1,-1
"11906","5",429,1,2,0,0,-242,-3,-4,-4,-198,-144,-4,-4,0,-1,-44,141,0,0
"11907","5",287,8,4,0,3,209,10,4,3,-195,-8,3,3,0,-8,404,18,1,0
"11908","5",473,4,3,0,0,-97,-21,-1,-1,-121,-33,-1,-1,0,-4,24,12,0,0
"11909","5",207,1,1,0,0,-249,-4,-4,-4,245,0,4,4,0,-1,-494,-4,-8,-8
"11910","5",43,1,3,0,0,-206,-7,-3,-4,59,51,-1,-2,0,-1,-265,-58,-2,-2
"11911","5",212,1,1,0,1,-213,21,0,-4,-229,27,0,-4,0,-1,16,-6,0,0
"11912","5",55,5,4,0,1,11,-6,0,0,55,4,0,0,0,-5,-44,-10,0,0
"11913","5",51,4,4,1,1,-23,-33,1,-1,-68,-60,0,-2,0,-4,45,27,1,1
"11914","5",476,2,3,0,0,-234,-224,-3,-3,-174,-161,-1,-1,0,-2,-60,-63,-2,-2
"11915","5",213,4,2,0,1,-2,1,0,-1,24,0,1,0,0,-4,-26,1,-1,-1
"11916","5",432,5,2,0,1,27,0,0,0,68,-5,0,0,0,-5,-41,5,0,0
"11917","5",49,7,4,1,1,201,105,2,2,100,118,2,2,0,-7,101,-13,0,0
"11918","5",21,2,4,1,2,-203,-141,-3,-3,70,65,-2,-2,0,-2,-273,-206,-1,-1
"11919","5",214,9,1,0,3,142,1,4,4,151,1,4,4,0,-9,-9,0,0,0
"11920","5",288,4,2,1,2,-120,0,-3,-1,-208,4,-3,0,0,-4,88,-4,0,-1
"11921","5",211,6,3,0,1,-88,-88,-3,1,131,153,2,4,0,-6,-219,-241,-5,-3
"11922","5",291,1,4,0,2,-220,150,-4,-4,84,-52,-4,-4,0,-1,-304,202,0,0
"11923","5",434,7,4,1,3,32,9,2,2,-15,-28,1,1,0,-7,47,37,1,1
"11924","5",289,8,1,1,3,-247,-20,3,3,170,180,2,2,0,-8,-417,-200,1,1
"11925","5",50,4,2,0,1,-17,-2,-1,-1,81,-47,0,-1,0,-4,-98,45,-1,0
"11926","5",216,5,3,0,1,31,-18,1,0,-101,-145,1,1,0,-5,132,127,0,-1
"11927","5",48,1,3,0,0,-3,1,-4,-4,64,-63,-4,-4,0,-1,-67,64,0,0
"11928","5",29,1,4,1,0,-242,242,-4,-4,209,180,-2,-1,0,-1,-451,62,-2,-3
"11929","5",56,4,3,0,1,48,-126,-2,-1,67,-103,-2,0,0,-4,-19,-23,0,-1
"11930","5",52,2,3,0,0,-96,5,2,-3,3,182,2,-1,0,-2,-99,-177,0,-2
"11931","5",210,1,4,1,2,-195,-51,3,-4,-168,-153,2,-4,0,-1,-27,102,1,0
"11932","5",182,6,4,1,3,-8,-165,3,1,-5,-196,4,4,0,-6,-3,31,-1,-3
"11933","5",433,2,1,0,0,194,225,-3,-3,202,165,4,-3,0,-2,-8,60,-7,0
"11934","5",5,1,2,0,2,-246,232,-2,-4,-240,8,-2,-4,0,-1,-6,224,0,0
"11935","5",400,4,4,0,2,-144,128,-4,-1,22,-19,1,0,0,-4,-166,147,-5,-1
"11936","5",58,9,4,1,1,-246,1,-4,4,2,246,4,4,0,-9,-248,-245,-8,0
"11937","5",54,5,4,1,1,25,-35,0,0,16,15,0,0,0,-5,9,-50,0,0
"11938","5",438,5,4,0,3,-1,8,0,0,2,3,4,0,0,-5,-3,5,-4,0
"11939","5",208,3,4,1,2,-158,-199,-2,-2,204,177,-4,4,0,-3,-362,-376,2,-6
"11940","5",435,3,4,0,1,-216,7,-2,-2,0,-63,0,0,0,-3,-216,70,-2,-2
"11941","5",265,9,1,0,3,161,1,3,4,-3,0,0,0,0,-9,164,1,3,4
"11942","5",181,5,4,1,3,-114,-80,0,0,106,198,0,0,0,-5,-220,-278,0,0
"11943","5",217,2,4,0,2,-124,32,-1,-3,64,35,1,-1,0,-2,-188,-3,-2,-2
"11944","5",206,1,4,0,0,-219,-229,-4,-4,-146,-97,-4,-4,0,-1,-73,-132,0,0
"11945","5",19,2,2,0,2,-207,-194,-3,-3,-120,-102,-1,-1,0,-2,-87,-92,-2,-2
"11946","5",57,1,4,0,1,-7,-139,-1,-4,1,-226,1,-4,0,-1,-8,87,-2,0
"11947","5",53,7,4,1,3,213,-3,2,2,201,-1,2,1,0,-7,12,-2,0,1
"11948","5",437,3,1,0,0,-197,2,-2,-2,-164,3,-2,-2,0,-3,-33,-1,0,0
"11949","5",183,3,4,0,1,-156,-32,1,-2,67,197,1,0,0,-3,-223,-229,0,-2
"11950","5",219,5,4,1,3,249,1,4,0,-1,248,4,0,0,-5,250,-247,0,0
"11951","5",18,3,3,0,1,-71,-61,0,-2,65,25,1,0,0,-3,-136,-86,-1,-2
"11952","5",292,5,3,1,1,-6,-30,0,0,-20,-7,0,0,0,-5,14,-23,0,0
"11953","5",59,1,1,0,0,-194,195,-4,-4,124,102,2,2,0,-1,-318,93,-6,-6
"11954","5",22,5,3,0,1,22,-8,0,0,139,15,2,2,0,-5,-117,-23,-2,-2
"11955","5",189,1,1,0,1,112,-60,3,-4,-55,55,2,-2,0,-1,167,-115,1,-2
"11956","5",209,7,4,1,3,198,-15,1,2,81,96,2,2,0,-7,117,-111,-1,0
"11957","5",290,3,1,0,1,-122,-103,1,-2,-161,98,-2,-2,0,-3,39,-201,3,0
"11958","5",266,3,1,0,1,1,1,-2,-2,2,0,0,0,0,-3,-1,1,-2,-2
"11959","5",80,8,4,1,3,-110,-1,3,3,234,3,4,-3,0,-8,-344,-4,-1,6
"11960","5",179,3,1,0,1,18,-2,4,-2,235,3,0,4,0,-3,-217,-5,4,-6
"11961","5",77,5,3,1,1,-131,-1,-1,0,-216,4,-2,-2,0,-5,85,-5,1,2
"11962","5",190,7,4,1,3,211,98,2,2,199,183,2,2,0,-7,12,-85,0,0
"11963","5",81,3,1,0,0,-229,168,2,-2,21,45,1,-3,0,-3,-250,123,1,1
"11964","5",61,1,1,0,3,249,-5,4,-4,164,-2,4,-4,0,-1,85,-3,0,0
"11965","5",401,1,2,0,1,-153,25,1,-4,192,56,1,1,0,-1,-345,-31,0,-5
"11966","5",184,6,3,0,3,114,-1,1,1,117,-1,1,1,0,-6,-3,0,0,0
"11967","5",82,1,4,0,2,-238,-17,-4,-4,14,-167,4,-4,0,-1,-252,150,-8,0
"11968","5",439,5,2,0,1,-1,-1,0,0,-2,1,-2,-3,0,-5,1,-2,2,3
"11969","5",293,1,4,1,0,-250,11,-4,-4,-192,15,-4,-4,0,-1,-58,-4,0,0
"11970","5",436,5,4,1,3,20,-147,4,0,125,-171,3,-1,0,-5,-105,24,1,1
"11971","5",178,4,1,0,1,-33,-3,-1,-1,248,3,3,3,0,-4,-281,-6,-4,-4
"11972","5",460,4,1,0,0,-226,42,-4,-1,146,14,-2,1,0,-4,-372,28,-2,-2
"11973","5",218,8,4,1,3,-66,-18,4,3,-14,-17,4,3,0,-8,-52,-1,0,0
"11974","5",60,8,1,0,3,222,4,3,3,234,2,2,3,0,-8,-12,2,1,0
"11975","5",202,7,1,0,1,112,-23,3,2,57,-65,2,1,0,-7,55,42,1,1
"11976","5",398,3,4,0,2,122,133,-2,-2,121,111,2,2,0,-3,1,22,-4,-4
"11977","5",187,1,4,0,2,-244,1,-4,-4,-67,-9,-1,0,0,-1,-177,10,-3,-4
"11978","5",268,8,4,1,3,120,90,3,3,119,-114,3,3,0,-8,1,204,0,0
"11979","5",191,3,1,0,0,-219,-28,-2,-2,-203,-36,-2,-2,0,-3,-16,8,0,0
"11980","5",399,6,4,0,3,-6,-2,0,1,140,3,2,1,0,-6,-146,-5,-2,0
"11981","5",180,1,2,1,2,-44,3,-2,-4,-250,-1,-3,-2,0,-1,206,4,1,-2
"11982","5",402,1,3,0,0,-246,1,3,-4,56,-1,-1,1,0,-1,-302,2,4,-5
"11983","5",6,3,4,1,2,-245,0,-2,-2,-129,0,-1,-1,0,-3,-116,0,-1,-1
"11984","5",220,1,4,1,2,-232,218,-4,-4,162,84,-2,-2,0,-1,-394,134,-2,-2
"11985","5",40,2,1,0,2,-232,107,4,-3,213,110,4,2,0,-2,-445,-3,0,-5
"11986","5",186,5,2,0,2,-14,20,0,0,-18,17,0,0,0,-5,4,3,0,0
"11987","5",84,7,4,0,3,191,5,2,2,239,-3,4,3,0,-7,-48,8,-2,-1
"11988","5",267,4,3,0,1,100,1,-1,-1,100,2,1,1,0,-4,0,-1,-2,-2
"11989","5",461,1,4,0,2,-38,25,-3,-4,17,21,-1,-4,0,-1,-55,4,-2,0
"11990","5",2,7,4,1,1,157,-77,3,2,76,-73,1,2,0,-7,81,-4,2,0
"11991","5",78,2,4,0,0,-228,3,-3,-3,-175,0,-2,-2,0,-2,-53,3,-1,-1
"11992","5",203,9,4,0,3,-11,-15,4,4,-12,10,4,-1,0,-9,1,-25,0,5
"11993","5",32,5,1,0,1,6,-2,0,0,5,-3,0,0,0,-5,1,1,0,0
"11994","5",62,9,2,0,3,-233,-6,-4,4,226,220,4,4,0,-9,-459,-226,-8,0
"11995","5",269,2,4,0,2,-249,164,0,-3,249,169,0,-3,0,-2,-498,-5,0,0
"11996","5",185,1,4,0,2,-244,-13,-4,-4,-34,-10,-4,-2,0,-1,-210,-3,0,-2
"11997","5",83,6,1,0,3,122,-118,2,1,149,-134,2,2,0,-6,-27,16,0,-1
"11998","5",44,1,2,0,2,-242,229,-3,-4,189,-181,0,-2,0,-1,-431,410,-3,-2
"11999","5",294,7,1,0,3,102,-1,2,2,49,1,3,3,0,-7,53,-2,-1,-1
"12000","5",397,2,4,0,3,166,-112,-3,-3,171,52,3,4,0,-2,-5,-164,-6,-7
"12001","5",408,2,1,0,0,-229,2,-4,-3,158,4,1,1,0,-2,-387,-2,-5,-4
"12002","5",404,5,1,0,1,55,-47,1,0,54,-47,1,0,0,-5,1,0,0,0
"12003","5",295,5,1,0,1,-1,-2,0,0,1,-3,0,0,0,-5,-2,1,0,0
"12004","5",170,1,2,0,0,-242,-242,-4,-4,12,10,0,0,0,-1,-254,-252,-4,-4
"12005","5",167,7,1,0,3,90,-116,2,2,-130,74,-2,-2,0,-7,220,-190,4,4
"12006","5",405,7,4,0,1,-193,107,1,2,95,40,0,-1,0,-7,-288,67,1,3
"12007","5",188,8,2,0,3,205,-1,3,3,191,1,3,3,0,-8,14,-2,0,0
"12008","5",79,2,4,1,2,-232,26,-3,-3,-225,21,-3,-3,0,-2,-7,5,0,0
"12009","5",192,7,4,0,1,-1,-80,1,2,-72,0,-1,0,0,-7,71,-80,2,2
"12010","5",4,2,3,1,1,-15,0,-3,-3,220,-106,2,2,0,-2,-235,106,-5,-5
"12011","5",407,1,2,1,2,92,-73,-4,-4,57,-119,1,1,0,-1,35,46,-5,-5
"12012","5",403,4,1,0,0,-147,-19,0,-1,-1,-34,2,1,0,-4,-146,15,-2,-2
"12013","5",193,1,1,0,0,-223,-151,-4,-4,140,-67,1,1,0,-1,-363,-84,-5,-5
"12014","5",221,7,4,0,1,83,-3,1,2,-9,-4,0,1,0,-7,92,1,1,1
"12015","5",440,2,3,0,0,-184,-95,-3,-3,-31,3,-3,-3,0,-2,-153,-98,0,0
"12016","5",137,4,1,0,1,-237,-235,-4,-1,25,14,-2,0,0,-4,-262,-249,-2,-1
"12017","5",85,1,2,0,2,-174,110,-3,-4,-128,138,-3,-2,0,-1,-46,-28,0,-2
"12018","5",409,7,4,0,2,-157,-169,2,2,89,85,2,2,0,-7,-246,-254,0,0
"12019","5",467,5,1,0,3,-83,-92,4,0,20,79,4,0,0,-5,-103,-171,0,0
"12020","5",20,1,3,0,0,-209,-221,4,-4,68,58,2,4,0,-1,-277,-279,2,-8
"12021","5",171,5,1,0,1,33,14,0,0,33,31,0,0,0,-5,0,-17,0,0
"12022","5",204,6,3,0,1,27,-30,0,1,72,-178,0,0,0,-6,-45,148,0,1
"12023","5",320,1,2,0,2,-249,147,-4,-4,-245,140,-3,-3,0,-1,-4,7,-1,-1
"12024","5",63,7,4,1,1,-243,-1,4,2,-241,-1,1,-3,0,-7,-2,0,3,5
"12025","5",27,5,2,0,2,-29,-41,0,0,27,-19,0,0,0,-5,-56,-22,0,0
"12026","5",205,2,1,0,2,-165,-1,-3,-3,214,-6,4,4,0,-2,-379,5,-7,-7
"12027","5",415,4,2,0,2,0,-1,0,-1,145,200,0,1,0,-4,-145,-201,0,-2
"12028","5",363,2,3,0,3,-247,1,3,-3,1,-248,3,3,0,-2,-248,249,0,-6
"12029","5",466,2,3,0,0,-97,-100,-3,-3,-111,-111,-2,-2,0,-2,14,11,-1,-1
"12030","5",255,5,3,0,1,-79,-75,0,0,-60,-162,1,0,0,-5,-19,87,-1,0
"12031","5",222,2,1,0,0,-241,6,-3,-3,-227,1,-3,-3,0,-2,-14,5,0,0
"12032","5",441,2,4,0,2,-216,104,-4,-3,-153,118,-3,-3,0,-2,-63,-14,-1,0
"12033","5",296,7,1,0,3,126,-95,1,2,208,11,2,2,0,-7,-82,-106,-1,0
"12034","5",86,5,4,0,3,113,10,1,0,161,13,-1,0,0,-5,-48,-3,2,0
"12035","5",168,4,1,1,3,69,-153,1,-1,84,-72,1,2,0,-4,-15,-81,0,-3
"12036","5",406,7,2,0,2,-183,-125,2,2,71,17,2,1,0,-7,-254,-142,0,1
"12037","5",414,2,1,0,0,-165,-162,-3,-3,38,37,0,0,0,-2,-203,-199,-3,-3
"12038","5",8,4,3,0,1,48,56,2,-1,49,-131,-1,0,0,-4,-1,187,3,-1
"12039","5",469,1,4,0,0,-240,58,-4,-4,121,59,-3,-4,0,-1,-361,-1,-1,0
"12040","5",254,8,2,0,3,151,-27,3,3,175,-78,-4,-1,0,-8,-24,51,7,4
"12041","5",64,9,1,0,1,239,-4,4,4,215,-55,4,4,0,-9,24,51,0,0
"12042","5",270,2,3,0,1,-238,-19,-3,-3,248,4,4,4,0,-2,-486,-23,-7,-7
"12043","5",194,9,1,0,0,-237,-8,-4,4,-231,8,-4,4,0,-9,-6,-16,0,0
"12044","5",416,1,4,1,0,-220,234,-4,-4,-240,242,-4,-4,0,-1,20,-8,0,0
"12045","5",364,6,3,1,1,-2,38,0,1,-46,-2,0,0,0,-6,44,40,0,1
"12046","5",138,5,3,0,1,103,-93,0,0,95,-46,1,1,0,-5,8,-47,-1,-1
"12047","5",256,5,3,0,1,-1,3,0,0,79,112,1,1,0,-5,-80,-109,-1,-1
"12048","5",41,6,2,0,3,4,78,2,1,30,62,2,1,0,-6,-26,16,0,0
"12049","5",468,4,1,1,3,145,75,2,-1,9,24,1,1,0,-4,136,51,1,-2
"12050","5",200,1,3,1,0,-209,-50,-4,-4,-189,-54,-3,-4,0,-1,-20,4,-1,0
"12051","5",172,1,2,1,3,-220,169,-4,-4,-111,90,1,1,0,-1,-109,79,-5,-5
"12052","5",169,1,3,0,0,-247,221,-4,-4,-229,213,-4,-4,0,-1,-18,8,0,0
"12053","5",321,4,1,0,0,-136,-132,-1,-1,-128,-109,0,0,0,-4,-8,-23,-1,-1
"12054","5",241,1,4,1,2,-87,-47,-2,-4,201,174,2,-1,0,-1,-288,-221,-4,-3
"12055","5",411,1,2,0,2,-227,-231,-4,-4,-179,-195,-3,-4,0,-1,-48,-36,-1,0
"12056","5",262,7,4,0,3,141,32,1,2,118,82,2,2,0,-7,23,-50,-1,0
"12057","5",283,4,1,0,1,-102,41,-3,-1,-84,-119,-2,1,0,-4,-18,160,-1,-2
"12058","5",470,4,1,0,1,-133,-76,-1,-1,-47,31,1,1,0,-4,-86,-107,-2,-2
"12059","5",276,7,4,1,3,158,-5,2,2,129,8,1,-4,0,-7,29,-13,1,6
"12060","5",463,5,4,1,3,232,2,0,0,-20,-226,3,0,0,-5,252,228,-3,0
"12061","5",223,5,1,0,1,0,0,0,0,0,-1,0,0,0,-5,0,1,0,0
"12062","5",442,6,4,0,1,-25,56,-1,1,47,48,1,2,0,-6,-72,8,-2,-1
"12063","5",297,3,3,0,2,204,39,2,-2,193,36,2,-2,0,-3,11,3,0,0
"12064","5",87,6,4,1,3,2,-249,1,1,-1,-246,1,1,0,-6,3,-3,0,0
"12065","5",410,1,1,0,0,-49,-5,-3,-4,-16,-19,-1,-3,0,-1,-33,14,-2,-1
"12066","5",261,9,1,0,3,57,58,4,4,156,204,4,4,0,-9,-99,-146,0,0
"12067","5",201,8,3,0,1,36,1,1,3,17,1,-3,-4,0,-8,19,0,4,7
"12068","5",47,6,4,1,3,106,-85,1,1,97,2,1,2,0,-6,9,-87,0,-1
"12069","5",104,1,1,0,0,-229,4,3,-4,-227,2,-1,-3,0,-1,-2,2,4,-1
"12070","5",462,9,3,0,3,-30,25,4,4,217,207,0,-4,0,-9,-247,-182,4,8
"12071","5",65,7,1,0,3,18,80,1,2,-80,59,1,2,0,-7,98,21,0,0
"12072","5",271,4,3,0,1,-119,-3,-1,-1,227,4,4,4,0,-4,-346,-7,-5,-5
"12073","5",195,1,1,0,1,-216,213,4,-4,30,-22,2,0,0,-1,-246,235,2,-4
"12074","5",417,5,2,0,2,1,-2,0,0,-133,-102,-2,-3,0,-5,134,100,2,3
"12075","5",365,1,3,0,1,-10,-5,-4,-4,-184,-11,0,-4,0,-1,174,6,-4,0
"12076","5",139,1,4,1,2,-238,-25,-4,-4,-245,-5,-4,-4,0,-1,7,-20,0,0
"12077","5",257,1,1,1,0,-30,-247,-4,-4,-205,81,-4,-4,0,-1,175,-328,0,0
"12078","5",472,1,1,0,0,-237,242,-4,-4,-223,24,-4,-4,0,-1,-14,218,0,0
"12079","5",278,5,4,0,1,-226,-223,4,0,-227,-226,4,-4,0,-5,1,3,0,4
"12080","5",465,7,4,0,3,17,-241,2,2,-15,204,4,2,0,-7,32,-445,-2,0
"12081","5",173,4,4,0,3,-172,-3,-1,-1,-1,-12,0,0,0,-4,-171,9,-1,-1
"12082","5",17,1,3,0,0,-28,56,-2,-4,144,104,-2,-4,0,-1,-172,-48,0,0
"12083","5",322,5,4,0,3,111,-127,0,0,250,-239,4,4,0,-5,-139,112,-4,-4
"12084","5",242,4,4,0,2,-130,-2,2,-1,-160,-1,-2,-3,0,-4,30,-1,4,2
"12085","5",412,9,1,0,0,-244,1,-2,4,245,1,4,4,0,-9,-489,0,-6,0
"12086","5",263,1,4,1,0,-238,-1,-4,-4,-207,0,-4,-4,0,-1,-31,-1,0,0
"12087","5",284,1,3,0,1,-141,-168,0,-4,-181,-185,0,-3,0,-1,40,17,0,-1
"12088","5",471,9,3,0,2,6,39,4,4,158,-169,-1,-1,0,-9,-152,208,5,5
"12089","5",277,1,4,1,1,-80,53,4,-4,36,-47,3,1,0,-1,-116,100,1,-5
"12090","5",464,6,1,0,1,90,8,1,1,68,25,1,1,0,-6,22,-17,0,0
"12091","5",224,2,2,0,2,-194,-46,-3,-3,158,69,2,1,0,-2,-352,-115,-5,-4
"12092","5",443,1,1,0,0,-231,-213,-4,-4,49,35,1,0,0,-1,-280,-248,-5,-4
"12093","5",298,2,1,0,0,-239,14,-1,-3,9,-229,-1,0,0,-2,-248,243,0,-3
"12094","5",88,1,4,1,2,-242,-9,-4,-4,239,-221,4,4,0,-1,-481,212,-8,-8
"12095","5",367,4,3,0,1,-184,-106,2,-1,-46,-35,2,-1,0,-4,-138,-71,0,0
"12096","5",140,5,1,0,1,-33,-17,-1,0,30,-48,1,1,0,-5,-63,31,-2,-1
"12097","5",259,1,3,0,1,-141,0,4,-4,-179,0,4,-4,0,-1,38,0,0,0
"12098","5",28,6,4,0,1,-225,116,1,1,-93,65,-2,-2,0,-6,-132,51,3,3
"12099","5",105,1,1,0,0,-244,93,-4,-4,-233,-39,-4,-4,0,-1,-11,132,0,0
"12100","5",101,1,3,0,0,-245,245,-4,-4,228,234,-3,-3,0,-1,-473,11,-1,-1
"12101","5",66,4,1,1,1,-245,-1,1,-1,189,3,2,4,0,-4,-434,-4,-1,-5
"12102","5",272,2,4,0,2,-60,0,-2,-3,11,6,-1,-2,0,-2,-71,-6,-1,-1
"12103","5",196,1,3,0,0,-242,3,-4,-4,134,166,2,2,0,-1,-376,-163,-6,-6
"12104","5",418,4,2,0,2,-155,98,-3,-1,199,-203,1,-1,0,-4,-354,301,-4,0
"12105","5",366,8,4,1,3,79,-50,2,3,85,-41,2,3,0,-8,-6,-9,0,0
"12106","5",14,5,3,0,1,9,6,0,0,215,-92,2,3,0,-5,-206,98,-2,-3
"12107","5",258,3,3,0,0,-51,1,-2,-2,-25,-1,-2,-4,0,-3,-26,2,0,2
"12108","5",108,9,2,0,3,236,39,4,4,172,55,4,4,0,-9,64,-16,0,0
"12109","5",279,6,4,1,3,-76,-106,2,1,38,94,2,2,0,-6,-114,-200,0,-1
"12110","5",100,9,4,0,3,201,2,3,4,198,0,2,2,0,-9,3,2,1,2
"12111","5",174,6,4,0,3,144,54,1,1,106,81,1,1,0,-6,38,-27,0,0
"12112","5",327,3,4,1,3,-171,148,0,-2,79,-111,2,-1,0,-3,-250,259,-2,-1
"12113","5",323,1,4,1,1,2,-92,-4,-4,198,-2,-2,-4,0,-1,-196,-90,-2,0
"12114","5",243,4,2,0,2,-249,-77,-3,-1,-248,-186,-3,0,0,-4,-1,109,0,-1
"12115","5",413,4,1,1,1,-194,-1,-1,-1,-219,-6,-3,-3,0,-4,25,5,2,2
"12116","5",264,1,4,0,2,9,7,-2,-4,240,246,0,0,0,-1,-231,-239,-2,-4
"12117","5",285,7,2,0,1,-233,87,2,2,1,77,0,0,0,-7,-234,10,2,2
"12118","5",281,1,4,0,2,-241,6,-4,-4,-230,1,-4,-4,0,-1,-11,5,0,0
"12119","5",107,2,2,0,3,-18,158,1,-3,-2,99,-2,3,0,-2,-16,59,3,-6
"12120","5",103,6,2,1,3,135,-1,3,1,201,1,2,2,0,-6,-66,-2,1,-1
"12121","5",225,6,2,1,2,-163,-25,-1,1,-174,-29,-2,-2,0,-6,11,4,1,3
"12122","5",444,1,2,0,2,-163,57,-3,-4,-120,31,-3,-3,0,-1,-43,26,0,-1
"12123","5",299,7,4,0,1,210,29,2,2,33,206,4,4,0,-7,177,-177,-2,-2
"12124","5",89,2,3,0,0,-1,3,-4,-3,-244,1,-3,-3,0,-2,243,2,-1,0
"12125","5",368,1,3,0,3,-101,-169,-4,-4,-134,140,4,4,0,-1,33,-309,-8,-8
"12126","5",141,1,1,0,0,-237,-193,-4,-4,-243,-109,-1,-3,0,-1,6,-84,-3,-1
"12127","5",26,1,1,0,0,-243,0,-4,-4,-1,-63,-1,-4,0,-1,-242,63,-3,0
"12128","5",280,7,2,0,1,-30,1,-2,2,-1,3,-1,1,0,-7,-29,-2,-1,1
"12129","5",106,6,2,0,1,-76,25,1,1,-86,22,1,1,0,-6,10,3,0,0
"12130","5",102,6,4,1,3,85,67,2,1,-117,94,0,0,0,-6,202,-27,2,1
"12131","5",67,2,1,0,0,-239,17,-4,-3,67,-102,1,1,0,-2,-306,119,-5,-4
"12132","5",273,1,1,0,0,-209,-225,-3,-4,157,59,1,0,0,-1,-366,-284,-4,-4
"12133","5",197,9,4,1,3,-30,-235,1,4,86,-104,1,4,0,-9,-116,-131,0,0
"12134","5",419,6,4,0,3,-67,-82,0,1,36,59,-1,0,0,-6,-103,-141,1,1
"12135","5",342,4,3,1,1,7,18,0,-1,-114,24,-2,-3,0,-4,121,-6,2,2
"12136","5",12,9,4,0,3,-2,1,4,4,-4,2,4,4,0,-9,2,-1,0,0
"12137","5",116,2,2,1,3,-224,-18,-3,-3,71,0,0,1,0,-2,-295,-18,-3,-4
"12138","5",109,1,1,0,1,-1,-201,2,-4,-4,-211,3,-4,0,-1,3,10,-1,0
"12139","5",73,1,4,0,2,-155,68,-4,-4,-108,151,-4,-4,0,-1,-47,-83,0,0
"12140","5",7,6,1,0,3,31,138,2,1,149,106,1,2,0,-6,-118,32,1,-1
"12141","5",175,3,4,1,1,-119,136,0,-2,184,130,1,3,0,-3,-303,6,-1,-5
"12142","5",328,4,3,0,1,-21,11,-1,-1,12,5,1,1,0,-4,-33,6,-2,-2
"12143","5",324,1,2,0,0,8,-2,-4,-4,-233,1,-4,-4,0,-1,241,-3,0,0
"12144","5",244,1,4,1,2,-189,-192,-4,-4,51,-88,1,1,0,-1,-240,-104,-5,-5
"12145","5",341,9,1,0,3,241,-44,4,4,248,-29,3,4,0,-9,-7,-15,1,0
"12146","5",119,5,3,0,3,-78,95,0,0,-209,-87,-2,-2,0,-5,131,182,2,2
"12147","5",286,6,1,0,3,65,12,1,1,57,5,1,1,0,-6,8,7,0,0
"12148","5",282,9,3,0,3,109,-115,1,4,213,122,1,4,0,-9,-104,-237,0,0
"12149","5",330,5,2,0,2,-235,1,1,0,212,176,1,1,0,-5,-447,-175,0,-1
"12150","5",72,2,1,0,0,-199,66,-2,-3,163,157,2,2,0,-2,-362,-91,-4,-5
"12151","5",226,2,1,0,0,-62,0,-2,-3,122,2,2,-2,0,-2,-184,-2,-4,-1
"12152","5",445,6,4,1,3,57,-25,1,1,110,-62,0,0,0,-6,-53,37,1,1
"12153","5",3,1,3,0,0,-247,249,-4,-4,-99,111,-3,-3,0,-1,-148,138,-1,-1
"12154","5",9,3,4,0,2,-94,88,-2,-2,68,88,-1,-1,0,-3,-162,0,-1,-1
"12155","5",369,2,4,1,0,-203,2,-1,-3,141,2,1,0,0,-2,-344,0,-2,-3
"12156","5",142,6,2,0,2,-170,75,-4,1,-18,22,-3,-1,0,-6,-152,53,-1,2
"12157","5",260,2,3,0,0,-245,-247,-3,-3,-212,-213,-2,-2,0,-2,-33,-34,-1,-1
"12158","5",110,2,1,0,1,-98,56,3,-3,109,-113,-3,1,0,-2,-207,169,6,-4
"12159","5",75,2,4,0,2,223,34,3,-3,243,239,4,-3,0,-2,-20,-205,-1,0
"12160","5",71,4,3,0,1,-110,14,-1,-1,21,17,0,0,0,-4,-131,-3,-1,-1
"12161","5",68,1,4,0,0,-246,1,-4,-4,200,4,2,0,0,-1,-446,-3,-6,-4
"12162","5",274,6,4,0,2,-61,-17,0,1,163,85,0,0,0,-6,-224,-102,0,1
"12163","5",198,2,1,1,1,-220,-178,-2,-3,18,-80,0,0,0,-2,-238,-98,-2,-3
"12164","5",42,3,3,0,1,-79,43,-1,-2,6,1,2,-2,0,-3,-85,42,-3,0
"12165","5",343,5,2,0,2,-37,3,0,0,-48,0,-1,-1,0,-5,11,3,1,1
"12166","5",120,8,3,0,1,95,-54,3,3,95,-135,0,0,0,-8,0,81,3,3
"12167","5",117,1,4,0,2,-243,-1,-3,-4,-219,0,-2,-2,0,-1,-24,-1,-1,-2
"12168","5",11,5,4,0,1,45,16,0,0,65,28,1,1,0,-5,-20,-12,-1,-1
"12169","5",74,1,3,0,0,-148,-45,-4,-4,-194,-54,-3,-4,0,-1,46,9,-1,0
"12170","5",70,1,2,0,2,-226,-71,2,-4,195,105,1,-2,0,-1,-421,-176,1,-2
"12171","5",176,8,1,0,1,-88,-30,-2,3,123,1,1,2,0,-8,-211,-31,-3,1
"12172","5",329,3,4,1,3,68,174,2,-2,133,-107,2,2,0,-3,-65,281,0,-4
"12173","5",325,8,1,0,1,-55,-38,-3,3,16,21,0,3,0,-8,-71,-59,-3,0
"12174","5",245,1,1,0,0,-248,91,-4,-4,-196,-5,-3,-4,0,-1,-52,96,-1,0
"12175","5",395,8,3,0,1,-184,67,-2,3,225,30,-2,4,0,-8,-409,37,0,-1
"12176","5",165,5,1,0,1,148,60,0,0,120,88,1,1,0,-5,28,-28,-1,-1
"12177","5",1,3,1,0,1,-163,-169,-3,-2,-108,-33,0,0,0,-3,-55,-136,-3,-2
"12178","5",133,5,2,0,1,-142,-213,-2,0,70,46,2,-1,0,-5,-212,-259,-4,1
"12179","5",331,1,1,1,0,-243,-136,-4,-4,-188,-82,-3,-4,0,-1,-55,-54,-1,0
"12180","5",36,6,3,0,3,-187,218,2,1,144,177,3,3,0,-6,-331,41,-1,-2
"12181","5",227,8,3,0,3,-189,-13,2,3,-66,-21,1,2,0,-8,-123,8,1,1
"12182","5",446,5,4,0,1,-118,-53,-2,0,30,9,0,0,0,-5,-148,-62,-2,0
"12183","5",30,7,2,0,2,182,-4,2,2,161,-2,0,1,0,-7,21,-2,2,1
"12184","5",90,4,4,1,0,-222,22,-4,-1,231,17,4,4,0,-4,-453,5,-8,-5
"12185","5",37,1,1,0,0,-215,14,-3,-4,-48,-12,-3,-1,0,-1,-167,26,0,-3
"12186","5",143,4,1,0,3,232,-12,-4,-1,133,-84,3,3,0,-4,99,72,-7,-4
"12187","5",115,6,3,0,3,3,2,1,1,59,1,0,0,0,-6,-56,1,1,1
"12188","5",111,5,1,0,0,-230,-229,-2,0,59,215,2,2,0,-5,-289,-444,-4,-2
"12189","5",76,5,4,1,3,3,1,2,0,8,5,0,0,0,-5,-5,-4,2,0
"12190","5",31,3,1,0,0,-152,-87,-2,-2,-113,-106,-1,-1,0,-3,-39,19,-1,-1
"12191","5",69,5,4,1,1,46,142,-1,0,48,-127,-1,-2,0,-5,-2,269,0,2
"12192","5",275,2,4,0,2,243,7,3,-3,-241,5,3,-1,0,-2,484,2,0,-2
"12193","5",199,3,4,0,2,100,43,-2,-2,157,34,-1,1,0,-3,-57,9,-1,-3
"12194","5",420,4,4,0,3,-2,1,0,-1,0,0,3,1,0,-4,-2,1,-3,-2
"12195","5",344,6,4,1,3,-10,0,2,1,-52,-69,-1,0,0,-6,42,69,3,1
"12196","5",121,1,1,0,0,-243,243,-4,-4,242,-231,4,-4,0,-1,-485,474,-8,0
"12197","5",118,5,3,0,1,-92,38,-2,0,-53,64,-2,-1,0,-5,-39,-26,0,1
"12198","5",135,5,1,0,1,-241,172,-3,0,-115,30,-2,-2,0,-5,-126,142,-1,2
"12199","5",333,5,4,1,1,57,-73,0,0,65,91,1,1,0,-5,-8,-164,-1,-1
"12200","5",309,2,4,0,2,-223,93,-3,-3,208,31,1,-1,0,-2,-431,62,-4,-2
"12201","5",177,1,4,1,1,-123,-147,0,-4,-66,93,2,-3,0,-1,-57,-240,-2,-1
"12202","5",33,6,3,0,1,95,-7,-1,1,-121,-153,-3,1,0,-6,216,146,2,0
"12203","5",326,1,4,1,2,-241,-231,-4,-4,-39,-37,-2,-2,0,-1,-202,-194,-2,-2
"12204","5",246,8,4,1,3,26,2,2,3,51,-2,2,2,0,-8,-25,4,0,1
"12205","5",396,1,1,0,1,-245,245,4,-4,12,-17,2,2,0,-1,-257,262,2,-6
"12206","5",166,7,4,0,2,7,24,2,2,185,191,-1,0,0,-7,-178,-167,3,2
"12207","5",10,4,3,1,1,-7,-7,0,-1,8,1,0,-1,0,-4,-15,-8,0,0
"12208","5",134,5,2,0,2,-50,-8,0,0,-50,-8,0,-3,0,-5,0,0,0,3
"12209","5",332,1,1,0,0,-249,129,-4,-4,-246,55,-3,-3,0,-1,-3,74,-1,-1
"12210","5",360,1,3,1,0,-147,-152,-4,-4,192,197,2,-4,0,-1,-339,-349,-6,0
"12211","5",228,1,4,0,2,-48,-167,-4,-4,-173,193,4,4,0,-1,125,-360,-8,-8
"12212","5",447,4,4,0,2,-101,-1,-2,-1,177,75,2,2,0,-4,-278,-76,-4,-3
"12213","5",300,2,1,0,0,-222,29,-2,-3,-33,92,-1,-2,0,-2,-189,-63,-1,-1
"12214","5",91,5,2,1,3,108,1,1,0,64,5,1,1,0,-5,44,-4,0,-1
"12215","5",370,9,1,0,3,240,13,4,4,-5,-11,-3,-3,0,-9,245,24,7,7
"12216","5",144,3,3,0,0,-229,4,-4,-2,-3,7,1,0,0,-3,-226,-3,-5,-2
"12217","5",362,6,4,1,3,-136,78,4,1,-59,109,3,-4,0,-6,-77,-31,1,5
"12218","5",112,2,4,0,3,-180,0,-2,-3,4,-125,2,3,0,-2,-184,125,-4,-6
"12219","5",335,5,2,0,1,19,0,-1,0,51,43,1,2,0,-5,-32,-43,-2,-2
"12220","5",310,3,4,0,2,-248,-16,-2,-2,225,156,4,-4,0,-3,-473,-172,-6,2
"12221","5",356,3,4,0,1,-69,3,-1,-2,48,0,1,1,0,-3,-117,3,-2,-3
"12222","5",352,3,2,0,1,18,-66,0,-2,15,-21,0,0,0,-3,3,-45,0,-2
"12223","5",425,5,4,1,2,-28,-114,0,0,-23,46,1,1,0,-5,-5,-160,-1,-1
"12224","5",421,5,3,0,1,-169,-242,0,0,0,-1,0,0,0,-5,-169,-241,0,0
"12225","5",345,8,1,0,0,-231,239,-4,3,10,-12,0,0,0,-8,-241,251,-4,3
"12226","5",122,5,1,0,0,7,-73,0,0,194,189,2,0,0,-5,-187,-262,-2,0
"12227","5",361,1,1,0,0,-248,0,-3,-4,246,2,4,4,0,-1,-494,-2,-7,-8
"12228","5",136,1,1,0,0,-249,245,-4,-4,-35,37,-4,-4,0,-1,-214,208,0,0
"12229","5",334,3,4,1,0,-145,203,-4,-2,-246,137,-4,-4,0,-3,101,66,0,2
"12230","5",301,4,4,1,1,-213,1,-1,-1,17,1,2,2,0,-4,-230,0,-3,-3
"12231","5",23,9,1,0,3,217,222,4,4,185,169,4,4,0,-9,32,53,0,0
"12232","5",449,7,4,1,3,-4,91,0,2,-2,77,1,1,0,-7,-2,14,-1,1
"12233","5",250,6,1,0,3,88,20,1,1,91,22,1,1,0,-6,-3,-2,0,0
"12234","5",247,3,3,0,0,-238,-6,-2,-2,159,-3,1,1,0,-3,-397,-3,-3,-3
"12235","5",372,1,3,0,0,-245,-239,-4,-4,60,57,0,-4,0,-1,-305,-296,-4,0
"12236","5",146,2,2,1,0,-198,-172,-3,-3,-175,-143,-3,-3,0,-2,-23,-29,0,0
"12237","5",311,1,2,0,2,-224,4,-4,-4,148,23,4,-4,0,-1,-372,-19,-8,0
"12238","5",114,2,4,1,1,-7,-15,0,-3,112,148,1,-3,0,-2,-119,-163,-1,0
"12239","5",232,1,1,0,0,-247,-245,-4,-4,-161,-57,-1,-4,0,-1,-86,-188,-3,0
"12240","5",426,7,4,0,3,1,-246,2,2,42,2,1,1,0,-7,-41,-248,1,1
"12241","5",229,6,1,0,1,14,-25,1,1,-234,214,-3,-3,0,-6,248,-239,4,4
"12242","5",448,6,2,0,2,-245,0,-4,1,-63,0,-1,-4,0,-6,-182,0,-3,5
"12243","5",123,2,4,0,2,-209,36,-3,-3,-78,75,-3,-3,0,-2,-131,-39,0,0
"12244","5",92,1,4,0,2,-117,-94,-4,-4,-169,-146,-1,-1,0,-1,52,52,-3,-3
"12245","5",371,1,3,0,0,-217,133,-4,-4,72,-171,-2,2,0,-1,-289,304,-2,-6
"12246","5",145,2,1,0,1,-231,-221,-4,-3,-227,-245,-2,-2,0,-2,-4,24,-2,-1
"12247","5",314,1,4,0,1,-246,10,4,-4,-241,12,4,-4,0,-1,-5,-2,0,0
"12248","5",113,4,2,0,2,-50,35,1,-1,-109,-43,-1,-3,0,-4,59,78,2,2
"12249","5",336,2,4,1,3,210,153,3,-3,151,187,3,-3,0,-2,59,-34,0,0
"12250","5",251,4,3,1,1,-145,153,3,-1,120,5,-3,-2,0,-4,-265,148,6,1
"12251","5",357,1,4,0,2,-232,-28,-4,-4,86,65,2,-2,0,-1,-318,-93,-6,-2
"12252","5",353,4,2,0,2,-242,219,-4,-1,242,46,-3,0,0,-4,-484,173,-1,-1
"12253","5",147,1,2,1,3,-226,-235,-4,-4,-122,-97,-2,-1,0,-1,-104,-138,-2,-3
"12254","5",422,2,3,0,1,-5,-85,2,-3,-102,-89,3,-3,0,-2,97,4,-1,0
"12255","5",346,7,3,0,0,-249,-73,0,2,248,17,1,3,0,-7,-497,-90,-1,-1
"12256","5",233,3,2,0,2,-232,56,-3,-2,-167,25,-2,0,0,-3,-65,31,-1,-2
"12257","5",313,1,3,0,0,-237,-238,-4,-4,27,28,-2,-2,0,-1,-264,-266,-2,-2
"12258","5",339,3,3,0,1,86,62,-2,-2,52,71,-2,-2,0,-3,34,-9,0,0
"12259","5",234,4,3,1,3,83,58,0,-1,37,115,0,1,0,-4,46,-57,0,-2
"12260","5",302,3,1,0,0,-237,25,-4,-2,196,51,-2,-2,0,-3,-433,-26,-2,0
"12261","5",230,4,1,0,0,-243,74,-4,-1,-232,80,-3,0,0,-4,-11,-6,-1,-1
"12262","5",45,4,3,0,0,-118,-103,-2,-1,29,-114,2,1,0,-4,-147,11,-4,-2
"12263","5",125,5,4,1,0,-178,-30,-3,0,236,-239,-4,-2,0,-5,-414,209,1,2
"12264","5",248,6,4,1,3,8,4,2,1,96,47,1,2,0,-6,-88,-43,1,-1
"12265","5",373,1,3,0,0,-226,-35,0,-4,-214,-70,0,-4,0,-1,-12,35,0,0
"12266","5",337,7,2,0,3,-10,-11,2,2,236,-6,4,4,0,-7,-246,-5,-2,-2
"12267","5",312,5,4,1,1,132,86,0,0,-120,146,4,4,0,-5,252,-60,-4,-4
"12268","5",338,1,3,1,2,30,24,-4,-4,42,-40,-4,-4,0,-1,-12,64,0,0
"12269","5",354,1,1,0,0,-222,232,-3,-4,147,111,2,1,0,-1,-369,121,-5,-5
"12270","5",427,1,4,0,1,-250,-10,4,-4,-240,-30,4,-4,0,-1,-10,20,0,0
"12271","5",359,7,4,0,3,-82,-59,2,2,174,186,4,4,0,-7,-256,-245,-2,-2
"12272","5",355,1,2,0,2,-224,172,-4,-4,-182,100,-4,-3,0,-1,-42,72,0,-1
"12273","5",124,7,1,0,3,229,-4,3,2,205,-93,1,2,0,-7,24,89,2,0
"12274","5",93,5,1,0,1,-155,112,-2,0,-115,60,-2,0,0,-5,-40,52,0,0
"12275","5",348,3,3,0,1,95,73,0,-2,84,63,0,-2,0,-3,11,10,0,0
"12276","5",235,1,3,1,0,-233,-1,-4,-4,242,3,3,3,0,-1,-475,-4,-7,-7
"12277","5",315,9,3,0,3,249,7,4,4,233,13,4,4,0,-9,16,-6,0,0
"12278","5",340,4,1,0,1,-101,-39,0,-1,58,22,0,0,0,-4,-159,-61,0,-1
"12279","5",450,6,4,1,3,-3,116,4,1,96,4,0,-1,0,-6,-99,112,4,2
"12280","5",252,4,4,1,1,-83,-188,-1,-1,-180,-116,0,0,0,-4,97,-72,-1,-1
"12281","5",358,1,4,0,2,-235,224,-4,-4,230,95,0,-4,0,-1,-465,129,-4,0
"12282","5",374,5,4,0,2,-12,-10,0,0,13,13,1,1,0,-5,-25,-23,-1,-1
"12283","5",148,1,1,0,1,-244,-63,3,-4,-245,-56,3,-4,0,-1,1,-7,0,0
"12284","5",423,4,1,0,3,-36,-84,3,-1,-237,8,0,-2,0,-4,201,-92,3,1
"12285","5",347,9,1,1,3,-197,199,4,4,-155,150,2,4,0,-9,-42,49,2,0
"12286","5",238,2,3,0,1,-169,0,3,-3,106,30,2,2,0,-2,-275,-30,1,-5
"12287","5",318,1,2,0,2,-212,146,-4,-4,188,123,-4,2,0,-1,-400,23,0,-6
"12288","5",34,3,4,0,2,-112,115,-2,-2,-124,111,-2,-2,0,-3,12,4,0,0
"12289","5",453,3,4,0,2,-124,-1,-2,-2,-128,3,1,0,0,-3,4,-4,-3,-2
"12290","5",303,1,3,0,2,-228,-222,-4,-4,-147,-93,-3,-4,0,-1,-81,-129,-1,0
"12291","5",231,8,4,0,0,-247,0,-4,3,56,119,1,2,0,-8,-303,-119,-5,1
"12292","5",349,6,4,1,1,34,-160,1,1,85,57,2,1,0,-6,-51,-217,-1,0
"12293","5",126,3,2,0,2,-231,-231,-2,-2,-112,-83,-2,-2,0,-3,-119,-148,0,0
"12294","5",249,1,3,0,0,-222,-211,-3,-4,23,-30,1,-4,0,-1,-245,-181,-4,0
"12295","5",240,1,2,1,1,-235,14,-4,-4,211,-6,1,-2,0,-1,-446,20,-5,-2
"12296","5",237,4,2,0,2,-249,33,-1,-1,42,0,1,1,0,-4,-291,33,-2,-2
"12297","5",317,2,4,0,2,-181,127,-3,-3,-143,114,-3,-3,0,-2,-38,13,0,0
"12298","5",456,1,1,0,0,-245,181,-2,-4,198,133,2,-2,0,-1,-443,48,-4,-2
"12299","5",452,5,3,0,1,1,-2,0,0,-70,2,-1,-1,0,-5,71,-4,1,1
"12300","5",428,1,1,0,0,-245,-245,-4,-4,-247,-249,-4,-4,0,-1,2,4,0,0
"12301","5",457,7,3,0,1,152,0,2,2,130,-124,3,3,0,-7,22,124,-1,-1
"12302","5",376,4,4,1,1,-53,-145,-1,-1,38,-134,-1,-1,0,-4,-91,-11,0,0
"12303","5",15,7,4,1,3,119,30,3,2,134,74,3,2,0,-7,-15,-44,0,0
"12304","5",94,4,4,0,1,-175,-168,2,-1,119,107,-1,1,0,-4,-294,-275,3,-2
"12305","5",24,1,2,0,2,-247,-2,0,-4,242,1,0,-4,0,-1,-489,-3,0,0
"12306","5",236,5,1,0,1,-72,-25,0,0,29,-23,-2,0,0,-5,-101,-2,2,0
"12307","5",316,2,3,0,0,-72,-89,-3,-3,-112,-102,-3,-3,0,-2,40,13,0,0
"12308","5",455,1,2,0,2,-190,-9,-4,-4,236,-6,4,4,0,-1,-426,-3,-8,-8
"12309","5",451,2,1,0,0,-218,-198,-3,-3,-187,-164,-2,-3,0,-2,-31,-34,-1,0
"12310","5",253,9,3,0,3,194,229,4,4,220,229,4,4,0,-9,-26,0,0,0
"12311","5",25,2,4,0,2,-139,-116,-2,-3,-38,-15,-2,-2,0,-2,-101,-101,0,-1
"12312","5",375,5,3,0,1,13,-1,0,0,0,-1,0,0,0,-5,13,0,0,0
"12313","5",149,6,3,0,1,-239,42,-3,1,243,17,-3,1,0,-6,-482,25,0,0
"12314","5",424,3,2,0,2,-106,-13,-2,-2,126,80,1,-1,0,-3,-232,-93,-3,-1
"12315","5",391,7,2,0,3,165,162,2,2,151,94,0,0,0,-7,14,68,2,2
"12316","5",239,8,1,0,1,243,1,3,3,211,-3,4,4,0,-8,32,4,-1,-1
"12317","5",319,4,1,0,1,-133,-1,-2,-1,48,-4,1,2,0,-4,-181,3,-3,-3
"12318","5",458,2,1,0,1,-92,-80,0,-3,76,77,-1,-2,0,-2,-168,-157,1,-1
"12319","5",454,8,4,0,3,247,1,3,3,248,-1,4,4,0,-8,-1,2,-1,-1
"12320","5",304,1,2,0,2,-238,-9,-4,-4,62,-21,2,2,0,-1,-300,12,-6,-6
"12321","5",95,2,4,0,2,-179,-3,-3,-3,-165,-3,-1,-1,0,-2,-14,0,-2,-2
"12322","5",35,4,1,0,3,38,169,0,-1,129,166,2,-1,0,-4,-91,3,-2,0
"12323","5",127,1,1,0,0,-226,6,-4,-4,122,1,1,-3,0,-1,-348,5,-5,-1
"12324","5",305,6,4,1,3,59,32,0,1,-98,19,1,1,0,-6,157,13,-1,0
"12325","5",46,1,1,0,0,-202,-243,0,-4,-8,-245,-4,-4,0,-1,-194,2,4,0
"12326","5",387,1,3,0,1,124,78,-3,-4,165,164,2,3,0,-1,-41,-86,-5,-7
"12327","5",306,5,3,0,3,138,120,1,0,121,130,1,0,0,-5,17,-10,0,0
"12328","5",97,2,1,0,1,-242,-48,4,-3,29,19,2,-2,0,-2,-271,-67,2,-1
"12329","5",388,4,4,1,0,-249,9,-4,-1,-246,6,-2,-1,0,-4,-3,3,-2,0
"12330","5",307,1,4,1,2,-246,247,-4,-4,-220,4,-4,-4,0,-1,-26,243,0,0
"12331","5",98,1,3,0,0,-232,30,-4,-4,-102,-129,-1,-1,0,-1,-130,159,-3,-3
"12332","5",377,1,1,0,0,-238,13,0,-4,-245,7,-4,-4,0,-1,7,6,4,0
"12333","5",150,5,3,1,1,1,-2,0,0,2,-2,0,0,0,-5,-1,0,0,0
"12334","5",308,1,4,0,0,-247,-247,-4,-4,177,182,0,2,0,-1,-424,-429,-4,-6
"12335","5",459,1,3,0,1,-91,-217,2,-4,-48,-141,2,-4,0,-1,-43,-76,0,0
"12336","5",386,1,1,0,0,-248,176,-4,-4,12,14,1,1,0,-1,-260,162,-5,-5
"12337","5",151,1,2,0,1,-249,7,0,-4,-244,10,0,-4,0,-1,-5,-3,0,0
"12338","5",96,3,1,0,0,-153,-8,-2,-2,-46,-2,-2,-2,0,-3,-107,-6,0,0
"12339","5",350,5,4,0,1,-244,7,0,0,243,1,4,0,0,-5,-487,6,-4,0
"12340","5",128,7,1,0,3,202,2,2,2,202,2,2,2,0,-7,0,0,0,0
"12341","5",160,7,2,0,0,125,1,-4,2,-50,-135,-4,2,0,-7,175,136,0,0
"12342","5",351,1,1,0,0,-246,-245,-4,-4,136,117,-4,-4,0,-1,-382,-362,0,0
"12343","5",129,6,4,1,1,71,-3,1,1,130,13,1,1,0,-6,-59,-16,0,0
"12344","5",161,1,2,0,2,-244,222,-4,-4,83,48,1,-3,0,-1,-327,174,-5,-1
"12345","5",392,3,1,0,0,-151,109,-2,-2,-137,9,-4,-2,0,-3,-14,100,2,0
"12346","5",389,5,3,0,2,-226,-4,4,0,-2,-1,0,0,0,-5,-224,-3,4,0
"12347","5",13,1,4,0,1,-166,-61,-3,-4,-73,-59,2,-4,0,-1,-93,-2,-5,0
"12348","5",99,9,4,1,3,233,-14,4,4,25,-239,4,4,0,-9,208,225,0,0
"12349","5",378,3,4,1,1,-179,1,1,-2,-138,-1,-2,-2,0,-3,-41,2,3,0
"12350","5",39,2,3,0,1,-234,1,-3,-3,132,143,2,3,0,-2,-366,-142,-5,-6
"12351","5",16,1,1,0,0,-239,236,0,-4,57,-19,1,-3,0,-1,-296,255,-1,-1
"12352","5",394,1,3,0,0,-246,195,-4,-4,-247,158,-4,-4,0,-1,1,37,0,0
"12353","5",390,1,2,0,2,-221,-2,-4,-4,6,-6,0,0,0,-1,-227,4,-4,-4
"12354","5",152,1,1,0,0,-161,-6,-2,-4,-140,1,-1,-4,0,-1,-21,-7,-1,0
"12355","5",157,9,3,0,2,177,182,4,4,109,85,-2,0,0,-9,68,97,6,4
"12356","5",38,6,4,0,3,82,2,1,1,227,-40,1,1,0,-6,-145,42,0,0
"12357","5",153,6,1,0,3,-144,-92,3,1,-13,-24,0,1,0,-6,-131,-68,3,0
"12358","5",158,1,3,0,0,-245,-7,-4,-4,-232,-17,-3,-3,0,-1,-13,10,-1,-1
"12359","5",380,4,4,0,1,-210,-142,3,-1,-219,-141,3,-4,0,-4,9,-1,0,3
"12360","5",384,1,1,0,0,-249,5,-1,-4,-213,1,0,-4,0,-1,-36,4,-1,0
"12361","5",162,9,3,0,3,86,75,4,4,210,205,4,4,0,-9,-124,-130,0,0
"12362","5",393,1,1,0,0,-199,-174,-4,-4,24,-77,-4,-4,0,-1,-223,-97,0,0
"12363","5",381,1,2,0,2,-221,208,-4,-4,189,144,4,4,0,-1,-410,64,-8,-8
"12364","5",130,9,1,1,3,92,79,4,4,-146,-43,2,-4,0,-9,238,122,2,8
"12365","5",156,5,2,1,1,1,-1,0,0,68,39,1,1,0,-5,-67,-40,-1,-1
"12366","5",379,5,3,1,1,63,-52,-2,0,-19,-38,1,-1,0,-5,82,-14,-3,1
"12367","5",382,3,4,0,2,-179,-11,-2,-2,94,-14,1,2,0,-3,-273,3,-3,-4
"12368","5",164,3,2,0,2,1,-143,-2,-2,-4,-2,0,0,0,-3,5,-141,-2,-2
"12369","5",385,4,4,1,1,103,-109,-1,-1,128,67,3,1,0,-4,-25,-176,-4,-2
"12370","5",383,5,4,1,1,-4,0,0,0,250,-1,0,1,0,-5,-254,1,0,-1
"12371","5",132,5,4,1,1,48,-124,1,0,28,137,1,2,0,-5,20,-261,0,-2
"12372","5",131,7,4,0,3,-137,144,-3,2,132,102,3,3,0,-7,-269,42,-6,-1
"12373","5",154,4,4,1,3,-86,-9,-1,-1,-91,35,-1,-1,0,-4,5,-44,0,0
"12374","5",159,2,3,0,2,242,5,-3,-3,244,7,4,4,0,-2,-2,-2,-7,-7
"12375","5",163,6,3,0,1,-169,4,-1,1,111,-36,3,1,0,-6,-280,40,-4,0
"12376","5",155,5,2,0,1,-168,-201,3,0,-113,-109,0,0,0,-5,-55,-92,3,0
"12377","6",439,5,2,1,1,-8,2,0,0,5,-4,-3,0,3,-2,-13,6,3,0
"12378","6",363,8,3,1,3,250,-1,3,3,-248,-1,-3,-3,3,-5,498,0,6,6
"12379","6",344,5,4,1,3,45,103,0,0,140,-107,2,2,3,-2,-95,210,-2,-2
"12380","6",434,6,4,1,3,13,-3,1,1,-32,-3,1,2,3,-3,45,0,0,-1
"12381","6",432,4,2,1,1,-32,-21,0,-1,29,1,0,0,3,-1,-61,-22,0,-1
"12382","6",43,1,3,0,0,-82,-1,-3,-4,178,5,-2,-3,3,2,-260,-6,-1,-1
"12383","6",343,6,2,1,2,-25,0,1,1,-18,2,-1,0,3,-3,-7,-2,2,1
"12384","6",341,9,1,0,3,247,-30,4,4,246,-28,4,4,3,-6,1,-2,0,0
"12385","6",430,6,2,1,1,56,-34,1,1,167,-78,1,0,3,-3,-111,44,0,1
"12386","6",345,2,1,1,0,-136,30,-3,-3,-219,106,-4,-3,3,1,83,-76,1,0
"12387","6",435,5,4,1,1,-1,-4,0,0,152,-9,3,0,3,-2,-153,5,-3,0
"12388","6",342,4,3,1,1,2,5,0,-1,22,43,-1,0,3,-1,-20,-38,1,-1
"12389","6",44,2,2,0,2,-219,71,-2,-3,198,-206,0,-2,3,1,-417,277,-2,-1
"12390","6",433,7,1,1,0,-66,-76,2,2,222,221,3,3,3,-4,-288,-297,-1,-1
"12391","6",436,5,4,1,3,122,-1,4,0,114,-141,4,-1,3,-2,8,140,0,1
"12392","6",331,1,1,0,0,93,87,-2,-4,-242,-199,-4,-4,3,2,335,286,2,0
"12393","6",364,5,3,0,1,-17,-17,0,0,10,8,-1,0,3,-2,-27,-25,1,0
"12394","6",438,5,4,1,3,82,5,2,0,84,3,4,0,3,-2,-2,2,-2,0
"12395","6",179,5,1,1,1,0,-1,3,0,2,3,0,0,3,-2,-2,-4,3,0
"12396","6",466,4,3,1,0,-37,-98,-1,-1,-135,-98,-2,-2,3,-1,98,0,1,1
"12397","6",365,1,3,1,1,-176,-3,0,-4,-247,-1,0,-4,3,2,71,-2,0,0
"12398","6",369,3,4,1,0,-65,0,-1,-2,72,3,0,0,3,0,-137,-3,-1,-2
"12399","6",333,6,4,1,1,-95,-97,1,1,-95,-98,-1,-1,3,-3,0,1,2,2
"12400","6",366,8,4,0,3,127,-45,2,3,141,-120,2,3,3,-5,-14,75,0,0
"12401","6",431,5,3,1,0,4,10,0,0,27,36,0,0,3,-2,-23,-26,0,0
"12402","6",330,5,2,0,2,-218,1,1,0,204,161,1,1,3,-2,-422,-160,0,-1
"12403","6",367,3,3,1,1,-61,-88,2,-2,-101,-67,2,-1,3,0,40,-21,0,-1
"12404","6",437,3,1,1,0,-200,4,-2,-2,-200,4,-2,-2,3,0,0,0,0,0
"12405","6",140,7,1,1,1,-20,69,0,2,-26,-49,-1,0,3,-4,6,118,1,2
"12406","6",440,3,3,1,0,0,2,-2,-2,-53,1,-3,-3,3,0,53,1,1,1
"12407","6",368,5,3,0,3,-90,-77,0,0,-169,143,4,4,3,-2,79,-220,-4,-4
"12408","6",194,9,1,0,0,-227,-12,-4,4,-230,-19,-4,4,3,-6,3,7,0,0
"12409","6",332,2,1,0,0,-249,145,-2,-3,-249,99,-3,-3,3,1,0,46,1,0
"12410","6",441,2,4,1,2,-119,54,-2,-3,-46,29,-3,-2,3,1,-73,25,1,-1
"12411","6",183,3,4,1,1,98,117,1,-2,-190,-77,1,-2,3,0,288,194,0,0
"12412","6",142,6,2,0,2,-69,27,-3,1,-139,35,-4,1,3,-3,70,-8,1,0
"12413","6",467,5,1,1,3,-74,36,4,0,72,185,4,0,3,-2,-146,-149,0,0
"12414","6",192,7,4,1,1,-3,30,1,2,-148,-1,-2,0,3,-4,145,31,3,2
"12415","6",189,2,1,0,1,-93,72,3,-3,-143,25,3,-3,3,1,50,47,0,0
"12416","6",346,7,3,1,0,-250,-70,-3,2,250,2,2,2,3,-4,-500,-72,-5,0
"12417","6",429,1,2,0,0,-219,-172,-4,-4,-229,-138,-4,-4,3,2,10,-34,0,0
"12418","6",464,6,1,0,1,17,21,1,1,92,23,1,1,3,-3,-75,-2,0,0
"12419","6",335,5,2,1,1,9,9,0,0,67,30,1,1,3,-2,-58,-21,-1,-1
"12420","6",182,6,4,1,3,-5,-141,2,1,3,-180,2,2,3,-3,-8,39,0,-1
"12421","6",133,4,2,1,1,-43,36,0,-1,230,14,4,0,3,-1,-273,22,-4,-1
"12422","6",141,4,1,0,0,-112,-85,-2,-1,-220,-232,-4,-4,3,-1,108,147,2,3
"12423","6",336,3,4,1,3,176,152,3,-2,168,139,2,-3,3,0,8,13,1,1
"12424","6",352,5,2,0,1,-48,-108,0,0,9,-110,0,-1,3,-2,-57,2,0,1
"12425","6",18,3,3,1,1,-3,-14,1,-2,64,18,1,0,3,0,-67,-32,0,-2
"12426","6",337,9,2,1,3,235,-25,4,4,238,-21,4,4,3,-6,-3,-4,0,0
"12427","6",442,6,4,1,1,-20,47,-1,1,37,46,1,1,3,-3,-57,1,-2,0
"12428","6",37,1,1,1,0,-133,15,-3,-4,-199,28,-4,-4,3,2,66,-13,1,0
"12429","6",334,1,4,1,0,-227,176,-4,-4,-178,170,-4,-2,3,2,-49,6,0,-2
"12430","6",193,1,1,0,0,187,109,-4,-4,216,169,1,1,3,2,-29,-60,-5,-5
"12431","6",181,6,4,1,3,148,-97,0,1,-51,-100,2,2,3,-3,199,3,-2,-1
"12432","6",19,7,2,1,2,70,33,1,2,82,-39,-2,-2,3,-4,-12,72,3,4
"12433","6",347,7,1,1,3,-200,-145,1,2,155,-180,2,-2,3,-4,-355,35,-1,4
"12434","6",473,3,3,0,0,-34,-26,-1,-2,-177,-18,0,-2,3,0,143,-8,-1,0
"12435","6",36,3,3,1,3,174,184,2,-2,-130,-86,-1,-2,3,0,304,270,3,0
"12436","6",356,4,4,0,1,-56,-1,-1,-1,19,-4,-1,-2,3,-1,-75,3,0,1
"12437","6",348,3,3,1,1,50,45,-1,-2,61,47,0,-2,3,0,-11,-2,-1,0
"12438","6",195,3,1,1,1,-158,117,2,-2,-112,101,3,-3,3,0,-46,16,-1,1
"12439","6",191,2,1,0,0,-213,-36,-2,-3,-168,-66,-2,-2,3,1,-45,30,0,-1
"12440","6",139,1,4,1,2,-249,-3,-4,-4,-242,-2,-4,-4,3,2,-7,-1,0,0
"12441","6",184,4,3,1,3,116,1,-1,-1,76,-1,1,1,3,-1,40,2,-2,-2
"12442","6",143,4,1,1,3,-14,26,-1,-1,62,-13,3,3,3,-1,-76,39,-4,-4
"12443","6",468,4,1,1,3,74,28,1,-1,98,22,1,-1,3,-1,-24,6,0,0
"12444","6",354,6,1,1,0,40,46,1,1,98,88,1,3,3,-3,-58,-42,0,-2
"12445","6",178,5,1,0,1,0,-3,0,0,-5,1,0,0,3,-2,5,-4,0,0
"12446","6",137,5,1,0,1,-98,-66,2,0,-242,-81,-4,-2,3,-2,144,15,6,2
"12447","6",469,1,4,1,0,33,0,-2,-4,74,82,-3,-4,3,2,-41,-82,1,0
"12448","6",465,9,4,1,3,128,5,4,4,-17,-232,4,3,3,-6,145,237,0,1
"12449","6",190,7,4,1,3,192,219,2,2,203,145,2,2,3,-4,-11,74,0,0
"12450","6",138,5,3,1,1,-3,-7,0,0,69,-54,0,0,3,-2,-72,47,0,0
"12451","6",134,4,2,1,2,-154,-8,1,-1,-47,-6,0,-1,3,-1,-107,-2,1,0
"12452","6",360,1,3,1,0,-114,-10,-4,-4,125,182,0,-4,3,2,-239,-192,-4,0
"12453","6",357,7,4,1,2,65,-25,2,2,98,77,-2,-2,3,-4,-33,-102,4,4
"12454","6",353,5,2,0,2,-242,67,1,0,237,103,-3,0,3,-2,-479,-36,4,0
"12455","6",180,1,2,1,2,-121,1,-3,-4,-239,1,-3,0,3,2,118,0,0,-4
"12456","6",338,1,3,1,2,68,58,-3,-4,69,44,-4,-4,3,2,-1,14,1,0
"12457","6",443,4,1,1,0,-17,-5,-1,-1,74,28,1,1,3,-1,-91,-33,-2,-2
"12458","6",370,9,1,0,3,245,-3,4,4,-244,-8,-4,-4,3,-6,489,5,8,8
"12459","6",144,3,3,1,0,-48,-26,0,-2,3,1,2,0,3,0,-51,-27,-2,-2
"12460","6",339,2,3,1,1,-46,-69,-3,-3,92,91,-3,-2,3,1,-138,-160,0,-1
"12461","6",186,3,2,1,2,-59,52,0,-2,-2,4,0,0,3,0,-57,48,0,-2
"12462","6",52,2,3,1,0,-97,-2,-2,-3,0,-65,1,-2,3,1,-97,63,-3,-1
"12463","6",49,5,4,1,1,42,118,0,0,129,32,2,0,3,-2,-87,86,-2,0
"12464","6",474,1,1,1,0,2,-67,0,-4,1,-81,0,-4,3,2,1,14,0,0
"12465","6",171,5,1,0,1,14,21,0,0,26,63,0,0,3,-2,-12,-42,0,0
"12466","6",168,7,1,0,3,78,-115,1,2,133,-58,1,2,3,-4,-55,-57,0,0
"12467","6",349,5,4,1,1,-41,-104,-1,0,96,45,2,3,3,-2,-137,-149,-3,-3
"12468","6",196,2,3,1,0,40,2,-1,-3,134,134,1,1,3,1,-94,-132,-2,-4
"12469","6",122,1,1,0,0,-187,-179,-4,-4,216,208,4,4,3,2,-403,-387,-8,-8
"12470","6",14,6,3,1,1,-30,-19,1,1,206,-57,4,3,3,-3,-236,38,-3,-2
"12471","6",185,3,4,1,2,7,-7,-2,-2,240,-21,-1,3,3,0,-233,14,-1,-5
"12472","6",51,1,4,1,1,44,49,-1,-4,40,74,-2,0,3,2,4,-25,1,-4
"12473","6",48,1,3,1,0,61,-64,-4,-4,76,-60,-4,-4,3,2,-15,-4,0,0
"12474","6",355,3,2,1,2,-82,-26,-4,-2,-195,158,-4,-4,3,0,113,-184,0,2
"12475","6",170,1,2,1,0,-234,-239,-4,-4,9,9,0,0,3,2,-243,-248,-4,-4
"12476","6",167,4,1,0,3,-163,115,-1,-1,163,-181,3,3,3,-1,-326,296,-4,-4
"12477","6",100,9,4,1,3,243,4,4,4,237,4,4,4,3,-6,6,0,0,0
"12478","6",397,6,4,1,3,97,-144,1,1,135,43,3,3,3,-3,-38,-187,-2,-2
"12479","6",462,9,3,1,3,-48,100,4,4,202,196,-4,-4,3,-6,-250,-96,8,8
"12480","6",340,4,1,1,1,-40,8,0,-1,100,24,0,0,3,-1,-140,-16,0,-1
"12481","6",135,5,1,0,1,-205,-90,0,0,-201,-57,0,0,3,-2,-4,-33,0,0
"12482","6",361,2,1,1,0,2,-249,1,-3,2,-248,3,-1,3,1,0,-1,-2,-2
"12483","6",358,1,4,1,2,-32,71,-4,-4,-246,126,-4,-4,3,2,214,-55,0,0
"12484","6",476,4,3,1,0,-57,-56,-1,-1,-117,-205,0,0,3,-1,60,149,-1,-1
"12485","6",173,5,4,0,3,204,12,0,0,178,-2,0,0,3,-2,26,14,0,0
"12486","6",17,1,3,1,0,66,46,-1,-4,175,115,-2,-4,3,2,-109,-69,1,0
"12487","6",444,1,2,1,2,-247,1,-4,-4,-185,55,-4,-4,3,2,-62,-54,0,0
"12488","6",371,4,3,1,0,-118,-197,-1,-1,46,-171,-1,-1,3,-1,-164,-26,0,0
"12489","6",145,1,1,1,1,-198,-162,-4,-4,-245,-143,-3,-3,3,2,47,-19,-1,-1
"12490","6",34,4,4,1,2,-61,49,-1,-1,-90,116,0,-2,3,-1,29,-67,-1,1
"12491","6",187,6,4,1,2,55,36,1,1,220,-3,2,3,3,-3,-165,39,-1,-2
"12492","6",53,7,4,1,3,204,-4,2,2,-1,-77,2,2,3,-4,205,73,0,0
"12493","6",5,2,2,0,2,-241,5,-2,-3,-237,4,-3,-4,3,1,-4,1,1,1
"12494","6",475,4,3,1,3,38,-6,0,-1,83,-55,0,0,3,-1,-45,49,0,-1
"12495","6",172,7,2,1,3,104,104,2,2,-179,83,-3,-3,3,-4,283,21,5,5
"12496","6",169,4,3,1,0,-77,118,-2,-1,-223,213,-4,-4,3,-1,146,-95,2,3
"12497","6",35,2,1,1,3,30,157,0,-3,124,167,3,-2,3,1,-94,-10,-3,-1
"12498","6",197,9,4,1,3,120,-99,1,4,139,-113,0,4,3,-6,-19,14,1,0
"12499","6",123,2,4,1,2,-170,-5,-3,-3,-178,29,-3,-3,3,1,8,-34,0,0
"12500","6",88,1,4,1,2,-245,-7,-4,-4,207,-212,4,4,3,2,-452,205,-8,-8
"12501","6",217,2,4,1,2,-47,21,-1,-3,-30,25,-1,-3,3,1,-17,-4,0,0
"12502","6",213,6,2,1,1,38,0,1,1,-2,-119,-1,0,3,-3,40,119,2,1
"12503","6",21,2,4,1,2,52,66,-1,-3,113,130,1,-1,3,1,-61,-64,-2,-2
"12504","6",77,4,3,1,1,-67,2,-1,-1,-4,22,-1,-1,3,-1,-63,-20,0,0
"12505","6",175,3,4,1,1,-85,-41,-3,-2,-73,-56,-1,-3,3,0,-12,15,-2,1
"12506","6",470,4,1,0,1,-63,24,-1,-1,-50,10,2,-1,3,-1,-13,14,-3,0
"12507","6",101,2,3,1,0,-132,130,-3,-3,227,234,-3,-3,3,1,-359,-104,0,0
"12508","6",398,3,4,1,2,46,54,-2,-2,-171,-103,-3,-3,3,0,217,157,1,1
"12509","6",463,5,4,1,3,14,-6,0,0,-246,-9,-1,0,3,-2,260,3,1,0
"12510","6",418,4,2,0,2,-124,36,-2,-1,145,85,-1,-2,3,-1,-269,-49,-1,1
"12511","6",136,1,1,1,0,-246,239,-4,-4,-98,92,-4,-4,3,2,-148,147,0,0
"12512","6",362,3,4,0,3,-122,117,1,-2,-104,111,2,-3,3,0,-18,6,-1,1
"12513","6",359,9,4,1,3,33,37,4,4,190,212,2,4,3,-6,-157,-175,2,0
"12514","6",407,3,2,1,2,-130,-37,-2,-2,110,24,2,2,3,0,-240,-61,-4,-4
"12515","6",174,6,4,1,3,103,50,0,1,127,42,1,1,3,-3,-24,8,-1,0
"12516","6",47,6,4,1,3,177,-1,1,1,39,0,-1,1,3,-3,138,-1,2,0
"12517","6",445,6,4,1,3,83,-25,0,1,59,-59,1,1,3,-3,24,34,-1,0
"12518","6",372,3,3,0,0,-212,-208,-3,-2,17,22,-1,-4,3,0,-229,-230,-2,2
"12519","6",146,2,2,1,0,-177,-183,-3,-3,-179,-167,-3,-3,3,1,2,-16,0,0
"12520","6",9,5,4,1,2,61,58,1,0,68,62,-1,-2,3,-2,-7,-4,2,2
"12521","6",188,8,2,0,3,183,7,3,3,127,-4,3,3,3,-5,56,11,0,0
"12522","6",54,3,4,1,1,34,19,-2,-2,67,45,0,0,3,0,-33,-26,-2,-2
"12523","6",50,4,2,1,1,6,0,0,-1,44,-80,0,-1,3,-1,-38,80,0,0
"12524","6",79,3,4,1,2,-207,-196,-2,-2,-237,-17,-3,-2,3,0,30,-179,1,0
"12525","6",177,4,4,1,1,35,188,2,-1,-124,124,2,-4,3,-1,159,64,0,3
"12526","6",472,1,1,1,0,-236,173,-4,-4,-235,200,-4,-4,3,2,-1,-27,0,0
"12527","6",350,1,4,1,1,-245,6,-3,-4,-6,-242,3,1,3,2,-239,248,-6,-5
"12528","6",198,3,1,1,1,-120,93,-1,-2,-193,-177,-2,-3,3,0,73,270,1,1
"12529","6",124,7,1,0,3,212,2,3,2,241,30,4,1,3,-4,-29,-28,-1,1
"12530","6",89,1,3,1,0,-207,0,-1,-4,-246,2,-4,-4,3,2,39,-2,3,0
"12531","6",218,8,4,0,3,-17,-16,4,3,-26,22,4,3,3,-5,9,-38,0,0
"12532","6",214,9,1,0,3,224,0,4,4,194,2,4,4,3,-6,30,-2,0,0
"12533","6",210,6,4,1,2,90,-79,1,1,-155,-47,0,-4,3,-3,245,-32,1,5
"12534","6",78,2,4,0,0,-210,2,-3,-3,-230,2,-3,-3,3,1,20,0,0,0
"12535","6",176,8,1,1,1,189,32,1,3,140,31,2,3,3,-5,49,1,-1,0
"12536","6",471,7,3,1,2,-241,48,-2,2,-48,91,-1,0,3,-4,-193,-43,-1,2
"12537","6",102,9,4,0,3,-25,51,2,4,-95,-69,-1,1,3,-6,70,120,3,3
"12538","6",399,4,4,1,3,107,3,1,-1,36,43,-1,-1,3,-1,71,-40,2,0
"12539","6",395,8,3,1,1,44,12,-2,3,212,21,3,4,3,-5,-168,-9,-5,-1
"12540","6",419,7,4,1,3,45,81,-1,2,32,43,1,1,3,-4,13,38,-2,1
"12541","6",266,5,1,0,1,0,1,0,0,-2,-1,0,0,3,-2,2,2,0,0
"12542","6",56,4,3,1,1,43,-118,-1,-1,46,-114,-2,0,3,-1,-3,-4,1,-1
"12543","6",112,8,4,1,3,-1,246,3,3,238,6,4,3,3,-5,-239,240,-1,0
"12544","6",408,2,1,1,0,-137,-4,-1,-3,-241,4,-1,-2,3,1,104,-8,0,-1
"12545","6",206,3,4,1,0,-110,-57,-3,-2,245,247,4,4,3,0,-355,-304,-7,-6
"12546","6",255,6,3,1,1,119,-50,1,1,-78,-99,0,0,3,-3,197,49,1,1
"12547","6",446,5,4,1,1,216,207,-1,0,124,212,-2,1,3,-2,92,-5,1,-1
"12548","6",373,3,3,1,0,-221,-37,1,-2,-224,-44,0,-4,3,0,3,7,1,2
"12549","6",147,6,2,1,3,-142,-177,0,1,73,89,0,1,3,-3,-215,-266,0,0
"12550","6",90,1,4,0,0,-241,13,-2,-4,234,13,4,4,3,2,-475,0,-6,-8
"12551","6",265,4,1,1,3,-20,-1,-2,-1,0,0,0,0,3,-1,-20,-1,-2,-1
"12552","6",55,5,4,1,1,17,4,0,0,9,2,1,0,3,-2,8,2,-1,0
"12553","6",111,6,1,0,0,-145,83,-1,1,67,168,1,-1,3,-3,-212,-85,-2,2
"12554","6",8,7,3,0,1,22,-99,-2,2,-54,109,1,1,3,-4,76,-208,-3,1
"12555","6",258,2,3,0,0,90,0,1,-3,-61,2,2,2,3,1,151,-2,-1,-5
"12556","6",254,4,2,1,3,120,-27,0,-1,97,-34,-2,-1,3,-1,23,7,2,0
"12557","6",351,1,1,0,0,-219,-194,-4,-4,121,125,-4,-4,3,2,-340,-319,0,0
"12558","6",199,6,4,1,2,83,58,1,1,68,37,1,1,3,-3,15,21,0,0
"12559","6",125,3,4,1,0,80,-47,-3,-2,-27,-18,-3,0,3,0,107,-29,0,-2
"12560","6",420,5,4,0,3,1,1,-3,0,-126,2,-1,1,3,-2,127,-1,-2,-1
"12561","6",219,5,4,1,3,246,5,4,0,249,1,0,4,3,-2,-3,4,4,-4
"12562","6",215,2,1,0,0,-118,27,-2,-3,-109,28,-2,-3,3,1,-9,-1,0,0
"12563","6",211,7,3,1,1,-33,-64,-2,2,105,114,-2,2,3,-4,-138,-178,0,0
"12564","6",41,6,2,1,3,16,64,3,1,15,70,2,1,3,-3,1,-6,1,0
"12565","6",208,3,4,0,2,-180,-137,-2,-2,209,233,-3,-3,3,0,-389,-370,1,1
"12566","6",257,1,1,1,0,-22,-248,-4,-4,94,44,-4,-4,3,2,-116,-292,0,0
"12567","6",103,5,2,1,3,8,-4,1,0,3,-63,1,1,3,-2,5,59,0,-1
"12568","6",4,4,3,1,1,-14,1,-1,-1,241,97,3,3,3,-1,-255,-96,-4,-4
"12569","6",396,1,1,1,1,-230,108,4,-4,-2,1,4,-4,3,2,-228,107,0,0
"12570","6",42,3,3,1,1,-50,37,2,-2,-66,49,0,-2,3,0,16,-12,2,0
"12571","6",267,4,3,0,1,6,0,-1,-1,38,-16,1,0,3,-1,-32,16,-2,-1
"12572","6",57,1,4,1,1,42,-192,-3,-4,-25,-182,-4,-4,3,2,67,-10,1,0
"12573","6",113,4,2,0,2,-28,-13,-1,-1,9,23,-1,-1,3,-1,-37,-36,0,0
"12574","6",409,5,4,0,2,-41,-48,0,0,106,117,2,1,3,-2,-147,-165,-2,-1
"12575","6",207,5,1,0,0,-247,2,-1,0,25,1,0,1,3,-2,-272,1,-1,-1
"12576","6",256,5,3,0,1,-79,1,0,0,47,5,0,0,3,-2,-126,-4,0,0
"12577","6",447,6,4,1,2,120,14,-2,1,82,50,2,2,3,-3,38,-36,-4,-1
"12578","6",374,6,4,1,2,61,15,1,1,42,7,0,0,3,-3,19,8,1,1
"12579","6",148,2,1,1,1,-195,-82,2,-3,-246,-84,3,-4,3,1,51,2,-1,1
"12580","6",91,5,2,0,3,107,3,0,0,103,-3,1,2,3,-2,4,6,-1,-2
"12581","6",220,1,4,0,2,-231,89,-4,-4,119,86,-2,-2,3,2,-350,3,-2,-2
"12582","6",298,4,1,1,0,-106,15,0,-1,2,-242,-1,0,3,-1,-108,257,1,-1
"12583","6",84,6,4,1,3,145,3,1,1,98,-1,2,1,3,-3,47,4,-1,0
"12584","6",80,8,4,1,3,46,1,3,3,244,3,3,0,3,-5,-198,-2,0,3
"12585","6",259,2,3,1,1,-168,0,4,-3,-1,3,4,-4,3,1,-167,-3,0,1
"12586","6",109,1,1,0,1,-2,-212,0,-4,-69,-1,3,-4,3,2,67,-211,-3,0
"12587","6",202,6,1,0,1,53,-18,2,1,79,-20,2,1,3,-3,-26,2,0,0
"12588","6",2,5,4,1,1,-63,-45,-1,0,-79,-171,3,0,3,-2,16,126,-4,0
"12589","6",126,4,2,1,2,22,23,-1,-1,-226,-238,-2,-2,3,-1,248,261,1,1
"12590","6",421,7,3,1,1,37,27,0,2,30,21,1,4,3,-4,7,6,-1,-2
"12591","6",22,4,3,1,1,-60,7,-1,-1,13,11,0,0,3,-1,-73,-4,-1,-1
"12592","6",216,6,3,0,1,51,-4,0,1,43,-24,-1,0,3,-3,8,20,1,1
"12593","6",212,5,1,0,1,-35,9,4,0,-220,24,4,-2,3,-2,185,-15,0,2
"12594","6",410,1,1,1,0,-163,-21,-2,-4,-190,-21,0,-2,3,2,27,0,-2,-2
"12595","6",209,7,4,1,3,153,3,2,2,-238,-1,0,0,3,-4,391,4,2,2
"12596","6",108,9,2,1,3,227,34,4,4,237,37,4,4,3,-6,-10,-3,0,0
"12597","6",104,2,1,0,0,-237,0,1,-3,224,-4,1,-3,3,1,-461,4,0,0
"12598","6",40,2,1,1,2,-191,-71,-1,-3,169,129,4,0,3,1,-360,-200,-5,-3
"12599","6",250,6,1,0,3,69,27,1,1,83,23,1,1,3,-3,-14,4,0,0
"12600","6",247,5,3,1,0,-22,-6,0,0,217,-3,0,0,3,-2,-239,-3,0,0
"12601","6",268,7,4,1,3,132,124,2,2,116,-126,3,3,3,-4,16,250,-1,-1
"12602","6",58,6,4,1,1,-250,3,1,1,-3,223,4,4,3,-3,-247,-220,-3,-3
"12603","6",114,2,4,1,1,16,12,1,-3,93,125,1,-3,3,1,-77,-113,0,0
"12604","6",386,2,1,0,0,-136,-4,-1,-3,11,16,0,-1,3,1,-147,-20,-1,-2
"12605","6",260,3,3,1,0,-188,-187,-2,-2,-229,-226,-3,-3,3,0,41,39,1,1
"12606","6",451,3,1,0,0,-179,-169,-2,-2,-206,-129,-1,-3,3,0,27,-40,-1,1
"12607","6",448,6,2,1,2,13,-2,1,1,1,-17,4,4,3,-3,12,15,-3,-3
"12608","6",375,5,3,1,1,0,-1,1,0,12,1,1,0,3,-2,-12,-2,0,0
"12609","6",149,7,3,1,1,65,5,-2,2,242,5,-3,1,3,-4,-177,0,1,1
"12610","6",92,4,4,1,2,-110,-108,-1,-1,-134,-129,-1,-1,3,-1,24,21,0,0
"12611","6",221,3,4,1,1,-228,11,-2,-2,16,0,1,1,3,0,-244,11,-3,-3
"12612","6",299,6,4,1,1,222,35,1,1,72,202,1,1,3,-3,150,-167,0,0
"12613","6",85,1,2,0,2,-161,102,-3,-4,-132,102,-2,-3,3,2,-29,0,-1,-1
"12614","6",81,2,1,0,0,-48,-108,-3,-3,-247,180,-4,-4,3,1,199,-288,1,1
"12615","6",26,3,1,0,0,-242,72,1,-2,-222,-63,-4,-4,3,0,-20,135,5,2
"12616","6",11,5,4,1,1,32,0,0,0,47,56,1,1,3,-2,-15,-56,-1,-1
"12617","6",203,9,4,1,3,235,15,4,4,-12,-18,4,4,3,-6,247,33,0,0
"12618","6",20,4,3,1,0,-100,-89,-2,-1,191,191,4,4,3,-1,-291,-280,-6,-5
"12619","6",127,2,1,1,0,88,43,2,-3,58,87,2,-3,3,1,30,-44,0,0
"12620","6",422,1,3,1,1,-98,-123,1,-4,-92,-108,3,-2,3,2,-6,-15,-2,-2
"12621","6",27,4,2,0,2,-48,72,-1,-1,-35,-14,0,0,3,-1,-13,86,-1,-1
"12622","6",6,4,4,1,2,-202,0,-1,-1,-245,0,-2,-2,3,-1,43,0,1,1
"12623","6",116,4,2,1,3,43,-15,1,-1,60,-12,1,1,3,-1,-17,-3,0,-2
"12624","6",411,1,2,0,2,-232,-231,-4,-4,-215,-213,-4,-4,3,2,-17,-18,0,0
"12625","6",287,7,4,1,3,64,-28,1,2,59,18,1,1,3,-4,5,-46,0,1
"12626","6",453,6,4,1,2,9,-136,1,1,-153,15,0,-1,3,-3,162,-151,1,2
"12627","6",105,2,1,0,0,-187,-4,-3,-3,-248,2,-4,-3,3,1,61,-6,1,0
"12628","6",400,6,4,1,2,88,-17,-1,1,42,-52,2,2,3,-3,46,35,-3,-1
"12629","6",251,1,3,0,1,-232,200,4,-4,-212,1,-4,-3,3,2,-20,199,8,-1
"12630","6",248,5,4,1,3,211,218,4,0,179,173,3,3,3,-2,32,45,1,-3
"12631","6",269,2,4,1,2,-249,139,-3,-3,-248,136,3,-3,3,1,-1,3,-6,0
"12632","6",59,3,1,1,0,-159,36,-2,-2,-120,48,-2,-2,3,0,-39,-12,0,0
"12633","6",115,6,3,1,3,1,1,0,1,57,2,-1,0,3,-3,-56,-1,1,1
"12634","6",387,4,3,1,1,140,139,2,-1,191,171,3,4,3,-1,-51,-32,-1,-5
"12635","6",261,9,1,1,3,189,166,4,4,30,-74,4,4,3,-6,159,240,0,0
"12636","6",452,2,3,1,1,-180,-6,-3,-3,-69,7,-1,-1,3,1,-111,-13,-2,-2
"12637","6",449,6,4,1,3,89,79,2,1,22,86,1,1,3,-3,67,-7,1,0
"12638","6",376,4,4,1,1,15,-155,-1,-1,44,-148,-1,-1,3,-1,-29,-7,0,0
"12639","6",15,8,4,1,3,-49,70,2,3,34,108,-1,-2,3,-5,-83,-38,3,5
"12640","6",93,6,1,0,1,-67,49,-2,1,-131,82,-2,0,3,-3,64,-33,0,1
"12641","6",222,2,1,0,0,-246,-2,-3,-3,-235,-3,-3,-3,3,1,-11,1,0,0
"12642","6",3,2,3,1,0,-81,73,-3,-3,-100,111,-3,-3,3,1,19,-38,0,0
"12643","6",86,7,4,1,3,130,3,1,2,167,-8,2,3,3,-4,-37,11,-1,-1
"12644","6",82,1,4,1,2,-241,-11,-4,-4,241,-13,4,4,3,2,-482,2,-8,-8
"12645","6",289,8,1,0,3,198,218,3,3,228,230,3,3,3,-5,-30,-12,0,0
"12646","6",110,6,1,1,1,-102,-136,-2,1,90,148,3,3,3,-3,-192,-284,-5,-2
"12647","6",204,5,3,1,1,108,-128,1,0,68,-37,1,2,3,-2,40,-91,0,-2
"12648","6",200,1,3,1,0,116,-24,-3,-4,-223,-49,-4,-4,3,2,339,25,1,0
"12649","6",128,7,1,0,3,176,-14,2,2,196,-46,2,2,3,-4,-20,32,0,0
"12650","6",423,4,1,0,3,208,-39,4,-1,-201,31,-3,0,3,-1,409,-70,7,-1
"12651","6",270,7,3,1,1,205,2,3,2,127,1,2,2,3,-4,78,1,1,0
"12652","6",60,3,1,0,3,212,4,-2,-2,230,1,3,3,3,0,-18,3,-5,-5
"12653","6",117,3,4,1,2,51,2,-1,-2,-239,-1,-3,-4,3,0,290,3,2,2
"12654","6",412,9,1,0,0,-244,1,-4,4,241,1,4,4,3,-6,-485,0,-8,0
"12655","6",288,7,2,0,2,-136,72,-2,2,-134,62,-2,-2,3,-4,-2,10,0,4
"12656","6",454,9,4,1,3,249,3,4,4,250,0,3,4,3,-6,-1,3,1,0
"12657","6",106,4,2,1,1,-106,-30,-1,-1,-91,20,-1,-1,3,-1,-15,-50,0,0
"12658","6",401,2,2,1,1,-65,16,1,-3,179,75,1,0,3,1,-244,-59,0,-3
"12659","6",252,6,4,1,1,109,-117,1,1,-138,-100,0,0,3,-3,247,-17,1,1
"12660","6",249,1,3,1,0,-103,-108,-3,-4,25,-27,1,-4,3,2,-128,-81,-4,0
"12661","6",245,1,1,0,0,-245,87,-4,-4,-218,6,-4,-4,3,2,-27,81,0,0
"12662","6",165,5,1,1,1,83,77,-1,0,65,51,1,1,3,-2,18,26,-2,-1
"12663","6",391,7,2,1,3,165,204,1,2,114,-73,0,0,3,-4,51,277,1,2
"12664","6",388,6,4,1,0,7,-230,-1,1,-238,4,-4,-4,3,-3,245,-234,3,5
"12665","6",262,6,4,0,3,110,10,1,1,37,56,1,2,3,-3,73,-46,0,-1
"12666","6",457,9,3,0,1,178,1,4,4,161,-16,3,3,3,-6,17,17,1,1
"12667","6",45,4,3,1,0,80,97,1,-1,23,-44,1,1,3,-1,57,141,0,-2
"12668","6",377,1,1,0,0,-244,7,-4,-4,-246,8,-4,-4,3,2,2,-1,0,0
"12669","6",150,5,3,1,1,-9,0,0,0,64,9,0,0,3,-2,-73,-9,0,0
"12670","6",94,2,4,1,1,-97,-84,-1,-3,114,149,2,-2,3,1,-211,-233,-3,-1
"12671","6",223,5,1,1,1,33,0,0,0,-3,-1,0,0,3,-2,36,1,0,0
"12672","6",30,6,2,1,2,130,-20,1,1,-110,-2,-1,-2,3,-3,240,-18,2,3
"12673","6",87,6,4,1,3,1,-4,1,1,0,-246,1,1,3,-3,1,242,0,0
"12674","6",83,6,1,1,3,119,-121,2,1,152,-128,2,1,3,-3,-33,7,0,0
"12675","6",29,4,4,1,0,187,41,-2,-1,-230,249,-4,-4,3,-1,417,-208,2,3
"12676","6",456,2,1,1,0,-198,39,0,-3,138,145,1,-3,3,1,-336,-106,-1,0
"12677","6",205,6,1,1,2,51,1,1,1,221,0,3,4,3,-3,-170,1,-2,-3
"12678","6",201,1,3,1,1,17,-1,-3,-4,43,0,-1,-4,3,2,-26,-1,-2,0
"12679","6",129,6,4,0,1,53,1,1,1,103,0,1,1,3,-3,-50,1,0,0
"12680","6",424,3,2,1,2,-22,-11,-1,-2,145,90,1,-1,3,0,-167,-101,-2,-1
"12681","6",271,4,3,1,1,-79,-2,-1,-1,217,-2,3,3,3,-1,-296,0,-4,-4
"12682","6",61,1,1,0,3,212,32,4,-4,-9,-47,4,-4,3,2,221,79,0,0
"12683","6",118,6,3,1,1,-14,12,-1,1,14,14,1,1,3,-3,-28,-2,-2,0
"12684","6",413,8,1,0,1,228,2,4,3,-117,6,-2,-2,3,-5,345,-4,6,5
"12685","6",264,2,4,1,2,85,44,-1,-3,241,5,-1,-2,3,1,-156,39,0,-1
"12686","6",455,2,2,1,2,-233,-6,-3,-3,247,-1,4,4,3,1,-480,-5,-7,-7
"12687","6",107,4,2,0,3,-46,47,3,-1,119,186,-2,1,3,-1,-165,-139,5,-2
"12688","6",402,6,3,1,0,49,-2,2,1,243,0,4,-1,3,-3,-194,-2,-2,2
"12689","6",253,9,3,1,3,216,231,4,4,216,226,4,4,3,-6,0,5,0,0
"12690","6",25,3,4,1,2,-48,-26,-2,-2,-87,-74,-3,-3,3,0,39,48,1,1
"12691","6",246,8,4,1,3,109,0,3,3,-5,58,3,2,3,-5,114,-58,0,1
"12692","6",166,1,4,1,2,-76,107,-2,-4,217,226,-1,1,3,2,-293,-119,-1,-5
"12693","6",392,2,1,1,0,-208,207,-3,-3,-169,128,-2,-2,3,1,-39,79,-1,-1
"12694","6",389,9,3,1,2,-217,8,4,4,7,-50,0,0,3,-6,-224,58,4,4
"12695","6",263,1,4,1,0,-211,0,-2,-4,-248,2,-4,-4,3,2,37,-2,2,0
"12696","6",458,3,1,1,1,2,3,-1,-2,62,83,-1,-2,3,0,-60,-80,0,0
"12697","6",450,5,4,1,3,156,3,1,0,-6,128,0,-1,3,-2,162,-125,1,1
"12698","6",378,3,4,1,1,-155,-1,-2,-2,-177,1,-2,-2,3,0,22,-2,0,0
"12699","6",151,1,2,0,1,-235,7,0,-4,-243,5,0,-4,3,2,8,2,0,0
"12700","6",95,4,4,1,2,-141,-6,-1,-1,-116,3,-1,-1,3,-1,-25,-9,0,0
"12701","6",224,4,2,1,2,-42,-15,-1,-1,174,71,2,1,3,-1,-216,-86,-3,-2
"12702","6",300,2,1,1,0,-91,52,-2,-3,14,36,0,-1,3,1,-105,16,-2,-2
"12703","6",12,9,4,1,3,1,-1,4,4,0,2,4,4,3,-6,1,-3,0,0
"12704","6",294,5,1,0,3,10,2,0,0,122,6,2,2,3,-2,-112,-4,-2,-2
"12705","6",290,3,1,0,1,-195,106,-1,-2,133,119,1,-2,3,0,-328,-13,-2,0
"12706","6",153,5,1,1,3,-2,2,1,0,-124,-52,1,1,3,-2,122,54,0,-1
"12707","6",384,1,1,0,0,-184,-1,0,-4,-170,1,-1,-4,3,2,-14,-2,1,0
"12708","6",283,6,1,1,1,-77,-106,-2,1,-127,-83,-2,1,3,-3,50,-23,0,0
"12709","6",13,1,4,0,1,-93,92,2,-4,-101,24,1,-2,3,2,8,68,1,-2
"12710","6",425,6,4,1,2,-12,-14,0,1,0,-13,0,1,3,-3,-12,-1,0,0
"12711","6",272,4,4,1,2,15,-1,0,-1,-11,-2,-2,-2,3,-1,26,1,2,1
"12712","6",62,9,2,1,3,-222,166,-4,4,220,216,3,4,3,-6,-442,-50,-7,0
"12713","6",119,6,3,1,3,105,-61,2,1,85,129,2,1,3,-3,20,-190,0,0
"12714","6",414,2,1,1,0,-148,-159,-3,-3,9,12,0,0,3,1,-157,-171,-3,-3
"12715","6",46,1,1,1,0,-202,-244,-4,-4,-112,-247,-4,-2,3,2,-90,3,0,-2
"12716","6",240,2,2,1,1,-76,25,-3,-3,13,-7,0,-2,3,1,-89,32,-3,-1
"12717","6",383,5,4,1,1,-1,8,0,0,-81,-17,0,0,3,-2,80,25,0,0
"12718","6",403,2,1,0,0,-81,-27,1,-3,24,-52,2,1,3,1,-105,25,-1,-4
"12719","6",301,7,4,1,1,67,0,2,2,-2,38,1,2,3,-4,69,-38,1,0
"12720","6",97,2,1,1,1,6,11,3,-3,-229,12,2,-3,3,1,235,-1,1,0
"12721","6",226,1,1,0,0,-94,2,-2,-4,119,1,2,-2,3,2,-213,1,-4,-2
"12722","6",243,4,2,1,2,-208,-249,-3,-1,-246,-180,-3,0,3,-1,38,-69,0,-1
"12723","6",393,1,1,0,0,-101,-60,-4,-4,-66,-147,-4,-4,3,2,-35,87,0,0
"12724","6",39,8,3,1,1,76,100,3,3,134,154,1,3,3,-5,-58,-54,2,0
"12725","6",459,1,3,1,1,13,-26,2,-4,-117,-136,1,-4,3,2,130,110,1,0
"12726","6",24,1,2,1,2,-74,1,-1,-4,248,1,0,4,3,2,-322,0,-1,-8
"12727","6",382,5,4,0,2,-52,-1,-1,0,-7,-2,0,0,3,-2,-45,1,-1,0
"12728","6",379,3,3,1,1,-5,-105,1,-2,33,21,1,0,3,0,-38,-126,0,-2
"12729","6",152,1,1,1,0,-147,-2,-2,-4,43,-2,0,-4,3,2,-190,0,-2,0
"12730","6",96,2,1,0,0,-201,0,-3,-3,-30,-3,-1,-1,3,1,-171,3,-2,-2
"12731","6",225,6,2,1,2,34,-39,1,1,51,-146,2,1,3,-3,-17,107,-1,0
"12732","6",460,3,1,0,0,-175,9,-2,-2,135,12,-2,2,3,0,-310,-3,0,-4
"12733","6",120,7,3,1,1,187,46,2,2,172,5,3,3,3,-4,15,41,-1,-1
"12734","6",295,5,1,0,1,-1,-3,0,0,-2,-3,0,0,3,-2,1,0,0,0
"12735","6",291,3,4,1,2,-6,30,-3,-2,-111,-26,-3,-3,3,0,105,56,0,1
"12736","6",154,5,4,0,3,84,74,0,0,21,131,0,2,3,-2,63,-57,0,-2
"12737","6",385,6,4,1,1,-82,71,1,1,-72,147,1,2,3,-3,-10,-76,0,-1
"12738","6",284,3,3,1,1,-145,39,-3,-2,-205,131,-2,-3,3,0,60,-92,-1,1
"12739","6",130,9,1,1,3,194,30,4,4,98,-34,4,4,3,-6,96,64,0,0
"12740","6",426,8,4,1,3,177,-2,3,3,153,2,2,2,3,-5,24,-4,1,1
"12741","6",273,5,1,1,0,-1,1,0,0,175,66,1,0,3,-2,-176,-65,-1,0
"12742","6",63,5,4,1,1,-3,1,0,0,-3,1,0,0,3,-2,0,0,0,0
"12743","6",325,9,1,1,1,-31,-41,0,4,-62,-53,-1,3,3,-6,31,12,1,1
"12744","6",415,5,2,1,2,3,-1,0,0,171,196,0,1,3,-2,-168,-197,0,-1
"12745","6",38,5,4,1,3,14,-8,0,0,27,-35,0,0,3,-2,-13,27,0,0
"12746","6",132,7,4,1,1,-56,17,1,2,4,84,1,2,3,-4,-60,-67,0,0
"12747","6",238,6,3,1,1,-90,21,1,1,117,-1,1,1,3,-3,-207,22,0,0
"12748","6",404,4,1,1,1,55,-53,1,-1,59,-61,1,0,3,-1,-4,8,0,-1
"12749","6",302,3,1,1,0,-56,-11,-3,-2,205,36,-2,-2,3,0,-261,-47,-1,0
"12750","6",98,3,3,1,0,-237,-17,-2,-2,110,-149,1,1,3,0,-347,132,-3,-3
"12751","6",227,7,3,0,3,-37,-24,1,2,-200,24,3,2,3,-4,163,-48,-2,0
"12752","6",244,1,4,0,2,-98,-158,-2,-4,70,142,-2,-4,3,2,-168,-300,0,0
"12753","6",394,1,3,0,0,-246,242,-4,-4,-249,203,-4,-4,3,2,3,39,0,0
"12754","6",390,4,2,1,2,-9,12,-1,-1,5,-22,-1,-1,3,-1,-14,34,0,0
"12755","6",293,1,4,1,0,-217,20,-4,-4,-11,-234,-4,-4,3,2,-206,254,0,0
"12756","6",131,7,4,1,3,-1,-1,0,2,-81,31,-4,2,3,-4,80,-32,4,0
"12757","6",237,5,2,0,2,-250,-1,-1,0,49,0,2,1,3,-2,-299,-1,-3,-1
"12758","6",274,5,4,1,2,27,46,1,0,-37,23,1,0,3,-2,64,23,0,0
"12759","6",64,9,1,0,1,211,-188,4,4,236,-1,4,4,3,-6,-25,-187,0,0
"12760","6",428,1,1,0,0,-244,-241,-4,-4,-246,161,-4,-4,3,2,2,-402,0,0
"12761","6",275,2,4,1,2,-243,9,0,-3,-247,5,2,-2,3,1,4,4,-2,-1
"12762","6",461,2,4,1,2,22,17,0,-3,-65,24,-2,-3,3,1,87,-7,2,0
"12763","6",121,1,1,0,0,-168,51,-4,-4,240,-238,4,-4,3,2,-408,289,-8,0
"12764","6",296,6,1,0,3,113,-7,1,1,186,-7,2,2,3,-3,-73,0,-1,-1
"12765","6",292,5,3,1,1,1,-41,0,0,-168,3,-1,-1,3,-2,169,-44,1,1
"12766","6",155,6,2,1,1,-118,-154,0,1,-13,-14,0,0,3,-3,-105,-140,0,1
"12767","6",236,5,1,0,1,-1,-4,0,0,-42,-34,0,0,3,-2,41,30,0,0
"12768","6",285,1,2,1,1,-97,-96,3,-4,-198,81,0,-2,3,2,101,-177,3,-2
"12769","6",1,5,1,1,1,-92,21,-2,0,-118,-45,-2,0,3,-2,26,66,0,0
"12770","6",427,1,4,0,1,-249,-19,4,-4,-234,-26,4,-4,3,2,-15,7,0,0
"12771","6",241,4,4,1,2,145,76,2,-1,174,156,2,0,3,-1,-29,-80,0,-1
"12772","6",321,4,1,0,0,-149,-143,0,-1,-111,-74,-1,-1,3,-1,-38,-69,1,0
"12773","6",326,5,4,1,2,84,40,0,0,131,133,0,0,3,-2,-47,-93,0,0
"12774","6",416,1,4,1,0,-202,103,-4,-4,-199,202,-4,-4,3,2,-3,-99,0,0
"12775","6",380,2,4,1,1,-219,-117,3,-3,-228,-112,3,-2,3,1,9,-5,0,-1
"12776","6",158,1,3,1,0,-230,-226,0,-4,-243,-6,-4,-4,3,2,13,-220,4,0
"12777","6",239,4,1,0,1,141,-9,2,-1,198,-1,2,1,3,-1,-57,-8,0,-2
"12778","6",405,2,4,1,1,-58,53,-1,-3,133,85,1,-1,3,1,-191,-32,-2,-2
"12779","6",303,3,3,1,2,-142,-118,-2,-2,-195,-147,-3,-3,3,0,53,29,1,1
"12780","6",99,7,4,1,3,201,16,2,2,4,10,0,0,3,-4,197,6,2,2
"12781","6",228,5,4,1,2,-178,-74,0,0,22,19,4,4,3,-2,-200,-93,-4,-4
"12782","6",320,1,2,0,2,-248,127,-4,-4,-250,154,-4,-4,3,2,2,-27,0,0
"12783","6",329,6,4,1,3,26,21,2,1,63,-95,-2,2,3,-3,-37,116,4,-1
"12784","6",309,4,4,1,2,78,55,1,-1,174,145,1,-1,3,-1,-96,-90,0,0
"12785","6",286,6,1,0,3,81,-9,1,1,51,-3,2,1,3,-3,30,-6,-1,0
"12786","6",157,3,3,1,2,-73,-54,-2,-2,153,105,-2,0,3,0,-226,-159,0,-2
"12787","6",31,4,1,0,0,-182,-77,-1,-1,-121,-82,-3,-3,3,-1,-61,5,2,2
"12788","6",23,9,1,0,3,211,219,4,4,220,217,4,4,3,-6,-9,2,0,0
"12789","6",65,7,1,0,3,17,105,2,2,12,18,2,2,3,-4,5,87,0,0
"12790","6",28,6,4,0,1,-72,30,-1,1,43,38,-1,-1,3,-3,-115,-8,0,2
"12791","6",276,7,4,1,3,151,-1,2,2,13,-5,2,2,3,-4,138,4,0,0
"12792","6",32,5,1,0,1,-4,-1,0,0,192,-63,0,0,3,-2,-196,62,0,0
"12793","6",328,6,3,1,1,14,3,1,1,13,9,1,1,3,-3,1,-6,0,0
"12794","6",297,2,3,1,2,182,39,2,-3,123,21,1,-4,3,1,59,18,1,1
"12795","6",406,7,2,1,2,100,-40,-1,2,65,34,2,2,3,-4,35,-74,-3,0
"12796","6",156,6,2,1,1,22,4,1,1,15,6,1,1,3,-3,7,-2,0,0
"12797","6",16,1,1,0,0,-150,18,-1,-4,238,16,2,-1,3,2,-388,2,-3,-3
"12798","6",229,6,1,1,1,59,68,-1,1,33,-49,2,2,3,-3,26,117,-3,-1
"12799","6",10,6,3,1,1,116,-4,1,1,-1,-7,-1,0,3,-3,117,3,2,1
"12800","6",33,5,3,0,1,17,4,0,0,-226,-39,-2,1,3,-2,243,43,2,-1
"12801","6",242,3,4,1,2,-5,3,1,-2,-174,1,-1,-2,3,0,169,2,2,0
"12802","6",322,7,4,1,3,138,-159,2,2,191,-189,2,2,3,-4,-53,30,0,0
"12803","6",327,4,4,0,3,111,-2,0,-1,-8,50,0,-2,3,-1,119,-52,0,1
"12804","6",417,4,2,1,2,0,0,-1,-1,-79,-71,-2,-4,3,-1,79,71,1,3
"12805","6",381,2,2,0,2,215,209,-3,-3,216,185,4,4,3,1,-1,24,-7,-7
"12806","6",159,8,3,1,2,0,0,3,3,221,-3,3,4,3,-5,-221,3,0,-1
"12807","6",280,7,2,1,1,228,5,2,2,9,13,-1,-2,3,-4,219,-8,3,4
"12808","6",277,1,4,0,1,-80,88,4,-4,-25,-78,3,-4,3,2,-55,166,1,0
"12809","6",304,4,2,1,2,-80,-24,-1,-1,94,-22,1,1,3,-1,-174,-2,-2,-2
"12810","6",67,6,1,1,0,85,-89,1,1,155,-132,2,2,3,-3,-70,43,-1,-1
"12811","6",281,1,4,1,2,-233,0,-4,-4,-1,-232,-3,0,3,2,-232,232,-1,-4
"12812","6",233,6,2,0,2,18,16,1,1,-203,27,-1,0,3,-3,221,-11,2,1
"12813","6",160,7,2,0,0,-98,2,-4,2,-154,-3,-4,2,3,-4,56,5,0,0
"12814","6",282,9,3,0,3,97,-93,1,4,221,74,1,4,3,-6,-124,-167,0,0
"12815","6",234,4,3,1,3,135,37,0,-1,132,50,1,-1,3,-1,3,-13,-1,0
"12816","6",161,1,2,0,2,-208,34,2,-4,56,53,1,-3,3,2,-264,-19,1,-1
"12817","6",310,1,4,0,2,-138,1,-3,-4,2,-1,1,-3,3,2,-140,2,-4,-1
"12818","6",230,4,1,0,0,-217,28,-4,-1,-231,85,-3,0,3,-1,14,-57,-1,-1
"12819","6",66,5,1,0,1,-80,-4,1,0,202,4,-1,2,3,-2,-282,-8,2,-2
"12820","6",162,2,3,0,3,-242,163,4,-3,-69,35,-2,1,3,1,-173,128,6,-4
"12821","6",324,2,2,1,0,48,4,-3,-3,-238,0,-4,-4,3,1,286,4,1,1
"12822","6",232,1,1,0,0,-239,-50,1,-4,-229,-43,-4,-4,3,2,-10,-7,5,0
"12823","6",163,5,3,0,1,138,14,-1,0,10,65,1,0,3,-2,128,-51,-2,0
"12824","6",308,1,4,1,0,-144,-154,-3,-4,246,247,1,2,3,2,-390,-401,-4,-6
"12825","6",278,1,4,1,1,-129,-219,4,-4,-235,-234,4,-4,3,2,106,15,0,0
"12826","6",305,7,4,1,3,35,54,1,2,-122,47,1,1,3,-4,157,7,0,1
"12827","6",68,3,4,1,0,129,9,0,-2,209,5,-2,-3,3,0,-80,4,2,1
"12828","6",279,7,4,1,3,35,-56,3,2,28,114,3,2,3,-4,7,-170,0,0
"12829","6",306,5,3,1,3,98,140,1,0,115,145,1,0,3,-2,-17,-5,0,0
"12830","6",69,1,4,1,1,38,181,-3,-4,-59,41,-1,-4,3,2,97,140,-2,0
"12831","6",323,5,4,1,1,1,-86,0,0,226,0,0,-4,3,-2,-225,-86,0,4
"12832","6",235,8,3,1,0,159,-3,3,3,0,-1,0,0,3,-5,159,-2,3,3
"12833","6",307,3,4,1,2,-58,233,-2,-2,-245,241,-2,-4,3,0,187,-8,0,2
"12834","6",311,1,2,1,2,-31,5,-4,-4,224,8,4,-4,3,2,-255,-3,-8,0
"12835","6",231,1,4,0,0,-229,1,-4,-4,8,-1,-3,2,3,2,-237,2,-1,-6
"12836","6",74,3,3,1,0,-126,71,-3,-2,-188,-77,-4,-4,3,0,62,148,1,2
"12837","6",313,2,3,1,0,-94,-105,-3,-3,-236,-233,-4,-4,3,1,142,128,1,1
"12838","6",312,5,4,1,1,68,93,0,0,-48,102,0,0,3,-2,116,-9,0,0
"12839","6",164,7,2,1,2,51,23,2,2,-1,-220,-3,-3,3,-4,52,243,5,5
"12840","6",314,1,4,1,1,-240,13,4,-4,-240,8,4,-4,3,2,0,5,0,0
"12841","6",73,1,4,1,2,-194,101,-4,-4,-162,80,-4,-4,3,2,-32,21,0,0
"12842","6",318,1,2,1,2,-194,-184,-4,-4,194,191,-4,0,3,2,-388,-375,0,-4
"12843","6",7,6,1,0,3,91,63,2,1,140,55,2,1,3,-3,-49,8,0,0
"12844","6",315,9,3,1,3,244,11,4,4,244,20,4,4,3,-6,0,-9,0,0
"12845","6",72,4,1,1,0,89,100,0,-1,164,169,2,3,3,-1,-75,-69,-2,-4
"12846","6",319,2,1,1,1,-205,-88,-3,-3,-85,40,1,2,3,1,-120,-128,-4,-5
"12847","6",70,1,2,1,2,-40,38,1,-4,51,64,-1,-4,3,2,-91,-26,2,0
"12848","6",75,3,4,1,2,-19,20,3,-2,226,30,0,-2,3,0,-245,-10,3,0
"12849","6",316,5,3,1,0,179,-102,0,0,-103,-76,-2,-2,3,-2,282,-26,2,2
"12850","6",71,5,3,1,1,-90,14,0,0,37,19,1,0,3,-2,-127,-5,-1,0
"12851","6",76,5,4,1,3,19,2,2,0,3,-1,0,0,3,-2,16,3,2,0
"12852","6",317,2,4,0,2,-154,121,-3,-3,-172,161,-4,-4,3,1,18,-40,1,1
"12853","7",432,5,2,0,1,20,-23,0,0,20,-17,0,0,0,-5,0,-6,0,0
"12854","7",144,5,3,0,0,-250,0,-1,0,231,241,4,2,0,-5,-481,-241,-5,-2
"12855","7",134,6,2,0,2,-37,-3,1,1,9,-9,1,-1,0,-6,-46,6,0,2
"12856","7",43,1,3,0,0,0,0,-4,-4,142,1,-3,-3,0,-1,-142,-1,-1,-1
"12857","7",429,1,2,0,0,-226,-227,-4,-4,-174,-158,-4,-4,0,-1,-52,-69,0,0
"12858","7",434,7,4,1,3,143,-8,1,2,-178,-9,-1,-1,0,-7,321,1,2,3
"12859","7",135,7,1,0,1,-150,-72,2,2,-49,-48,0,2,0,-7,-101,-24,2,0
"12860","7",441,3,4,0,2,-122,89,-3,-2,-121,30,-3,-3,0,-3,-1,59,0,1
"12861","7",408,1,1,0,0,-245,-2,-3,-4,-41,4,4,-1,0,-1,-204,-6,-7,-3
"12862","7",407,1,2,0,2,-205,129,-4,-4,94,65,3,3,0,-1,-299,64,-7,-7
"12863","7",136,1,1,0,0,-247,245,-4,-4,-125,125,-4,-4,0,-1,-122,120,0,0
"12864","7",431,3,3,0,0,-207,3,-3,-2,55,55,-1,-1,0,-3,-262,-52,-2,-1
"12865","7",410,2,1,0,0,-246,-7,-2,-3,-142,-23,-2,-1,0,-2,-104,16,0,-2
"12866","7",440,2,3,1,0,-139,-4,-3,-3,-1,0,0,0,0,-2,-138,-4,-3,-3
"12867","7",433,1,1,1,0,-229,-230,-4,-4,214,178,2,2,0,-1,-443,-408,-6,-6
"12868","7",411,1,2,0,2,-239,-231,-4,-4,-194,-235,-4,-4,0,-1,-45,4,0,0
"12869","7",437,2,1,0,0,-218,1,-3,-3,-105,2,-3,-3,0,-2,-113,-1,0,0
"12870","7",430,5,2,0,1,34,-23,0,0,180,-96,2,2,0,-5,-146,73,-2,-2
"12871","7",417,1,2,0,2,-219,-201,-4,-4,-105,-79,-3,-3,0,-1,-114,-122,-1,-1
"12872","7",442,6,4,0,1,-31,59,-1,1,35,53,1,1,0,-6,-66,6,-2,0
"12873","7",41,6,2,0,3,12,70,3,1,15,72,3,1,0,-6,-3,-2,0,0
"12874","7",414,2,1,0,0,-143,-140,-3,-3,-38,-30,0,0,0,-2,-105,-110,-3,-3
"12875","7",44,1,2,0,2,-223,222,-4,-4,207,-175,-2,-3,0,-1,-430,397,-2,-1
"12876","7",443,2,1,0,0,-170,-67,-2,-3,44,38,1,0,0,-2,-214,-105,-3,-3
"12877","7",415,3,2,0,2,-12,2,0,-2,158,145,0,1,0,-3,-170,-143,0,-3
"12878","7",133,1,2,0,1,-232,-26,0,-4,230,12,4,0,0,-1,-462,-38,-4,-4
"12879","7",342,4,3,0,1,12,11,0,-1,7,15,-1,0,0,-4,5,-4,1,-1
"12880","7",145,1,1,0,1,-247,4,-4,-4,-194,-111,-3,-3,0,-1,-53,115,-1,-1
"12881","7",412,1,1,0,0,-243,-21,-4,-4,243,1,4,4,0,-1,-486,-22,-8,-8
"12882","7",404,4,1,0,1,67,-49,1,-1,51,-57,1,0,0,-4,16,8,0,-1
"12883","7",409,2,4,0,2,-159,-188,3,-3,114,137,2,2,0,-2,-273,-325,1,-5
"12884","7",146,2,2,1,0,-200,-171,-3,-3,-161,-165,-3,-3,0,-2,-39,-6,0,0
"12885","7",413,6,1,0,1,140,3,-1,1,-133,4,-2,0,0,-6,273,-1,1,1
"12886","7",66,1,1,0,1,-245,2,-3,-4,219,1,1,-1,0,-1,-464,1,-4,-3
"12887","7",421,2,3,0,1,-191,152,-3,-3,168,180,1,1,0,-2,-359,-28,-4,-4
"12888","7",435,5,4,0,1,8,4,-2,0,33,-158,1,-1,0,-5,-25,162,-3,1
"12889","7",341,9,1,1,3,0,0,4,4,246,-24,4,4,0,-9,-246,24,0,0
"12890","7",422,1,3,0,1,-75,-150,4,-4,-65,-163,2,-4,0,-1,-10,13,2,0
"12891","7",436,6,4,0,3,120,-223,3,1,129,-176,4,2,0,-6,-9,-47,-1,-1
"12892","7",403,3,1,0,0,-95,-11,0,-2,-37,-12,1,-1,0,-3,-58,1,-1,-1
"12893","7",137,3,1,0,1,-229,161,-4,-2,-61,-98,3,2,0,-3,-168,259,-7,-4
"12894","7",416,7,4,0,0,-234,227,-4,2,-80,53,-4,-4,0,-7,-154,174,0,6
"12895","7",89,4,3,1,0,-238,6,-3,-1,-249,-1,-1,-4,0,-4,11,7,-2,3
"12896","7",445,6,4,1,3,117,-30,1,1,86,-35,1,1,0,-6,31,5,0,0
"12897","7",138,4,3,0,1,-132,-20,-1,-1,24,-30,0,0,0,-4,-156,10,-1,-1
"12898","7",9,4,4,0,2,-97,27,0,-1,72,75,1,0,0,-4,-169,-48,-1,-1
"12899","7",438,5,4,0,3,3,3,4,0,4,3,4,0,0,-5,-1,0,0,0
"12900","7",139,1,4,1,2,0,0,-4,-4,-236,13,-4,-4,0,-1,236,-13,0,0
"12901","7",418,3,2,0,2,-161,169,2,-2,100,80,2,-1,0,-3,-261,89,0,-1
"12902","7",406,4,2,0,2,-197,-153,2,-1,188,175,-2,1,0,-4,-385,-328,4,-2
"12903","7",189,3,1,0,1,-241,18,2,-2,-223,23,3,-2,0,-3,-18,-5,-1,0
"12904","7",88,1,4,1,2,-234,-23,-4,-4,211,-229,4,4,0,-1,-445,206,-8,-8
"12905","7",419,6,4,1,3,37,46,1,1,36,47,0,1,0,-6,1,-1,1,0
"12906","7",444,1,2,0,2,-245,-2,-4,-4,-249,-1,-4,-4,0,-1,4,-1,0,0
"12907","7",423,2,1,1,3,157,1,2,-3,157,-1,-2,2,0,-2,0,2,4,-5
"12908","7",80,8,4,1,3,214,0,3,3,218,-2,3,3,0,-8,-4,2,0,0
"12909","7",343,4,2,0,2,-33,1,-1,-1,41,2,1,1,0,-4,-74,-1,-2,-2
"12910","7",400,2,4,0,2,-119,48,-2,-3,40,21,1,2,0,-2,-159,27,-3,-5
"12911","7",398,1,4,0,2,-236,-223,-4,-4,-122,-158,-3,-3,0,-1,-114,-65,-1,-1
"12912","7",405,1,4,0,1,-208,208,0,-4,78,56,-3,-3,0,-1,-286,152,3,-1
"12913","7",446,5,4,0,1,-93,-35,-1,0,109,105,-1,1,0,-5,-202,-140,0,-1
"12914","7",147,3,2,1,3,-75,-212,-2,-2,-156,-189,-1,-1,0,-3,81,-23,-1,-1
"12915","7",90,1,4,1,0,-244,-1,-4,-4,134,-1,0,3,0,-1,-378,0,-4,-7
"12916","7",67,2,1,0,0,-232,20,-4,-3,195,-217,4,3,0,-2,-427,237,-8,-6
"12917","7",1,4,1,0,1,-187,-186,-3,-1,-135,-62,-1,0,0,-4,-52,-124,-2,-1
"12918","7",55,5,4,0,1,-2,2,-2,0,4,-1,0,0,0,-5,-6,3,-2,0
"12919","7",464,6,1,0,1,7,18,1,1,16,40,1,1,0,-6,-9,-22,0,0
"12920","7",19,3,2,0,2,-95,-23,-1,-2,118,-85,1,-1,0,-3,-213,62,-2,-1
"12921","7",397,2,4,0,3,120,-56,-3,-3,121,-146,2,2,0,-2,-1,90,-5,-5
"12922","7",77,5,3,0,1,-4,-15,0,0,-140,1,-1,-1,0,-5,136,-16,1,1
"12923","7",69,4,4,1,1,152,78,0,-1,-168,-17,-1,-4,0,-4,320,95,1,3
"12924","7",424,3,2,0,2,-144,-8,-2,-2,85,29,1,-1,0,-3,-229,-37,-3,-1
"12925","7",420,4,4,1,3,-4,1,0,-1,-77,2,-1,-1,0,-4,73,-1,1,0
"12926","7",344,7,4,1,3,177,-59,1,2,162,-81,2,1,0,-7,15,22,-1,1
"12927","7",191,3,1,0,0,-186,-78,-2,-2,-209,-54,-2,-2,0,-3,23,-24,0,0
"12928","7",82,1,4,1,2,-234,-14,-4,-4,15,234,4,3,0,-1,-249,-248,-8,-7
"12929","7",439,4,2,0,1,-144,6,-1,-1,0,0,-1,-1,0,-4,-144,6,0,0
"12930","7",14,5,3,0,1,-1,2,0,0,198,-50,3,2,0,-5,-199,52,-3,-2
"12931","7",4,5,3,1,1,-2,1,0,0,13,146,-1,1,0,-5,-15,-145,1,-1
"12932","7",111,1,1,0,0,-217,-229,-4,-4,-76,179,2,-1,0,-1,-141,-408,-6,-3
"12933","7",68,1,4,0,0,-244,1,-4,-4,216,6,0,-2,0,-1,-460,-5,-4,-2
"12934","7",10,6,3,1,1,59,-16,0,1,1,7,0,-1,0,-6,58,-23,0,2
"12935","7",42,3,3,0,1,-62,8,2,-2,-38,22,2,-2,0,-3,-24,-14,0,0
"12936","7",465,9,4,0,3,214,14,3,4,41,-229,3,3,0,-9,173,243,0,1
"12937","7",190,7,4,1,3,180,139,2,2,201,215,2,2,0,-7,-21,-76,0,0
"12938","7",81,7,1,0,0,-232,161,-3,2,-206,144,-2,1,0,-7,-26,17,-1,1
"12939","7",78,3,4,1,0,-218,-3,-2,-2,-221,-1,-2,-3,0,-3,3,-2,0,1
"12940","7",401,5,2,0,1,-48,1,2,0,148,56,1,-2,0,-5,-196,-55,1,2
"12941","7",399,5,4,0,3,77,11,0,0,82,17,-1,-1,0,-5,-5,-6,1,1
"12942","7",79,2,4,0,2,-224,112,-4,-3,-223,191,-3,-3,0,-2,-1,-79,-1,0
"12943","7",447,3,4,0,2,-117,-6,1,-2,81,85,2,1,0,-3,-198,-91,-1,-3
"12944","7",148,1,1,0,1,-247,-114,2,-4,-186,-87,2,-4,0,-1,-61,-27,0,0
"12945","7",91,5,2,0,3,149,-1,1,0,64,-9,1,2,0,-5,85,8,0,-2
"12946","7",298,2,1,0,0,-237,16,-1,-3,18,-164,-1,1,0,-2,-255,180,0,-4
"12947","7",140,6,1,0,1,-8,46,0,1,-11,91,1,1,0,-6,3,-45,-1,0
"12948","7",56,5,3,0,1,109,-137,-1,0,29,-113,-2,0,0,-5,80,-24,1,0
"12949","7",112,1,4,1,3,-241,-6,-4,-4,169,162,3,3,0,-1,-410,-168,-7,-7
"12950","7",331,1,1,0,0,-212,-138,-4,-4,-171,-150,-4,-4,0,-1,-41,12,0,0
"12951","7",179,5,1,1,1,-4,2,0,0,3,1,0,0,0,-5,-7,1,0,0
"12952","7",474,1,1,0,0,2,-71,0,-4,3,-77,0,-4,0,-1,-1,6,0,0
"12953","7",7,6,1,0,3,171,129,2,1,190,16,1,2,0,-6,-19,113,1,-1
"12954","7",425,4,4,1,2,-49,-48,-1,-1,4,71,2,2,0,-4,-53,-119,-3,-3
"12955","7",349,4,4,1,1,-73,-143,-2,-1,59,77,1,0,0,-4,-132,-220,-3,-1
"12956","7",345,9,1,0,0,-227,238,-4,4,-24,-117,-2,0,0,-9,-203,355,-2,4
"12957","7",192,6,4,1,1,-2,-55,1,1,0,-126,1,1,0,-6,-2,71,0,0
"12958","7",83,6,1,0,3,136,-165,1,1,148,-113,2,1,0,-6,-12,-52,-1,0
"12959","7",8,5,3,1,1,116,-173,3,0,-25,-206,-3,-2,0,-5,141,33,6,2
"12960","7",40,2,1,0,2,-227,127,-3,-3,214,96,3,3,0,-2,-441,31,-6,-6
"12961","7",178,5,1,0,1,-1,3,0,0,-1,3,0,0,0,-5,0,0,0,0
"12962","7",473,4,3,0,0,-202,-21,-1,-1,-163,-27,-1,-2,0,-4,-39,6,0,1
"12963","7",104,1,1,0,0,-239,0,-4,-4,-234,2,-3,-4,0,-1,-5,-2,-1,0
"12964","7",100,8,4,0,3,189,9,3,3,3,198,3,3,0,-8,186,-189,0,0
"12965","7",47,7,4,1,3,213,21,1,2,149,-1,2,1,0,-7,64,22,-1,1
"12966","7",466,2,3,0,0,-107,53,-2,-3,-67,-114,-2,-2,0,-2,-40,167,0,-1
"12967","7",462,9,3,0,3,228,16,4,4,227,218,4,4,0,-9,1,-202,0,0
"12968","7",58,8,4,1,1,-246,5,-4,3,-2,241,4,3,0,-8,-244,-236,-8,0
"12969","7",114,2,4,0,1,-1,-2,0,-3,46,64,1,-3,0,-2,-47,-66,-1,0
"12970","7",402,1,3,0,0,-236,-1,-4,-4,244,2,4,1,0,-1,-480,-3,-8,-5
"12971","7",180,1,2,0,2,-82,0,-3,-4,-248,2,-3,-2,0,-1,166,-2,0,-2
"12972","7",476,3,3,0,0,-143,-143,-2,-2,-187,-70,1,2,0,-3,44,-73,-3,-4
"12973","7",448,9,2,0,2,171,-3,4,4,65,2,2,1,0,-9,106,-5,2,3
"12974","7",149,6,3,0,1,-246,6,-4,1,238,5,-2,1,0,-6,-484,1,-2,0
"12975","7",92,4,4,0,2,-170,-190,-1,-1,-115,-133,-1,-1,0,-4,-55,-57,0,0
"12976","7",299,2,4,1,1,-211,-20,-2,-3,80,188,1,1,0,-2,-291,-208,-3,-4
"12977","7",141,1,1,0,0,-190,-236,-4,-4,214,83,3,2,0,-1,-404,-319,-7,-6
"12978","7",57,1,4,0,1,-2,-93,-2,-4,-3,-216,-4,-4,0,-1,1,123,2,0
"12979","7",113,4,2,0,2,-33,29,0,-1,-56,38,-3,-3,0,-4,23,-9,3,2
"12980","7",332,1,1,0,0,-250,157,-4,-4,-250,129,-2,-2,0,-1,0,28,-2,-2
"12981","7",18,3,3,0,1,-46,-138,-2,-2,10,10,1,-1,0,-3,-56,-148,-3,-1
"12982","7",475,4,3,0,3,38,-66,0,-1,64,35,0,0,0,-4,-26,-101,0,-1
"12983","7",70,1,2,0,2,-218,-33,4,-4,38,201,-1,-3,0,-1,-256,-234,5,-1
"12984","7",426,7,4,0,3,0,-248,2,2,191,-1,4,4,0,-7,-191,-247,-2,-2
"12985","7",35,2,1,0,3,24,147,0,-3,130,139,3,-1,0,-2,-106,8,-3,-2
"12986","7",346,8,3,0,0,-250,-55,0,3,247,35,3,3,0,-8,-497,-90,-3,0
"12987","7",193,1,1,0,0,-214,-190,-4,-4,158,-51,1,1,0,-1,-372,-139,-5,-5
"12988","7",84,6,4,1,3,169,3,3,1,102,1,2,2,0,-6,67,2,1,-1
"12989","7",363,3,3,0,3,-249,2,2,-2,3,249,3,3,0,-3,-252,-247,-1,-5
"12990","7",213,3,2,0,1,194,0,-2,-2,-226,1,-3,2,0,-3,420,-1,1,-4
"12991","7",182,7,4,1,3,128,-57,2,2,2,-164,1,1,0,-7,126,107,1,1
"12992","7",49,8,4,1,1,113,83,3,3,0,-3,0,0,0,-8,113,86,3,3
"12993","7",105,1,1,0,0,-246,-17,-4,-4,-201,-1,-4,-4,0,-1,-45,-16,0,0
"12994","7",101,1,3,0,0,-245,243,-4,-4,232,233,-4,-4,0,-1,-477,10,0,0
"12995","7",470,4,1,0,1,-71,36,-1,-1,-148,32,-2,-2,0,-4,77,4,1,1
"12996","7",467,5,1,0,3,-48,-90,4,0,84,71,4,0,0,-5,-132,-161,0,0
"12997","7",463,6,4,1,3,-247,3,-4,1,-244,3,2,4,0,-6,-3,0,-6,-3
"12998","7",59,2,1,0,0,-140,76,-3,-3,-55,-36,1,1,0,-2,-85,112,-4,-4
"12999","7",115,6,3,0,3,4,3,1,1,1,-3,1,1,0,-6,3,6,0,0
"13000","7",330,5,2,0,2,-244,-1,1,0,180,178,2,1,0,-5,-424,-179,-1,-1
"13001","7",181,5,4,0,3,141,153,0,0,-46,-137,1,1,0,-5,187,290,-1,-1
"13002","7",48,1,3,0,0,-1,0,-4,-4,74,-82,-4,-4,0,-1,-75,82,0,0
"13003","7",449,7,4,1,3,3,98,1,2,39,90,0,0,0,-7,-36,8,1,2
"13004","7",15,8,4,1,3,201,52,2,3,63,54,3,3,0,-8,138,-2,-1,0
"13005","7",93,6,1,0,1,-126,113,-2,1,-88,53,-2,0,0,-6,-38,60,0,1
"13006","7",3,1,3,0,0,-249,243,-4,-4,-74,72,-3,-3,0,-1,-175,171,-1,-1
"13007","7",142,3,2,0,2,-214,14,-4,-2,-4,72,-2,1,0,-3,-210,-58,-2,-3
"13008","7",86,6,4,0,3,25,90,2,1,-129,-7,-2,-1,0,-6,154,97,4,2
"13009","7",365,1,3,1,1,2,-221,4,-4,-241,-4,0,-4,0,-1,243,-217,4,0
"13010","7",333,5,4,1,1,-102,-86,0,0,30,54,1,0,0,-5,-132,-140,-1,0
"13011","7",156,5,2,1,1,-22,4,0,0,6,-3,1,1,0,-5,-28,7,-1,-1
"13012","7",451,2,1,0,0,-145,-213,-3,-3,-210,-123,-3,-3,0,-2,65,-90,0,0
"13013","7",71,4,3,1,1,-107,9,-1,-1,39,29,-1,0,0,-4,-146,-20,0,-1
"13014","7",427,1,4,0,1,-250,-45,4,-4,-245,-35,4,-4,0,-1,-5,-10,0,0
"13015","7",350,5,4,1,1,-238,-8,1,0,245,6,3,1,0,-5,-483,-14,-2,-1
"13016","7",347,9,1,0,3,-156,237,-4,4,112,135,2,3,0,-9,-268,102,-6,1
"13017","7",194,9,1,0,0,-221,-43,-4,4,-224,-25,-4,4,0,-9,3,-18,0,0
"13018","7",85,1,2,0,2,-129,105,-3,-4,-93,121,-2,-1,0,-1,-36,-16,-1,-3
"13019","7",364,5,3,0,1,-9,-10,0,0,-56,-3,-1,0,0,-5,47,-7,1,0
"13020","7",214,9,1,0,3,250,1,4,4,205,2,4,4,0,-9,45,-1,0,0
"13021","7",183,3,4,1,1,-160,41,-2,-2,48,106,-2,-2,0,-3,-208,-65,0,0
"13022","7",5,1,2,0,2,-244,221,-3,-4,-241,201,-2,-4,0,-1,-3,20,-1,0
"13023","7",106,4,2,0,1,-67,-73,1,-1,-33,-56,0,0,0,-4,-34,-17,1,-1
"13024","7",102,5,4,1,3,34,-26,3,0,-79,-145,-2,2,0,-5,113,119,5,-2
"13025","7",471,5,3,0,2,-79,49,0,0,-208,-27,0,0,0,-5,129,76,0,0
"13026","7",468,4,1,0,3,124,-139,1,-1,56,85,0,1,0,-4,68,-224,1,-2
"13027","7",395,1,3,0,1,170,20,-4,-4,138,24,-2,3,0,-1,32,-4,-2,-7
"13028","7",6,9,4,0,2,25,-1,4,4,-188,0,4,4,0,-9,213,-1,0,0
"13029","7",116,7,2,0,3,141,-18,2,2,118,-23,1,1,0,-7,23,5,1,1
"13030","7",335,4,2,0,1,113,-8,0,-1,41,20,2,1,0,-4,72,-28,-2,-2
"13031","7",158,2,3,0,0,-230,-22,-3,-3,-193,-158,-3,-3,0,-2,-37,136,0,0
"13032","7",453,3,4,0,2,-157,5,-2,-2,1,-176,1,1,0,-3,-158,181,-3,-3
"13033","7",45,1,3,0,0,-197,-113,-4,-4,70,79,1,-2,0,-1,-267,-192,-5,-2
"13034","7",150,5,3,0,1,-1,3,0,0,-6,12,0,0,0,-5,5,-9,0,0
"13035","7",94,1,4,0,1,-226,-231,0,-4,115,118,2,3,0,-1,-341,-349,-2,-7
"13036","7",30,5,2,0,2,-36,-10,-2,0,-172,1,-2,3,0,-5,136,-11,0,-3
"13037","7",143,6,1,0,3,139,-10,-4,1,-10,57,2,2,0,-6,149,-67,-6,-1
"13038","7",87,7,4,1,3,-4,-249,1,2,248,2,0,-1,0,-7,-252,-251,1,3
"13039","7",366,7,4,0,3,68,-59,3,2,132,-60,1,2,0,-7,-64,1,2,0
"13040","7",334,6,4,1,0,59,245,-4,1,-226,223,-4,-1,0,-6,285,22,0,2
"13041","7",157,9,3,0,2,195,203,4,4,177,93,-2,0,0,-9,18,110,6,4
"13042","7",452,4,3,0,1,-8,-1,-1,-1,-67,2,-1,-1,0,-4,59,-3,0,0
"13043","7",72,3,1,0,0,-237,234,0,-2,146,162,2,2,0,-3,-383,72,-2,-4
"13044","7",428,1,1,0,0,-247,214,-4,-4,-246,204,-4,-4,0,-1,-1,10,0,0
"13045","7",351,1,1,0,0,-246,-246,-4,-4,245,245,-4,-4,0,-1,-491,-491,0,0
"13046","7",348,2,3,0,1,-51,-2,0,-3,47,43,0,-1,0,-2,-98,-45,0,-2
"13047","7",195,1,1,1,1,-218,208,4,-4,-191,183,3,-3,0,-1,-27,25,1,-1
"13048","7",61,1,1,0,3,240,5,4,-4,-27,8,4,-4,0,-1,267,-3,0,0
"13049","7",118,5,3,0,1,-86,36,-2,0,0,24,1,1,0,-5,-86,12,-3,-1
"13050","7",215,2,1,0,0,-192,77,-2,-3,-151,35,-2,-3,0,-2,-41,42,0,0
"13051","7",184,7,3,0,3,109,2,1,2,-1,2,0,0,0,-7,110,0,1,2
"13052","7",50,3,2,0,1,-21,-4,0,-2,30,-72,0,-1,0,-3,-51,68,0,-1
"13053","7",107,3,2,1,3,-25,21,2,-2,63,-143,2,0,0,-3,-88,164,0,-2
"13054","7",103,7,2,1,3,171,1,2,2,38,0,2,1,0,-7,133,1,0,1
"13055","7",472,1,1,0,0,-243,244,-4,-4,-233,208,-4,-4,0,-1,-10,36,0,0
"13056","7",469,1,4,1,0,-240,90,-4,-4,2,16,-3,-4,0,-1,-242,74,-1,0
"13057","7",396,1,1,0,1,-247,247,4,-4,0,1,4,-4,0,-1,-247,246,0,0
"13058","7",60,7,1,0,3,206,4,3,2,-7,-247,3,3,0,-7,213,251,0,-1
"13059","7",117,1,4,0,2,-249,-1,-4,-4,-82,-3,-1,-1,0,-1,-167,2,-3,-3
"13060","7",336,3,4,1,3,184,167,2,-2,128,184,3,-2,0,-3,56,-17,-1,0
"13061","7",159,1,3,0,2,241,-5,-3,-4,213,14,4,4,0,-1,28,-19,-7,-8
"13062","7",454,9,4,1,3,0,0,4,4,245,-1,4,4,0,-9,-245,1,0,0
"13063","7",450,7,4,1,3,-85,2,-1,2,-4,162,1,1,0,-7,-81,-160,-2,1
"13064","7",151,1,2,0,1,-243,9,0,-4,-243,13,0,-4,0,-1,0,-4,0,0
"13065","7",95,1,4,0,2,-243,3,-4,-4,-120,11,-2,-2,0,-1,-123,-8,-2,-2
"13066","7",300,2,1,0,0,-227,35,-2,-3,37,39,1,1,0,-2,-264,-4,-3,-4
"13067","7",224,2,2,0,2,-79,-27,-3,-3,165,66,2,1,0,-2,-244,-93,-5,-4
"13068","7",220,1,4,0,2,-236,185,-4,-4,121,106,-2,-2,0,-1,-357,79,-2,-2
"13069","7",367,4,3,0,1,-51,-43,2,-1,-80,-74,2,-1,0,-4,29,31,0,0
"13070","7",217,2,4,0,2,-106,27,-1,-3,-24,22,-1,-3,0,-2,-82,5,0,0
"13071","7",294,7,1,0,3,158,2,2,2,-1,-1,0,0,0,-7,159,3,2,2
"13072","7",21,2,4,0,2,-65,-35,-2,-3,102,133,0,-2,0,-2,-167,-168,-2,-1
"13073","7",73,1,4,0,2,-123,175,-4,-4,-130,82,-3,-4,0,-1,7,93,-1,0
"13074","7",356,3,4,0,1,-1,7,0,-2,105,-4,2,1,0,-3,-106,11,-2,-3
"13075","7",352,4,2,0,1,12,-78,0,-1,13,-83,0,-1,0,-4,-1,5,0,0
"13076","7",2,3,4,1,1,-106,80,-2,-2,121,-122,1,2,0,-3,-227,202,-3,-4
"13077","7",196,1,3,0,0,-243,1,-4,-4,1,3,0,0,0,-1,-244,-2,-4,-4
"13078","7",62,9,2,0,3,229,248,4,4,217,216,4,4,0,-9,12,32,0,0
"13079","7",119,7,3,0,3,136,-18,1,2,135,115,2,2,0,-7,1,-133,-1,0
"13080","7",216,7,3,0,1,-121,-17,2,2,-115,133,0,-2,0,-7,-6,-150,2,4
"13081","7",185,1,4,0,2,-239,-11,-4,-4,222,-15,-1,3,0,-1,-461,4,-3,-7
"13082","7",51,4,4,1,1,-2,-171,-2,-1,-87,-69,1,-1,0,-4,85,-102,-3,0
"13083","7",108,9,2,0,3,214,29,4,4,214,40,4,4,0,-9,0,-11,0,0
"13084","7",258,2,3,1,0,38,1,-3,-3,-19,1,1,-2,0,-2,57,0,-4,-1
"13085","7",254,6,2,0,3,16,-8,2,1,133,-176,-4,-1,0,-6,-117,168,6,2
"13086","7",174,6,4,0,3,175,122,1,1,43,110,1,0,0,-6,132,12,0,1
"13087","7",170,1,2,0,0,-240,-240,-4,-4,13,12,0,0,0,-1,-253,-252,-4,-4
"13088","7",167,3,1,0,3,-114,-177,-3,-2,-129,-90,-1,-1,0,-3,15,-87,-2,-1
"13089","7",243,4,2,0,2,-246,-22,-4,-1,-242,-136,-3,-1,0,-4,-4,114,-1,0
"13090","7",337,9,2,0,3,12,-15,4,4,233,-19,4,4,0,-9,-221,4,0,0
"13091","7",16,2,1,0,0,-230,231,-1,-3,65,18,1,-2,0,-2,-295,213,-2,-1
"13092","7",455,9,2,0,2,-247,1,-1,4,-8,239,4,4,0,-9,-239,-238,-5,0
"13093","7",232,1,1,0,0,-250,-216,-4,-4,-179,-93,-3,-4,0,-1,-71,-123,-1,0
"13094","7",152,1,1,0,0,-116,-8,-2,-4,-75,0,0,-4,0,-1,-41,-8,-2,0
"13095","7",96,2,1,0,0,-206,7,-3,-3,-184,3,-3,-3,0,-2,-22,4,0,0
"13096","7",301,3,4,1,1,-132,-3,-1,-2,1,107,2,2,0,-3,-133,-110,-3,-4
"13097","7",225,6,2,1,2,-44,204,1,1,135,-126,0,0,0,-6,-179,330,1,1
"13098","7",221,1,4,1,1,-247,-4,-4,-4,12,1,0,0,0,-1,-259,-5,-4,-4
"13099","7",368,1,3,0,3,98,-140,-4,-4,-89,103,4,4,0,-1,187,-243,-8,-8
"13100","7",218,8,4,1,3,-10,179,4,3,-19,51,4,3,0,-8,9,128,0,0
"13101","7",295,5,1,0,1,1,-2,0,0,-4,-4,0,0,0,-5,5,2,0,0
"13102","7",210,1,4,1,2,-67,-26,-1,-4,161,-101,3,3,0,-1,-228,75,-4,-7
"13103","7",74,1,3,0,0,-161,-118,-4,-4,187,182,3,2,0,-1,-348,-300,-7,-6
"13104","7",357,1,4,1,2,-233,-16,-4,-4,103,75,2,-4,0,-1,-336,-91,-6,0
"13105","7",353,3,2,0,2,227,232,-4,-2,226,190,-4,1,0,-3,1,42,0,-3
"13106","7",20,3,3,0,0,-194,-198,4,-2,54,72,2,4,0,-3,-248,-270,2,-6
"13107","7",197,9,4,0,3,49,-27,1,4,30,-184,3,4,0,-9,19,157,-2,0
"13108","7",63,1,4,1,1,-239,6,-3,-4,-1,8,-1,0,0,-1,-238,-2,-2,-4
"13109","7",12,9,4,1,3,1,1,4,4,0,-1,4,4,0,-9,1,2,0,0
"13110","7",339,1,3,1,1,-202,-174,-4,-4,-108,-76,-3,-2,0,-1,-94,-98,-1,-2
"13111","7",186,5,2,0,2,12,20,0,0,20,17,0,0,0,-5,-8,3,0,0
"13112","7",52,3,3,0,0,-94,0,-2,-2,186,-1,3,1,0,-3,-280,1,-5,-3
"13113","7",109,1,1,0,1,-72,0,2,-4,-110,0,3,-4,0,-1,38,0,-1,0
"13114","7",259,1,3,0,1,-95,23,4,-4,-1,-1,3,-3,0,-1,-94,24,1,-1
"13115","7",255,1,3,0,1,-108,-96,-4,-4,18,-52,0,0,0,-1,-126,-44,-4,-4
"13116","7",175,4,4,1,1,-84,-10,-2,-1,-44,-79,-1,-2,0,-4,-40,69,-1,1
"13117","7",171,5,1,0,1,29,12,0,0,21,25,0,0,0,-5,8,-13,0,0
"13118","7",168,4,1,0,3,-22,-67,-1,-1,75,-85,2,2,0,-4,-97,18,-3,-3
"13119","7",244,1,4,1,2,-118,-149,-4,-4,30,-25,1,1,0,-1,-148,-124,-5,-5
"13120","7",338,1,3,0,2,20,-58,-4,-4,77,67,-4,-4,0,-1,-57,-125,0,0
"13121","7",160,7,2,0,0,-210,-3,-4,2,-196,0,-4,2,0,-7,-14,-3,0,0
"13122","7",456,1,1,0,0,-243,222,-2,-4,147,135,1,-3,0,-1,-390,87,-3,-1
"13123","7",233,4,2,0,2,-226,71,-1,-1,18,21,0,0,0,-4,-244,50,-1,-1
"13124","7",153,7,1,0,3,103,-48,2,2,-124,-81,1,1,0,-7,227,33,1,1
"13125","7",97,2,1,0,1,-231,12,3,-3,-22,9,4,-1,0,-2,-209,3,-1,-2
"13126","7",302,3,1,0,0,-216,25,-4,-2,208,38,-2,-2,0,-3,-424,-13,-2,0
"13127","7",226,1,1,0,0,-40,1,-3,-4,178,0,3,-1,0,-1,-218,1,-6,-3
"13128","7",222,1,1,0,0,-245,2,-4,-4,-229,-5,-2,-3,0,-1,-16,7,-2,-1
"13129","7",369,1,4,1,0,-218,4,-4,-4,-94,0,-1,0,0,-1,-124,4,-3,-4
"13130","7",219,5,4,1,3,249,1,4,0,248,3,4,0,0,-5,1,-2,0,0
"13131","7",296,6,1,0,3,96,-3,1,1,4,222,-2,1,0,-6,92,-225,3,0
"13132","7",211,9,3,1,1,64,95,4,4,106,100,3,4,0,-9,-42,-5,1,0
"13133","7",75,7,4,0,2,168,43,2,2,237,195,2,2,0,-7,-69,-152,0,0
"13134","7",358,1,4,0,2,-241,223,-4,-4,236,99,0,-4,0,-1,-477,124,-4,0
"13135","7",354,2,1,0,0,-205,-165,-2,-3,159,171,2,4,0,-2,-364,-336,-4,-7
"13136","7",200,1,3,0,0,-197,-47,-4,-4,62,-20,-3,-4,0,-1,-259,-27,-1,0
"13137","7",198,3,1,0,1,-70,-52,-1,-2,-6,-105,0,-1,0,-3,-64,53,-1,-1
"13138","7",64,9,1,0,1,229,-224,4,4,225,1,4,4,0,-9,4,-225,0,0
"13139","7",120,6,3,0,1,-28,-60,1,1,134,120,1,1,0,-6,-162,-180,0,0
"13140","7",34,2,4,0,2,-82,43,-2,-3,-38,24,-1,-2,0,-2,-44,19,-1,-1
"13141","7",187,4,4,0,2,104,20,1,-1,42,31,1,2,0,-4,62,-11,0,-3
"13142","7",53,7,4,1,3,195,3,2,2,168,1,1,1,0,-7,27,2,1,1
"13143","7",11,5,4,0,1,10,-1,0,0,66,16,1,1,0,-5,-56,-17,-1,-1
"13144","7",26,1,1,0,0,-231,-163,-4,-4,-169,-155,-3,-4,0,-1,-62,-8,-1,0
"13145","7",256,5,3,1,1,-34,3,0,0,27,28,0,0,0,-5,-61,-25,0,0
"13146","7",176,8,1,0,1,-67,-27,-3,3,172,18,1,3,0,-8,-239,-45,-4,0
"13147","7",172,9,2,0,3,-219,214,3,4,-143,131,-2,4,0,-9,-76,83,5,0
"13148","7",169,1,3,0,0,-230,-43,-4,-4,-81,74,-4,-4,0,-1,-149,-117,0,0
"13149","7",245,1,1,0,0,-243,60,-4,-4,-243,4,-4,-4,0,-1,0,56,0,0
"13150","7",165,4,1,0,1,-170,6,-1,-1,78,57,1,1,0,-4,-248,-51,-2,-2
"13151","7",161,1,2,0,2,-243,223,-4,-4,83,56,1,-4,0,-1,-326,167,-5,0
"13152","7",457,7,3,0,1,124,-3,2,2,197,-23,3,3,0,-7,-73,20,-1,-1
"13153","7",234,4,3,0,3,93,44,0,-1,117,39,1,0,0,-4,-24,5,-1,-1
"13154","7",154,5,4,1,3,-5,-28,0,0,-55,-75,0,0,0,-5,50,47,0,0
"13155","7",98,1,3,0,0,-242,-17,-4,-4,223,207,3,3,0,-1,-465,-224,-7,-7
"13156","7",303,1,3,0,2,-188,-172,-4,-4,-128,-95,-1,-1,0,-1,-60,-77,-3,-3
"13157","7",227,7,3,0,3,-197,-108,2,2,-7,31,2,3,0,-7,-190,-139,0,-1
"13158","7",223,5,1,0,1,-1,-1,0,0,2,-1,0,0,0,-5,-3,0,0,0
"13159","7",37,1,1,0,0,-147,14,-3,-4,-135,18,-3,-4,0,-1,-12,-4,0,0
"13160","7",22,5,3,0,1,-11,9,0,0,-54,2,0,0,0,-5,43,7,0,0
"13161","7",297,1,3,1,2,-228,232,-4,-4,222,221,3,3,0,-1,-450,11,-7,-7
"13162","7",212,3,1,0,1,-27,26,4,-2,-210,33,4,-2,0,-3,183,-7,0,0
"13163","7",76,5,4,1,3,8,2,4,0,15,-3,1,0,0,-5,-7,5,3,0
"13164","7",359,4,4,0,3,-128,-126,4,-1,192,214,4,4,0,-4,-320,-340,0,-5
"13165","7",355,1,2,0,2,-205,162,-4,-4,-171,93,-4,-3,0,-1,-34,69,0,-1
"13166","7",201,7,3,1,1,-26,-1,2,2,8,-2,-2,-4,0,-7,-34,1,4,6
"13167","7",199,2,4,0,2,-188,43,-2,-3,21,12,0,0,0,-2,-209,31,-2,-3
"13168","7",65,7,1,0,3,51,103,2,2,35,28,2,2,0,-7,16,75,0,0
"13169","7",121,1,1,0,0,-237,230,-4,-4,235,-234,4,-4,0,-1,-472,464,-8,0
"13170","7",340,5,1,0,1,-83,-19,0,0,74,25,0,0,0,-5,-157,-44,0,0
"13171","7",188,8,2,0,3,208,4,3,3,223,1,2,2,0,-8,-15,3,1,1
"13172","7",54,1,4,0,1,-236,-3,-4,-4,188,8,0,0,0,-1,-424,-11,-4,-4
"13173","7",110,6,1,0,1,-63,61,-4,1,35,-106,-3,2,0,-6,-98,167,-1,-1
"13174","7",260,3,3,0,0,-241,-244,-2,-2,-213,-226,-2,-2,0,-3,-28,-18,0,0
"13175","7",257,1,1,1,0,-42,-243,-4,-4,98,77,2,-4,0,-1,-140,-320,-6,0
"13176","7",177,2,4,1,1,-56,-50,0,-3,63,138,2,-4,0,-2,-119,-188,-2,1
"13177","7",173,3,4,1,3,-237,-22,-2,-2,188,10,0,0,0,-3,-425,-32,-2,-2
"13178","7",17,1,3,0,0,-118,24,-2,-4,87,92,-1,-4,0,-1,-205,-68,-1,0
"13179","7",246,9,4,0,3,-125,-3,3,4,-1,51,2,3,0,-9,-124,-54,1,1
"13180","7",166,1,4,1,2,-54,78,-2,-4,202,195,1,1,0,-1,-256,-117,-3,-5
"13181","7",162,9,3,0,3,138,93,4,4,167,111,3,4,0,-9,-29,-18,1,0
"13182","7",458,2,1,0,1,-93,-89,0,-3,68,77,-1,-2,0,-2,-161,-166,1,-1
"13183","7",235,1,3,1,0,-248,5,-4,-4,184,3,2,2,0,-1,-432,2,-6,-6
"13184","7",155,5,2,0,1,-19,-11,0,0,-14,-128,0,0,0,-5,-5,117,0,0
"13185","7",99,7,4,1,3,243,-13,2,2,216,-22,2,2,0,-7,27,9,0,0
"13186","7",304,1,2,0,2,-237,56,-4,-4,68,-25,2,2,0,-1,-305,81,-6,-6
"13187","7",228,1,4,1,2,-106,187,-4,-4,-83,50,3,2,0,-1,-23,137,-7,-6
"13188","7",374,5,4,0,2,-9,12,0,0,89,14,1,1,0,-5,-98,-2,-1,-1
"13189","7",370,9,1,0,3,-246,-14,-4,4,-243,-14,-4,-4,0,-9,-3,0,0,8
"13190","7",27,5,2,0,2,-70,-20,0,0,-24,-15,0,0,0,-5,-46,-5,0,0
"13191","7",266,5,1,0,1,-61,2,0,0,0,-4,0,-2,0,-5,-61,6,0,2
"13192","7",460,2,1,0,0,-225,105,-4,-3,156,18,-2,1,0,-2,-381,87,-2,-4
"13193","7",290,3,1,0,1,-200,-116,-1,-2,98,120,-1,-2,0,-3,-298,-236,0,0
"13194","7",36,8,3,0,3,-85,169,3,3,83,-148,3,-2,0,-8,-168,317,0,5
"13195","7",206,1,4,0,0,128,37,-4,-4,239,241,3,4,0,-1,-111,-204,-7,-8
"13196","7",202,4,1,0,1,34,30,1,-1,135,35,-2,-1,0,-4,-101,-5,3,0
"13197","7",13,1,4,0,1,-128,-97,1,-4,-100,-30,0,-4,0,-1,-28,-67,1,0
"13198","7",126,2,2,1,2,25,38,-3,-3,22,25,-4,-4,0,-2,3,13,1,1
"13199","7",122,3,1,0,0,-175,-161,-4,-2,226,211,4,4,0,-3,-401,-372,-8,-6
"13200","7",269,2,4,0,2,-250,83,2,-3,-250,149,0,-3,0,-2,0,-66,2,0
"13201","7",265,6,1,0,3,46,-3,0,1,4,2,0,0,0,-6,42,-5,0,1
"13202","7",46,2,1,0,0,-48,-247,-4,-3,-24,-246,-4,-4,0,-2,-24,-1,0,1
"13203","7",237,4,2,0,2,-246,62,-3,-1,24,-1,-1,1,0,-4,-270,63,-2,-2
"13204","7",261,9,1,0,3,210,207,4,4,193,185,4,4,0,-9,17,22,0,0
"13205","7",31,4,1,0,0,-70,-52,-1,-1,-172,166,-4,-4,0,-4,102,-218,3,3
"13206","7",306,5,3,0,3,117,105,1,0,123,138,1,0,0,-5,-6,-33,0,0
"13207","7",23,9,1,0,3,214,213,4,4,209,216,4,4,0,-9,5,-3,0,0
"13208","7",250,6,1,0,3,85,22,1,1,92,22,1,1,0,-6,-7,0,0,0
"13209","7",247,3,3,0,0,-224,-11,-2,-2,96,-7,1,1,0,-3,-320,-4,-3,-3
"13210","7",323,5,4,0,1,-1,-53,0,0,-2,-228,-4,-4,0,-5,1,175,4,4
"13211","7",163,6,3,0,1,77,-43,-2,1,22,61,1,0,0,-6,55,-104,-3,1
"13212","7",459,1,3,0,1,-35,-190,3,-4,33,-52,2,-4,0,-1,-68,-138,1,0
"13213","7",236,5,1,0,1,-1,1,0,0,-9,2,0,0,0,-5,8,-1,0,0
"13214","7",386,1,1,0,0,-238,210,-4,-4,-12,15,-2,-3,0,-1,-226,195,-2,-1
"13215","7",309,2,4,0,2,-227,140,-3,-3,190,165,1,-2,0,-2,-417,-25,-4,-1
"13216","7",305,6,4,1,3,108,-2,1,1,-18,54,1,1,0,-6,126,-56,0,0
"13217","7",229,7,1,0,1,95,-37,1,2,77,-48,-1,0,0,-7,18,11,2,2
"13218","7",375,5,3,0,1,0,1,0,0,5,0,0,0,0,-5,-5,1,0,0
"13219","7",371,1,3,0,0,-186,-195,-4,-4,176,171,-2,1,0,-1,-362,-366,-2,-5
"13220","7",270,5,3,0,1,-3,4,0,0,67,1,1,1,0,-5,-70,3,-1,-1
"13221","7",267,5,3,0,1,-4,-2,0,0,66,-8,1,1,0,-5,-70,6,-1,-1
"13222","7",461,3,4,0,2,16,20,-2,-2,-69,26,-2,-3,0,-3,85,-6,0,1
"13223","7",291,1,4,0,2,-244,89,-4,-4,-238,-71,-4,-4,0,-1,-6,160,0,0
"13224","7",360,1,3,0,0,-195,-171,0,-4,-1,3,0,-4,0,-1,-194,-174,0,0
"13225","7",207,3,1,0,0,-249,-1,-4,-2,0,1,0,0,0,-3,-249,-2,-4,-2
"13226","7",203,9,4,1,3,197,9,4,4,237,16,4,4,0,-9,-40,-7,0,0
"13227","7",130,9,1,0,3,190,-37,4,4,81,-39,4,4,0,-9,109,2,0,0
"13228","7",127,1,1,0,0,-224,-42,2,-4,85,64,2,-3,0,-1,-309,-106,0,-1
"13229","7",123,2,4,1,2,-180,-3,-3,-3,-173,0,-3,-3,0,-2,-7,-3,0,0
"13230","7",325,8,1,0,1,-86,-85,-2,3,8,11,-1,3,0,-8,-94,-96,-1,0
"13231","7",321,1,1,1,0,-236,-233,-4,-4,-101,-71,-1,-1,0,-1,-135,-162,-3,-3
"13232","7",209,7,4,1,3,177,-3,2,2,-14,4,-1,0,0,-7,191,-7,3,2
"13233","7",238,1,3,1,1,76,-12,-3,-4,106,-115,2,0,0,-1,-30,103,-5,-4
"13234","7",262,6,4,1,3,85,22,1,1,72,45,1,1,0,-6,13,-23,0,0
"13235","7",310,1,4,0,2,-166,1,-3,-4,-127,-9,1,-1,0,-1,-39,10,-4,-3
"13236","7",307,1,4,1,2,-81,-15,-3,-4,-50,212,-1,-1,0,-1,-31,-227,-2,-3
"13237","7",230,4,1,0,0,-240,71,-4,-1,-231,152,-4,-1,0,-4,-9,-81,0,0
"13238","7",251,5,3,0,1,-234,-190,-4,0,-78,-74,0,-2,0,-5,-156,-116,-4,2
"13239","7",248,7,4,1,3,174,169,2,2,151,180,4,4,0,-7,23,-11,-2,-2
"13240","7",324,1,2,0,0,-193,1,-3,-4,-7,1,-4,-4,0,-1,-186,0,1,0
"13241","7",164,7,2,0,2,90,8,1,2,101,-90,2,2,0,-7,-11,98,-1,0
"13242","7",320,1,2,0,2,-249,127,-4,-4,-247,140,-4,-4,0,-1,-2,-13,0,0
"13243","7",293,1,4,1,0,-117,14,-4,-4,-229,-5,-4,-4,0,-1,112,19,0,0
"13244","7",387,1,3,0,1,139,84,2,-4,103,101,2,1,0,-1,36,-17,0,-5
"13245","7",128,7,1,0,3,202,-35,2,2,179,-117,1,2,0,-7,23,82,1,0
"13246","7",205,3,1,0,2,-125,-3,-3,-2,197,-1,4,4,0,-3,-322,-2,-7,-6
"13247","7",132,7,4,1,1,144,-12,1,2,23,181,1,0,0,-7,121,-193,0,2
"13248","7",376,4,4,1,1,30,-154,-1,-1,68,-160,-1,-1,0,-4,-38,6,0,0
"13249","7",372,1,3,0,0,-248,-242,-4,-4,35,90,-2,-4,0,-1,-283,-332,-2,0
"13250","7",271,4,3,0,1,-56,2,-1,-1,198,4,4,4,0,-4,-254,-2,-5,-5
"13251","7",268,7,4,0,3,132,124,2,2,112,-124,4,3,0,-7,20,248,-2,-1
"13252","7",32,5,1,0,1,2,-1,0,0,212,-216,2,-4,0,-5,-210,215,-2,4
"13253","7",292,7,3,1,1,-41,12,4,2,64,-2,0,-2,0,-7,-105,14,4,4
"13254","7",361,1,1,1,0,-2,-249,-4,-4,249,2,4,4,0,-1,-251,-251,-8,-8
"13255","7",208,4,4,0,2,-192,-122,-1,-1,213,181,3,3,0,-4,-405,-303,-4,-4
"13256","7",204,5,3,0,1,-72,-52,0,0,96,-138,1,1,0,-5,-168,86,-1,-1
"13257","7",131,7,4,0,3,-122,152,-3,2,148,204,-4,2,0,-7,-270,-52,1,0
"13258","7",362,2,4,1,3,-97,148,4,-3,140,106,2,-2,0,-2,-237,42,2,-1
"13259","7",124,8,1,0,3,167,-1,3,3,216,1,0,2,0,-8,-49,-2,3,1
"13260","7",326,2,4,1,2,-195,-180,-3,-3,55,40,1,1,0,-2,-250,-220,-4,-4
"13261","7",322,5,4,0,3,176,-140,0,0,37,-22,2,2,0,-5,139,-118,-2,-2
"13262","7",287,8,4,0,3,-185,-8,3,3,-89,8,1,1,0,-8,-96,-16,2,2
"13263","7",239,6,1,0,1,83,-8,1,1,64,-9,2,1,0,-6,19,1,-1,0
"13264","7",263,1,4,1,0,-241,-1,-4,-4,-219,7,-2,-2,0,-1,-22,-8,-2,-2
"13265","7",311,1,2,0,2,-192,-7,-4,-4,168,2,4,-4,0,-1,-360,-9,-8,0
"13266","7",308,1,4,0,0,-248,-247,-4,-4,227,234,2,2,0,-1,-475,-481,-6,-6
"13267","7",231,6,4,1,0,-205,4,-4,1,-99,-139,-4,2,0,-6,-106,143,0,-1
"13268","7",252,5,4,0,1,124,-71,0,0,91,-143,1,1,0,-5,33,72,-1,-1
"13269","7",249,1,3,0,0,-68,-64,-4,-4,23,-24,1,-4,0,-1,-91,-40,-5,0
"13270","7",273,4,1,0,0,-231,3,-2,-1,-37,55,0,0,0,-4,-194,-52,-2,-1
"13271","7",382,3,4,0,2,-182,-1,-2,-2,18,-3,-2,0,0,-3,-200,2,0,-2
"13272","7",313,2,3,0,0,-209,-211,-3,-3,-194,-172,-3,-3,0,-2,-15,-39,0,0
"13273","7",241,1,4,0,2,-145,-75,-2,-4,189,175,2,0,0,-1,-334,-250,-4,-4
"13274","7",388,4,4,1,0,-224,12,-2,-1,-233,2,1,-1,0,-4,9,10,-3,0
"13275","7",129,6,4,1,1,106,5,1,1,106,5,1,1,0,-6,0,0,0,0
"13276","7",125,3,4,1,0,-212,-22,-4,-2,-46,-31,-3,-1,0,-3,-166,9,-1,-1
"13277","7",283,6,1,0,1,-85,51,-3,1,-96,-108,-1,1,0,-6,11,159,-2,0
"13278","7",377,1,1,0,0,-243,6,-4,-4,-243,7,-4,-4,0,-1,0,-1,0,0
"13279","7",373,1,3,0,0,-244,-52,0,-4,-233,-163,0,-4,0,-1,-11,111,0,0
"13280","7",272,4,4,1,2,33,1,-3,-1,16,7,-1,-1,0,-4,17,-6,-2,0
"13281","7",264,1,4,1,2,-225,-234,-4,-4,-117,34,-3,-4,0,-1,-108,-268,-1,0
"13282","7",312,5,4,0,1,92,77,0,0,-97,116,0,0,0,-5,189,-39,0,0
"13283","7",240,4,2,0,1,176,30,1,-1,123,16,1,1,0,-4,53,14,0,-2
"13284","7",329,3,4,0,3,75,96,-1,-2,52,-80,2,2,0,-3,23,176,-3,-4
"13285","7",253,9,3,0,3,220,221,4,4,210,225,2,4,0,-9,10,-4,2,0
"13286","7",25,2,4,0,2,-114,-153,-3,-3,-59,-54,-3,-3,0,-2,-55,-99,0,0
"13287","7",383,5,4,1,1,-3,1,0,0,-3,1,0,0,0,-5,0,0,0,0
"13288","7",391,5,2,0,3,203,213,0,0,130,-117,0,0,0,-5,73,330,0,0
"13289","7",314,1,4,0,1,-242,10,4,-4,-241,9,4,-4,0,-1,-1,1,0,0
"13290","7",327,5,4,1,3,32,-201,2,0,118,0,2,-1,0,-5,-86,-201,0,1
"13291","7",389,9,3,1,2,249,1,-4,4,33,-16,2,1,0,-9,216,17,-6,3
"13292","7",288,7,2,0,2,21,48,1,2,-85,62,0,1,0,-7,106,-14,1,1
"13293","7",24,1,2,0,2,-247,0,0,-4,226,0,0,3,0,-1,-473,0,0,-7
"13294","7",284,1,3,1,1,-227,-146,-3,-4,-103,-118,-3,-4,0,-1,-124,-28,0,0
"13295","7",378,5,4,1,1,-101,5,-1,0,79,-1,1,1,0,-5,-180,6,-2,-1
"13296","7",277,1,4,0,1,-40,99,4,-4,48,-93,3,-3,0,-1,-88,192,1,-1
"13297","7",316,3,3,0,0,-160,-109,0,-2,-180,-107,-2,-2,0,-3,20,-2,2,0
"13298","7",390,1,2,0,2,-188,-5,-3,-4,64,-8,1,1,0,-1,-252,3,-4,-5
"13299","7",29,1,4,1,0,-202,200,-4,-4,86,73,-3,-2,0,-1,-288,127,-1,-2
"13300","7",274,6,4,0,2,-106,39,0,1,-23,56,0,0,0,-6,-83,-17,0,1
"13301","7",286,6,1,0,3,82,-1,2,1,69,-1,1,1,0,-6,13,0,1,0
"13302","7",38,6,4,0,3,102,-8,1,1,11,-21,1,0,0,-6,91,13,0,1
"13303","7",242,3,4,0,2,-1,1,0,-2,-23,0,-1,-3,0,-3,22,1,1,1
"13304","7",384,1,1,0,0,-79,3,0,-4,-206,1,0,-4,0,-1,127,2,0,0
"13305","7",28,1,4,0,1,-213,153,-4,-4,8,14,-1,-1,0,-1,-221,139,-3,-3
"13306","7",276,7,4,0,3,176,-3,2,2,156,-8,2,2,0,-7,20,5,0,0
"13307","7",328,4,3,0,1,-127,12,-1,-1,6,6,1,1,0,-4,-133,6,-2,-2
"13308","7",39,3,3,0,1,-237,-7,-3,-2,49,-64,1,-1,0,-3,-286,57,-4,-1
"13309","7",289,8,1,0,3,187,187,3,3,215,223,3,3,0,-8,-28,-36,0,0
"13310","7",381,1,2,0,2,-225,196,-4,-4,166,70,3,3,0,-1,-391,126,-7,-7
"13311","7",285,1,2,0,1,-126,120,-4,-4,-166,134,-4,-1,0,-1,40,-14,0,-3
"13312","7",379,4,3,1,1,0,-162,-1,-1,24,-81,1,0,0,-4,-24,-81,-2,-1
"13313","7",278,1,4,0,1,-221,-224,4,-4,0,-224,4,-4,0,-1,-221,0,0,0
"13314","7",33,6,3,0,1,34,-41,0,1,-188,-110,0,1,0,-6,222,69,0,0
"13315","7",315,9,3,0,3,242,13,4,4,222,9,4,4,0,-9,20,4,0,0
"13316","7",279,6,4,0,3,20,-22,2,1,69,-36,2,1,0,-6,-49,14,0,0
"13317","7",275,1,4,0,2,-245,-1,-4,-4,-237,0,2,-2,0,-1,-8,-1,-6,-2
"13318","7",392,3,1,0,0,-144,49,-1,-2,-234,214,-2,-2,0,-3,90,-165,1,0
"13319","7",393,1,1,0,0,-225,-31,-4,-4,30,30,4,-4,0,-1,-255,-61,-8,0
"13320","7",319,7,1,0,1,69,-1,1,2,48,2,1,-1,0,-7,21,-3,0,3
"13321","7",385,3,4,1,1,60,-125,-2,-2,-56,43,0,0,0,-3,116,-168,-2,-2
"13322","7",280,2,2,0,1,-162,-4,-2,-3,3,35,2,-1,0,-2,-165,-39,-4,-2
"13323","7",281,1,4,0,2,-237,2,-4,-4,-242,-1,-4,-4,0,-1,5,3,0,0
"13324","7",380,2,4,0,1,-117,-149,3,-3,-170,-141,3,-3,0,-2,53,-8,0,0
"13325","7",394,1,3,1,0,-245,247,-4,-4,-250,246,-4,-4,0,-1,5,1,0,0
"13326","7",317,1,4,0,2,-184,185,-4,-4,-167,177,-3,-3,0,-1,-17,8,-1,-1
"13327","7",318,1,2,0,2,-208,207,-4,-4,191,184,-4,0,0,-1,-399,23,0,-4
"13328","7",282,9,3,0,3,54,-58,2,4,222,25,1,4,0,-9,-168,-83,1,0
"13329","8",400,2,4,1,2,-199,77,-3,-3,79,-40,2,0,1,-1,-278,117,-5,-3
"13330","8",266,5,1,0,1,-115,0,0,0,-152,3,-2,-2,1,-4,37,-3,2,2
"13331","8",429,1,2,0,0,-221,-222,-4,-4,-198,-189,-4,-4,1,0,-23,-33,0,0
"13332","8",267,4,3,0,1,43,-5,-1,-1,85,-2,1,1,1,-3,-42,-3,-2,-2
"13333","8",435,5,4,0,1,10,-3,0,0,5,-10,1,0,1,-4,5,7,-1,0
"13334","8",434,6,4,1,3,90,-16,1,1,-2,41,1,1,1,-5,92,-57,0,0
"13335","8",43,1,3,1,0,-230,8,-4,-4,42,1,1,-2,1,0,-272,7,-5,-2
"13336","8",432,5,2,0,1,26,-47,0,0,20,-28,0,0,1,-4,6,-19,0,0
"13337","8",144,1,3,1,0,-249,4,-4,-4,220,10,1,-1,1,0,-469,-6,-5,-3
"13338","8",265,8,1,0,3,185,1,3,3,1,-7,0,0,1,-7,184,8,3,3
"13339","8",430,5,2,1,1,30,-34,0,0,144,-64,1,1,1,-4,-114,30,-1,-1
"13340","8",433,2,1,1,0,-235,-238,-3,-3,-15,-26,-2,-2,1,-1,-220,-212,-1,-1
"13341","8",145,5,1,0,1,-46,-98,0,0,-128,-215,0,0,1,-4,82,117,0,0
"13342","8",40,1,1,0,2,-197,140,-4,-4,177,67,3,3,1,0,-374,73,-7,-7
"13343","8",57,1,4,1,1,-38,-222,-3,-4,-2,-192,-4,-4,1,0,-36,-30,1,0
"13344","8",462,9,3,1,3,213,221,4,4,208,189,4,4,1,-8,5,32,0,0
"13345","8",401,4,2,0,1,-17,1,3,-1,91,13,2,0,1,-3,-108,-12,1,-1
"13346","8",58,6,4,1,1,-244,25,-4,1,242,0,4,4,1,-5,-486,25,-8,-3
"13347","8",418,3,2,0,2,-103,134,-1,-2,202,-58,-1,-2,1,-2,-305,192,0,0
"13348","8",402,1,3,1,0,-224,0,-4,-4,-153,-6,-2,-3,1,0,-71,6,-2,-1
"13349","8",55,5,4,0,1,35,-5,0,0,1,1,0,0,1,-4,34,-6,0,0
"13350","8",436,5,4,1,3,87,-245,0,0,66,-204,4,2,1,-4,21,-41,-4,-2
"13351","8",84,7,4,1,3,139,1,2,2,95,3,1,1,1,-6,44,-2,1,1
"13352","8",56,4,3,1,1,21,-116,-1,-1,21,-110,-2,0,1,-3,0,-6,1,-1
"13353","8",80,8,4,0,3,213,1,3,3,230,-2,3,-2,1,-7,-17,3,0,5
"13354","8",77,7,3,1,1,9,2,1,2,-103,-4,-1,-1,1,-6,112,6,2,3
"13355","8",73,1,4,0,2,-121,141,-4,-4,-128,95,-4,-4,1,0,7,46,0,0
"13356","8",331,1,1,0,0,-238,-231,-4,-4,-216,-188,-4,-4,1,0,-22,-43,0,0
"13357","8",398,1,4,1,2,-239,-234,-4,-4,17,19,-3,-3,1,0,-256,-253,-1,-1
"13358","8",268,7,4,1,3,83,-119,2,2,108,-153,2,2,1,-6,-25,34,0,0
"13359","8",74,2,3,1,0,-163,-85,-4,-3,156,-90,2,2,1,-1,-319,5,-6,-5
"13360","8",439,5,2,0,1,-2,-2,0,0,3,5,0,0,1,-4,-5,-7,0,0
"13361","8",431,4,3,1,0,-24,17,-2,-1,65,57,-1,-1,1,-3,-89,-40,-1,0
"13362","8",451,2,1,0,0,-147,-144,-3,-3,-199,-127,-2,-3,1,-1,52,-17,-1,0
"13363","8",59,2,1,0,0,-95,94,-3,-3,-60,-33,-1,-1,1,-1,-35,127,-2,-2
"13364","8",419,6,4,1,3,33,43,1,1,42,89,1,1,1,-5,-9,-46,0,0
"13365","8",330,6,2,0,2,-247,-4,1,1,195,174,1,1,1,-5,-442,-178,0,0
"13366","8",452,3,3,1,1,-191,5,-2,-2,-6,2,0,0,1,-2,-185,3,-2,-2
"13367","8",397,4,4,0,3,121,62,1,-1,129,58,3,1,1,-3,-8,4,-2,-2
"13368","8",85,2,2,0,2,-128,-118,-2,-3,90,-81,1,0,1,-1,-218,-37,-3,-3
"13369","8",47,7,4,1,3,158,2,1,2,161,1,1,1,1,-6,-3,1,0,1
"13370","8",438,5,4,1,3,3,4,4,0,3,-11,4,0,1,-4,0,15,0,0
"13371","8",146,2,2,0,0,-135,-192,-3,-3,-149,-149,-3,-3,1,-1,14,-43,0,0
"13372","8",470,4,1,1,1,-55,25,-1,-1,-74,10,-1,-2,1,-3,19,15,0,1
"13373","8",82,5,4,1,2,-249,-13,0,0,19,16,4,-4,1,-4,-268,-29,-4,4
"13374","8",463,5,4,1,3,-7,1,0,0,230,-12,-2,2,1,-4,-237,13,2,-2
"13375","8",44,1,2,0,2,-232,237,-4,-4,220,-225,-2,-4,1,0,-452,462,-2,0
"13376","8",75,3,4,1,2,229,69,4,-2,155,39,1,-3,1,-2,74,30,3,1
"13377","8",4,5,3,0,1,-2,1,0,0,30,1,1,1,1,-4,-32,0,-1,-1
"13378","8",27,3,2,0,2,-161,111,-1,-2,-57,-82,0,0,1,-2,-104,193,-1,-2
"13379","8",440,2,3,1,0,-182,-4,-3,-3,-38,-1,-2,-2,1,-1,-144,-3,-1,-1
"13380","8",437,3,1,0,0,-221,0,-2,-2,-242,5,-3,-3,1,-2,21,-5,1,1
"13381","8",42,2,3,0,1,-31,8,1,-3,-38,22,1,-2,1,-1,7,-14,0,-1
"13382","8",270,4,3,1,1,61,1,1,-1,188,3,2,1,1,-3,-127,-2,-1,-2
"13383","8",81,9,1,0,0,-229,204,1,4,-220,195,3,-3,1,-8,-9,9,-2,7
"13384","8",78,1,4,0,0,-204,-1,-4,-4,-133,-10,-3,-3,1,0,-71,9,-1,-1
"13385","8",86,5,4,0,3,93,-26,2,0,173,-9,1,2,1,-4,-80,-17,1,-2
"13386","8",332,1,1,0,0,-250,84,-2,-4,-248,142,-3,-3,1,0,-2,-58,1,-1
"13387","8",399,7,4,1,3,135,9,1,2,10,11,0,0,1,-6,125,-2,1,2
"13388","8",269,2,4,0,2,-249,105,3,-3,-250,116,0,-3,1,-1,1,-11,3,0
"13389","8",471,4,3,1,2,-86,163,-1,-1,-75,70,-1,0,1,-3,-11,93,0,-1
"13390","8",88,1,4,1,2,-243,-8,-4,-4,234,-218,4,4,1,0,-477,210,-8,-8
"13391","8",464,6,1,0,1,12,13,1,1,31,18,1,1,1,-5,-19,-5,0,0
"13392","8",169,1,3,0,0,-208,212,-4,-4,-134,94,-4,-4,1,0,-74,118,0,0
"13393","8",6,9,4,0,2,219,0,4,4,84,0,4,4,1,-8,135,0,0,0
"13394","8",411,1,2,0,2,-226,-229,-4,-4,-240,-232,-4,-4,1,0,14,3,0,0
"13395","8",404,4,1,0,1,22,-9,-1,-1,51,-42,1,0,1,-3,-29,33,-2,-1
"13396","8",453,5,4,1,2,-148,-2,0,0,-6,-193,1,-2,1,-4,-142,191,-1,2
"13397","8",49,7,4,1,1,169,72,2,2,101,46,2,2,1,-6,68,26,0,0
"13398","8",474,1,1,0,0,3,-65,0,-4,5,-74,0,-4,1,0,-2,9,0,0
"13399","8",442,6,4,1,1,-25,56,-1,1,42,59,1,1,1,-5,-67,-3,-2,0
"13400","8",90,5,4,1,0,-249,14,0,0,69,-4,1,1,1,-4,-318,18,-1,-1
"13401","8",147,6,2,1,3,84,-195,1,1,120,-131,1,1,1,-5,-36,-64,0,0
"13402","8",87,8,4,1,3,-9,-249,2,3,-2,-248,1,1,1,-7,-7,-1,1,2
"13403","8",83,5,1,0,3,107,-148,0,0,88,-85,1,1,1,-4,19,-63,-1,-1
"13404","8",410,1,1,0,0,-20,-23,0,-4,-143,-38,0,-4,1,0,123,15,0,0
"13405","8",403,3,1,0,0,-166,-13,-1,-2,-198,-21,0,-3,1,-2,32,8,-1,1
"13406","8",76,5,4,1,3,3,1,0,0,9,4,1,0,1,-4,-6,-3,-1,0
"13407","8",48,1,3,1,0,6,-10,-4,-4,87,-95,-4,-4,1,0,-81,85,0,0
"13408","8",473,3,3,1,0,-214,-24,-2,-2,-200,-24,-2,-2,1,-2,-14,0,0,0
"13409","8",441,3,4,1,2,-192,-4,-3,-2,-132,17,-3,-2,1,-2,-60,-21,0,0
"13410","8",9,3,4,1,2,-35,41,1,-2,92,97,1,-1,1,-2,-127,-56,0,-1
"13411","8",420,5,4,0,3,2,0,0,0,-1,-69,1,0,1,-4,3,69,-1,0
"13412","8",271,2,3,1,1,119,-3,-1,-3,-134,0,2,1,1,-1,253,-3,-3,-4
"13413","8",61,1,1,0,3,249,22,4,-4,-40,-3,4,-4,1,0,289,25,0,0
"13414","8",79,2,4,1,2,-221,216,-3,-3,-217,192,-4,-4,1,-1,-4,24,1,1
"13415","8",406,8,2,0,2,-89,-71,1,3,-48,-51,3,1,1,-7,-41,-20,-2,2
"13416","8",333,6,4,1,1,67,-34,1,1,55,44,1,1,1,-5,12,-78,0,0
"13417","8",50,3,2,0,1,-33,0,0,-2,40,-59,0,-2,1,-2,-73,59,0,0
"13418","8",476,6,3,1,0,-106,-111,-1,1,-142,-72,1,1,1,-5,36,-39,-2,0
"13419","8",472,1,1,0,0,-241,244,-4,-4,-247,231,-4,-4,1,0,6,13,0,0
"13420","8",89,1,3,1,0,-243,-1,-4,-4,-242,2,-3,-4,1,0,-1,-3,-1,0
"13421","8",465,6,4,1,3,249,-170,4,1,4,-231,4,4,1,-5,245,61,0,-3
"13422","8",17,1,3,1,0,26,5,0,-4,147,144,-1,-4,1,0,-121,-139,1,0
"13423","8",60,8,1,0,3,247,3,3,3,-1,-243,3,3,1,-7,248,246,0,0
"13424","8",412,9,1,0,0,-246,2,-4,4,244,-1,4,4,1,-8,-490,3,-8,0
"13425","8",405,2,4,1,1,-107,68,0,-3,100,76,-1,-1,1,-1,-207,-8,1,-2
"13426","8",454,8,4,1,3,250,3,3,3,247,2,3,3,1,-7,3,1,0,0
"13427","8",5,2,2,0,2,-238,216,-2,-3,-240,234,-3,-4,1,-1,2,-18,1,1
"13428","8",475,2,3,0,3,130,-28,1,-3,35,46,0,0,1,-1,95,-74,1,-3
"13429","8",443,2,1,0,0,-248,-219,-3,-3,47,-2,0,0,1,-1,-295,-217,-3,-3
"13430","8",91,7,2,1,3,77,6,2,2,60,9,1,2,1,-6,17,-3,1,0
"13431","8",148,1,1,0,1,-235,-122,2,-4,-196,-117,2,-3,1,0,-39,-5,0,-1
"13432","8",370,9,1,0,3,243,-12,4,4,-241,-11,-4,-4,1,-8,484,-1,8,8
"13433","8",367,4,3,0,1,-47,-55,2,-1,-87,-64,3,2,1,-3,40,9,-1,-3
"13434","8",363,8,3,1,3,248,1,3,3,249,1,1,1,1,-7,-1,0,2,2
"13435","8",408,1,1,0,0,-218,-1,-3,-4,-90,1,0,0,1,0,-128,-2,-3,-4
"13436","8",133,2,2,0,1,-47,-183,0,-3,167,29,3,0,1,-1,-214,-212,-3,-3
"13437","8",21,2,4,1,2,-135,-76,-1,-3,101,71,-1,-2,1,-1,-236,-147,0,-1
"13438","8",7,6,1,0,3,72,76,1,1,153,145,2,2,1,-5,-81,-69,-1,-1
"13439","8",66,1,1,0,1,-213,2,-1,-4,158,1,1,3,1,0,-371,1,-2,-7
"13440","8",2,6,4,1,1,107,-88,0,1,71,-136,2,1,1,-5,36,48,-2,0
"13441","8",421,6,3,1,1,-23,8,-1,1,52,39,1,1,1,-5,-75,-31,-2,0
"13442","8",272,4,4,1,2,4,3,-2,-1,13,2,-1,-1,1,-3,-9,1,-1,0
"13443","8",62,9,2,0,3,211,212,4,4,236,234,4,4,1,-8,-25,-22,0,0
"13444","8",8,7,3,0,1,-217,-240,-2,2,-32,56,0,0,1,-6,-185,-296,-2,2
"13445","8",407,1,2,0,2,-245,44,-4,-4,231,72,4,4,1,0,-476,-28,-8,-8
"13446","8",334,2,4,1,0,-227,140,-4,-3,-69,215,-4,2,1,-1,-158,-75,0,-5
"13447","8",51,6,4,1,1,67,84,1,1,50,110,0,-1,1,-5,17,-26,1,2
"13448","8",108,9,2,0,3,217,25,3,4,229,45,4,4,1,-8,-12,-20,-1,0
"13449","8",104,1,1,0,0,-236,3,-4,-4,244,1,1,-2,1,0,-480,2,-5,-2
"13450","8",100,7,4,1,3,196,4,3,2,-101,0,-1,-1,1,-6,297,4,4,3
"13451","8",466,2,3,1,0,-129,108,-3,-3,-111,-74,-2,-2,1,-1,-18,182,-1,-1
"13452","8",170,1,2,0,0,-235,-236,-4,-4,6,17,0,0,1,0,-241,-253,-4,-4
"13453","8",167,7,1,0,3,101,-141,2,2,159,-98,2,2,1,-6,-58,-43,0,0
"13454","8",413,3,1,0,1,-160,23,-2,-2,-98,-3,-2,-1,1,-2,-62,26,0,-1
"13455","8",41,6,2,0,3,10,74,3,1,14,82,3,1,1,-5,-4,-8,0,0
"13456","8",455,2,2,0,2,-247,5,-3,-3,-4,237,4,3,1,-1,-243,-232,-7,-6
"13457","8",232,1,1,0,0,-246,-244,-4,-4,-248,-237,-4,-4,1,0,2,-7,0,0
"13458","8",448,9,2,0,2,1,-158,2,4,1,-212,4,4,1,-8,0,54,-2,0
"13459","8",444,1,2,0,2,-247,3,-4,-4,-246,-1,-4,-4,1,0,-1,4,0,0
"13460","8",92,3,4,1,2,-161,-157,-2,-2,-170,-156,-1,-1,1,-2,9,-1,-1,-1
"13461","8",149,6,3,0,1,-249,3,-4,1,239,8,-2,1,1,-5,-488,-5,-2,0
"13462","8",371,1,3,0,0,-188,-184,-4,-4,140,-154,-1,-1,1,0,-328,-30,-3,-3
"13463","8",368,9,3,1,3,-158,143,4,4,-100,137,4,4,1,-8,-58,6,0,0
"13464","8",364,5,3,0,1,-101,-48,0,0,-68,-4,0,0,1,-4,-33,-44,0,0
"13465","8",409,2,4,0,2,-150,-153,-3,-3,119,126,2,1,1,-1,-269,-279,-5,-4
"13466","8",134,6,2,0,2,-16,-5,1,1,9,-4,1,0,1,-5,-25,-1,0,1
"13467","8",210,2,4,0,2,-200,25,2,-3,231,23,1,-3,1,-1,-431,2,1,0
"13468","8",70,1,2,0,2,-238,-209,0,-4,-70,-24,-3,-4,1,0,-168,-185,3,0
"13469","8",67,1,1,0,0,-235,27,-4,-4,211,-198,3,3,1,0,-446,225,-7,-7
"13470","8",20,1,3,1,0,-200,-202,-4,-4,153,159,3,4,1,0,-353,-361,-7,-8
"13471","8",422,1,3,0,1,-99,-167,4,-4,-90,-154,4,-4,1,0,-9,-13,0,0
"13472","8",273,5,1,0,0,21,5,0,0,62,1,0,0,1,-4,-41,4,0,0
"13473","8",63,5,4,1,1,2,0,0,0,2,0,0,0,1,-4,0,0,0,0
"13474","8",415,2,2,0,2,-119,-24,0,-3,131,190,0,1,1,-1,-250,-214,0,-4
"13475","8",137,4,1,0,1,-14,-233,-4,-1,232,238,-3,-3,1,-3,-246,-471,-1,2
"13476","8",335,3,2,0,1,-139,38,-2,-2,35,36,2,2,1,-2,-174,2,-4,-4
"13477","8",52,1,3,1,0,-239,2,-3,-4,-110,6,0,-1,1,0,-129,-4,-3,-3
"13478","8",109,1,1,0,1,-46,-1,2,-4,-62,-1,3,-4,1,0,16,0,-1,0
"13479","8",105,1,1,0,0,-245,-59,-4,-4,-250,2,-4,-4,1,0,5,-61,0,0
"13480","8",101,1,3,1,0,-240,236,-4,-4,234,236,-3,-3,1,0,-474,0,-1,-1
"13481","8",467,5,1,1,3,-106,-122,4,0,110,61,4,0,1,-4,-216,-183,0,0
"13482","8",171,5,1,0,1,36,30,3,0,56,33,0,0,1,-4,-20,-3,3,0
"13483","8",168,4,1,0,3,43,-67,-1,-1,103,-60,1,2,1,-3,-60,-7,-2,-3
"13484","8",414,1,1,1,0,-123,-145,-4,-4,-52,-42,-1,-1,1,0,-71,-103,-3,-3
"13485","8",338,1,3,1,2,-172,-202,-4,-4,83,59,-4,-4,1,0,-255,-261,0,0
"13486","8",456,2,1,1,0,-221,-100,-1,-3,20,24,0,-1,1,-1,-241,-124,-1,-2
"13487","8",233,3,2,0,2,-210,23,-3,-2,-49,25,-1,-1,1,-2,-161,-2,-2,-1
"13488","8",449,6,4,1,3,14,64,1,1,32,82,1,1,1,-5,-18,-18,0,0
"13489","8",445,7,4,1,3,88,-38,1,2,87,-41,1,1,1,-6,1,3,0,1
"13490","8",93,5,1,0,1,-135,53,-2,0,-92,60,-2,0,1,-4,-43,-7,0,0
"13491","8",15,6,4,1,3,219,26,3,1,73,31,3,2,1,-5,146,-5,0,-1
"13492","8",372,1,3,1,0,-221,-235,-4,-4,1,2,-4,-4,1,0,-222,-237,0,0
"13493","8",369,3,4,1,0,-172,-1,-1,-2,-205,1,0,0,1,-2,33,-2,-1,-2
"13494","8",365,1,3,1,1,23,3,0,-4,-120,-2,0,-4,1,0,143,5,0,0
"13495","8",139,1,4,1,2,-241,2,-2,-4,-243,-3,-4,-4,1,0,2,5,2,0
"13496","8",135,5,1,0,1,-155,-145,0,0,123,-81,0,0,1,-4,-278,-64,0,0
"13497","8",211,7,3,1,1,17,20,4,2,96,98,-2,1,1,-6,-79,-78,6,1
"13498","8",71,4,3,0,1,-70,13,-1,-1,19,14,-1,0,1,-3,-89,-1,0,-1
"13499","8",68,2,4,1,0,-12,0,-2,-3,204,2,-2,-3,1,-1,-216,-2,0,0
"13500","8",200,1,3,1,0,-232,-155,-4,-4,-218,-20,-4,-4,1,0,-14,-135,0,0
"13501","8",423,3,1,0,3,26,1,1,-2,178,-29,-1,2,1,-2,-152,30,2,-4
"13502","8",274,7,4,1,2,-114,24,1,2,-71,58,1,1,1,-6,-43,-34,0,1
"13503","8",64,9,1,0,1,214,-229,4,4,239,-8,4,4,1,-8,-25,-221,0,0
"13504","8",416,1,4,1,0,-229,239,-4,-4,-196,226,-4,4,1,0,-33,13,0,-8
"13505","8",138,5,3,0,1,38,-105,0,0,18,-25,0,0,1,-4,20,-80,0,0
"13506","8",336,3,4,1,3,-176,124,3,-2,222,112,2,-2,1,-2,-398,12,1,0
"13507","8",53,7,4,1,3,225,1,2,2,192,1,2,2,1,-6,33,0,0,0
"13508","8",11,4,4,1,1,29,-1,0,-1,72,30,1,1,1,-3,-43,-31,-1,-2
"13509","8",106,7,2,0,1,-163,-145,2,2,-123,-17,-1,-1,1,-6,-40,-128,3,3
"13510","8",102,8,4,1,3,132,61,2,3,120,-103,1,1,1,-7,12,164,1,2
"13511","8",468,7,1,0,3,105,-134,1,2,69,26,2,1,1,-6,36,-160,-1,1
"13512","8",172,8,2,0,3,103,155,3,3,-165,166,1,3,1,-7,268,-11,2,0
"13513","8",395,6,3,1,1,-220,30,-2,1,198,20,3,3,1,-5,-418,10,-5,-2
"13514","8",245,1,1,0,0,-247,65,-3,-4,-242,2,-3,-4,1,0,-5,63,0,0
"13515","8",339,3,3,1,1,-56,-97,-2,-2,-80,-38,-2,-3,1,-2,24,-59,0,1
"13516","8",457,9,3,0,1,218,0,4,4,13,-175,1,0,1,-8,205,175,3,4
"13517","8",234,4,3,1,3,133,28,0,-1,121,38,0,-1,1,-3,12,-10,0,0
"13518","8",45,3,3,1,0,-87,-29,-1,-2,60,-39,2,1,1,-2,-147,10,-3,-3
"13519","8",446,5,4,1,1,155,200,1,0,69,48,0,0,1,-4,86,152,1,0
"13520","8",94,1,4,0,1,-245,241,-4,-4,199,-219,0,2,1,0,-444,460,-4,-6
"13521","8",150,2,3,1,1,247,2,-3,-3,-249,1,0,0,1,-1,496,1,-3,-3
"13522","8",373,1,3,0,0,-249,-216,0,-4,132,-48,-1,-4,1,0,-381,-168,1,0
"13523","8",37,1,1,0,0,-204,24,-4,-4,-154,19,-3,-4,1,0,-50,5,-1,0
"13524","8",366,7,4,1,3,103,-59,3,2,-106,-57,2,3,1,-6,209,-2,1,-1
"13525","8",14,5,3,0,1,1,4,0,0,156,-27,2,2,1,-4,-155,31,-2,-2
"13526","8",136,1,1,0,0,-247,247,-4,-4,-249,245,-4,-4,1,0,2,2,0,0
"13527","8",212,2,1,0,1,-213,-34,4,-3,-220,30,4,-2,1,-1,7,-64,0,-1
"13528","8",72,3,1,0,0,-117,14,0,-2,143,148,2,2,1,-2,-260,-134,-2,-4
"13529","8",69,1,4,1,1,-35,22,-2,-4,24,-125,-3,-4,1,0,-59,147,1,0
"13530","8",201,2,3,1,1,20,1,3,-3,14,0,2,3,1,-1,6,1,1,-6
"13531","8",424,3,2,0,2,-90,-13,-2,-2,38,17,1,-1,1,-2,-128,-30,-3,-1
"13532","8",275,1,4,0,2,-238,8,-2,-4,-230,3,2,-2,1,0,-8,5,-4,-2
"13533","8",65,7,1,0,3,72,77,2,2,17,43,2,2,1,-6,55,34,0,0
"13534","8",417,5,2,0,2,0,-3,0,0,-15,-25,-3,-3,1,-4,15,22,3,3
"13535","8",340,4,1,0,1,-101,-29,0,-1,89,19,0,0,1,-3,-190,-48,0,-1
"13536","8",337,8,2,0,3,-25,17,3,3,235,-25,4,4,1,-7,-260,42,-1,-1
"13537","8",54,5,4,1,1,-240,-7,0,0,227,-18,0,0,1,-4,-467,11,0,0
"13538","8",110,7,1,0,1,-128,72,-4,2,47,-126,-4,1,1,-6,-175,198,0,1
"13539","8",107,6,2,1,3,140,163,-3,1,-186,-61,-1,2,1,-5,326,224,-2,-1
"13540","8",103,6,2,1,3,79,4,1,1,222,-4,2,2,1,-5,-143,8,-1,-1
"13541","8",469,1,4,0,0,-239,148,-3,-4,34,18,-2,-4,1,0,-273,130,-1,0
"13542","8",173,5,4,1,3,-210,5,0,0,222,3,0,0,1,-4,-432,2,0,0
"13543","8",396,1,1,0,1,-249,248,4,-4,-187,20,4,-4,1,0,-62,228,0,0
"13544","8",246,9,4,1,3,44,-1,3,4,-45,4,2,2,1,-8,89,-5,1,2
"13545","8",34,2,4,0,2,-164,97,-2,-3,-127,127,-2,-3,1,-1,-37,-30,0,0
"13546","8",458,2,1,0,1,-66,-71,0,-3,72,85,-1,-2,1,-1,-138,-156,1,-1
"13547","8",235,6,3,1,0,13,-2,1,1,18,0,1,1,1,-5,-5,-2,0,0
"13548","8",450,3,4,1,3,203,-5,1,-2,83,0,1,-2,1,-2,120,-5,0,0
"13549","8",447,4,4,1,2,-92,12,-2,-1,48,41,-1,-2,1,-3,-140,-29,-1,1
"13550","8",95,1,4,1,2,-245,1,-4,-4,-159,-4,-3,-3,1,0,-86,5,-1,-1
"13551","8",151,1,2,0,1,-235,10,0,-4,-241,10,0,-4,1,0,6,0,0,0
"13552","8",374,4,4,1,2,-62,-22,-1,-1,52,13,1,1,1,-3,-114,-35,-2,-2
"13553","8",298,1,1,0,0,-14,235,-4,-4,22,-226,1,2,1,0,-36,461,-5,-6
"13554","8",220,2,4,1,2,-231,71,-4,-3,128,122,-2,-2,1,-1,-359,-51,-2,-1
"13555","8",140,5,1,0,1,-23,62,-1,0,-11,-57,1,1,1,-4,-12,119,-2,-1
"13556","8",217,2,4,1,2,-47,22,-1,-3,28,33,1,-1,1,-1,-75,-11,-2,-2
"13557","8",213,5,2,1,1,31,2,0,0,0,35,-1,0,1,-4,31,-33,1,0
"13558","8",290,2,1,1,1,-188,-106,-3,-3,112,-117,1,-3,1,-1,-300,11,-4,0
"13559","8",206,1,4,1,0,160,-10,-3,-4,55,33,-2,2,1,0,105,-43,-1,-6
"13560","8",202,4,1,0,1,-20,106,-2,-1,14,33,-3,0,1,-3,-34,73,1,-1
"13561","8",425,5,4,1,2,-68,-80,0,0,-4,-17,0,0,1,-4,-64,-63,0,0
"13562","8",276,7,4,0,3,187,1,2,2,144,0,2,2,1,-6,43,1,0,0
"13563","8",126,1,2,1,2,-5,-3,-4,-4,25,43,-2,-3,1,0,-30,-46,-2,-1
"13564","8",122,2,1,0,0,0,0,-4,-3,210,226,4,4,1,-1,-210,-226,-8,-7
"13565","8",341,9,1,1,3,193,-57,4,4,224,-24,4,4,1,-8,-31,-33,0,0
"13566","8",192,4,4,1,1,102,-13,-2,-1,0,80,1,1,1,-3,102,-93,-3,-2
"13567","8",189,2,1,0,1,-236,32,2,-3,-200,52,3,-3,1,-1,-36,-20,-1,0
"13568","8",111,6,1,0,0,-92,-96,0,1,226,230,4,-2,1,-5,-318,-326,-4,3
"13569","8",185,1,4,1,2,-161,-18,-4,-4,61,-13,-3,2,1,0,-222,-5,-1,-6
"13570","8",181,6,4,0,3,-85,-49,1,1,-70,-91,0,0,1,-5,-15,42,1,1
"13571","8",178,5,1,0,1,-2,1,0,0,1,-1,0,0,1,-4,-3,2,0,0
"13572","8",174,6,4,1,3,57,46,0,1,60,-67,0,0,1,-5,-3,113,0,1
"13573","8",250,6,1,0,3,82,29,1,1,104,20,1,1,1,-5,-22,9,0,0
"13574","8",247,4,3,1,0,-238,-3,-1,-1,82,-12,0,0,1,-3,-320,9,-1,-1
"13575","8",243,3,2,0,2,-248,-77,-4,-2,-249,-149,-4,-2,1,-2,1,72,0,0
"13576","8",459,1,3,1,1,-78,-211,3,-4,-24,-154,3,-4,1,0,-54,-57,0,0
"13577","8",236,5,1,0,1,-3,1,0,0,-3,1,0,0,1,-4,0,0,0,0
"13578","8",16,3,1,0,0,-232,16,0,-2,38,15,1,-2,1,-2,-270,1,-1,0
"13579","8",156,5,2,0,1,0,1,0,0,40,0,1,1,1,-4,-40,1,-1,-1
"13580","8",96,3,1,0,0,-182,-4,-2,-2,-166,18,-3,-3,1,-2,-16,-22,1,1
"13581","8",152,1,1,0,0,-202,-2,-2,-4,-86,-1,0,-4,1,0,-116,-1,-2,0
"13582","8",375,4,3,1,1,-23,-1,-1,-1,-1,1,0,0,1,-3,-22,-2,-1,-1
"13583","8",299,6,4,0,1,207,-16,1,1,122,153,1,1,1,-5,85,-169,0,0
"13584","8",221,5,4,0,1,-3,-5,0,0,-6,9,0,1,1,-4,3,-14,0,-1
"13585","8",141,2,1,0,0,-39,-16,-2,-3,238,107,2,4,1,-1,-277,-123,-4,-7
"13586","8",218,8,4,1,3,-129,243,4,3,-18,233,4,3,1,-7,-111,10,0,0
"13587","8",214,9,1,0,3,226,-2,4,4,250,3,4,4,1,-8,-24,-5,0,0
"13588","8",291,5,4,1,2,-189,-98,0,0,-1,-43,-4,-4,1,-4,-188,-55,4,4
"13589","8",207,9,1,0,0,-249,1,-1,4,249,1,4,4,1,-8,-498,0,-5,0
"13590","8",203,9,4,1,3,229,14,4,4,213,16,4,4,1,-8,16,-2,0,0
"13591","8",426,9,4,0,3,2,-244,4,4,245,-1,4,4,1,-8,-243,-243,0,0
"13592","8",277,1,4,1,1,-41,86,4,-4,27,-90,0,0,1,0,-68,176,4,-4
"13593","8",127,1,1,0,0,-233,-1,-3,-4,0,1,2,-3,1,0,-233,-2,-5,-1
"13594","8",123,2,4,1,2,-198,41,-3,-3,-195,59,-3,-3,1,-1,-3,-18,0,0
"13595","8",342,5,3,1,1,-44,30,-1,0,-9,17,-2,-3,1,-4,-35,13,1,3
"13596","8",193,1,1,0,0,-235,-26,-4,-4,174,129,1,1,1,0,-409,-155,-5,-5
"13597","8",19,4,2,0,2,-154,-59,-1,-1,55,-35,-1,-2,1,-3,-209,-24,0,1
"13598","8",112,7,4,1,3,229,19,2,2,185,77,3,3,1,-6,44,-58,-1,-1
"13599","8",186,3,2,1,2,-38,11,0,-2,23,10,0,0,1,-2,-61,1,0,-2
"13600","8",182,7,4,1,3,-3,-76,2,2,-1,-192,2,2,1,-6,-2,116,0,0
"13601","8",179,5,1,0,1,0,1,0,0,-8,2,0,4,1,-4,8,-1,0,-4
"13602","8",175,3,4,1,1,-152,-56,-4,-2,-122,-93,-2,-1,1,-2,-30,37,-2,-1
"13603","8",251,4,3,1,1,12,12,0,-1,-4,-238,3,3,1,-3,16,250,-3,-4
"13604","8",248,4,4,1,3,-39,-33,-2,-1,231,206,3,4,1,-3,-270,-239,-5,-5
"13605","8",244,1,4,0,2,-181,-198,0,-4,-29,-60,-1,-3,1,0,-152,-138,1,-1
"13606","8",46,1,1,0,0,-36,-239,-4,-4,106,-29,4,4,1,0,-142,-210,-8,-8
"13607","8",237,5,2,0,2,-239,1,-2,0,102,2,-1,1,1,-4,-341,-1,-1,-1
"13608","8",160,7,2,0,0,-217,32,-4,2,0,1,-4,2,1,-6,-217,31,0,0
"13609","8",157,8,3,0,2,137,55,3,3,136,79,-2,0,1,-7,1,-24,5,3
"13610","8",97,1,1,0,1,-234,9,3,-4,-231,13,3,-3,1,0,-3,-4,0,-1
"13611","8",153,6,1,0,3,-46,-79,0,1,-5,1,1,1,1,-5,-41,-80,-1,0
"13612","8",376,4,4,1,1,14,-166,-1,-1,64,-161,-1,-1,1,-3,-50,-5,0,0
"13613","8",3,1,3,0,0,-216,224,-4,-4,-70,65,-3,-3,1,0,-146,159,-1,-1
"13614","8",222,2,1,0,0,0,0,-3,-3,-245,6,-4,-4,1,-1,245,-6,1,1
"13615","8",142,5,2,0,2,-218,15,-4,0,-201,11,-4,1,1,-4,-17,4,0,-1
"13616","8",219,5,4,1,3,249,1,4,0,0,-248,4,0,1,-4,249,249,0,0
"13617","8",215,2,1,0,0,-158,48,-2,-3,-135,60,-2,-3,1,-1,-23,-12,0,0
"13618","8",292,6,3,1,1,116,9,1,1,5,-16,0,0,1,-5,111,25,1,1
"13619","8",208,5,4,1,2,-184,-212,0,0,75,-230,0,0,1,-4,-259,18,0,0
"13620","8",204,5,3,0,1,53,-40,0,0,120,-102,0,0,1,-4,-67,62,0,0
"13621","8",427,1,4,1,1,-247,-46,4,-4,-246,-36,4,-4,1,0,-1,-10,0,0
"13622","8",278,1,4,1,1,-221,-221,4,-4,0,-220,4,-4,1,0,-221,-1,0,0
"13623","8",128,7,1,0,3,221,2,2,2,221,2,0,2,1,-6,0,0,2,0
"13624","8",124,6,1,0,3,232,61,4,1,242,2,3,2,1,-5,-10,59,1,-1
"13625","8",343,3,2,0,2,-108,3,-2,-2,-8,6,-1,-1,1,-2,-100,-3,-1,-1
"13626","8",194,9,1,0,0,-231,-80,-4,4,-239,-69,-4,4,1,-8,8,-11,0,0
"13627","8",190,7,4,1,3,185,130,2,2,209,219,2,2,1,-6,-24,-89,0,0
"13628","8",113,2,2,0,2,-114,-56,-3,-3,-193,12,-2,-2,1,-1,79,-68,-1,-1
"13629","8",187,5,4,1,2,6,0,0,0,18,0,1,1,1,-4,-12,0,-1,-1
"13630","8",183,6,4,1,1,-15,29,1,1,21,239,2,-4,1,-5,-36,-210,-1,5
"13631","8",18,3,3,0,1,-46,-152,1,-2,47,19,0,-2,1,-2,-93,-171,1,0
"13632","8",176,8,1,0,1,-85,1,-3,3,163,-1,0,2,1,-7,-248,2,-3,1
"13633","8",252,4,4,1,1,-149,-195,-1,-1,109,129,1,1,1,-3,-258,-324,-2,-2
"13634","8",249,1,3,1,0,-60,-65,-4,-4,35,-38,1,-4,1,0,-95,-27,-5,0
"13635","8",1,3,1,0,1,-153,-158,-2,-2,-123,-70,-1,-1,1,-2,-30,-88,-1,-1
"13636","8",460,1,1,0,0,-188,14,-4,-4,187,31,-3,1,1,0,-375,-17,-1,-5
"13637","8",238,7,3,1,1,-66,-68,-3,2,178,98,4,2,1,-6,-244,-166,-7,0
"13638","8",161,1,2,0,2,-245,184,-4,-4,93,41,1,-4,1,0,-338,143,-5,0
"13639","8",158,1,3,0,0,-239,-15,-4,-4,-236,-19,-4,-4,1,0,-3,4,0,0
"13640","8",98,1,3,0,0,-238,-19,-4,-4,235,238,4,4,1,0,-473,-257,-8,-8
"13641","8",154,6,4,1,3,120,-144,1,1,47,-108,1,1,1,-5,73,-36,0,0
"13642","8",377,1,1,0,0,-240,8,-4,-4,-241,7,-4,-4,1,0,1,1,0,0
"13643","8",30,5,2,0,2,33,3,1,0,-127,1,4,1,1,-4,160,2,-3,-1
"13644","8",223,5,1,0,1,2,1,0,0,2,1,0,0,1,-4,0,0,0,0
"13645","8",143,8,1,0,3,144,-10,3,3,156,-44,4,3,1,-7,-12,34,-1,0
"13646","8",22,5,3,0,1,-230,11,0,0,12,-241,4,4,1,-4,-242,252,-4,-4
"13647","8",216,4,3,1,1,-73,-46,1,-1,-124,-124,1,1,1,-3,51,78,0,-2
"13648","8",293,1,4,1,0,-218,19,-4,-4,-227,13,-4,-4,1,0,9,6,0,0
"13649","8",209,8,4,1,3,112,12,2,3,5,-250,1,2,1,-7,107,262,1,1
"13650","8",205,4,1,1,2,-123,1,-1,-1,217,1,3,3,1,-3,-340,0,-4,-4
"13651","8",428,1,1,0,0,-245,240,-4,-4,-249,245,-4,-4,1,0,4,-5,0,0
"13652","8",279,6,4,1,3,-110,-20,3,1,15,-30,2,1,1,-5,-125,10,1,0
"13653","8",129,5,4,1,1,130,5,1,0,131,5,1,1,1,-4,-1,0,0,-1
"13654","8",125,4,4,1,0,-128,-34,-3,-1,-94,-21,-4,-1,1,-3,-34,-13,1,0
"13655","8",344,6,4,1,3,139,-22,2,1,-38,-35,4,-1,1,-5,177,13,-2,2
"13656","8",195,1,1,0,1,-180,190,4,-4,94,-108,3,1,1,0,-274,298,1,-5
"13657","8",191,3,1,0,0,-135,-79,-2,-2,-193,-43,-2,-3,1,-2,58,-36,0,1
"13658","8",114,9,4,0,1,-48,-35,0,4,93,101,1,-3,1,-8,-141,-136,-1,7
"13659","8",188,8,2,0,3,208,0,3,3,216,-2,3,3,1,-7,-8,2,0,0
"13660","8",184,7,3,1,3,93,-4,1,2,93,-6,1,1,1,-6,0,2,0,1
"13661","8",180,3,2,0,2,-119,-7,-2,-2,-187,0,-1,0,1,-2,68,-7,-1,-2
"13662","8",177,4,4,1,1,28,219,0,-1,-34,47,1,-4,1,-3,62,172,-1,3
"13663","8",253,9,3,1,3,213,211,4,4,221,222,4,4,1,-8,-8,-11,0,0
"13664","8",25,1,4,1,2,-148,-129,-4,-4,-85,-108,-4,-4,1,0,-63,-21,0,0
"13665","8",10,3,3,1,1,-11,-2,-1,-2,2,1,0,0,1,-2,-13,-3,-1,-2
"13666","8",461,1,4,0,2,17,19,0,-4,27,22,-2,-4,1,0,-10,-3,2,0
"13667","8",239,1,1,0,1,-199,2,-4,-4,60,3,1,1,1,0,-259,-1,-5,-5
"13668","8",162,9,3,0,3,237,41,4,4,152,124,4,4,1,-8,85,-83,0,0
"13669","8",159,2,3,1,2,244,9,-3,-3,228,3,4,3,1,-1,16,6,-7,-6
"13670","8",99,9,4,1,3,30,226,3,4,210,-14,2,2,1,-8,-180,240,1,2
"13671","8",155,5,2,0,1,-2,11,0,0,-3,2,0,0,1,-4,1,9,0,0
"13672","8",378,4,4,1,1,-89,-2,-1,-1,-111,-2,-4,-1,1,-3,22,0,3,0
"13673","8",300,2,1,1,0,-194,35,-2,-3,20,38,1,1,1,-1,-214,-3,-3,-4
"13674","8",224,3,2,1,2,-139,-41,-2,-2,194,72,2,1,1,-2,-333,-113,-4,-3
"13675","8",346,6,3,1,0,-249,-94,-4,1,239,-1,2,2,1,-5,-488,-93,-6,-1
"13676","8",197,9,4,0,3,111,21,2,4,87,-44,2,4,1,-8,24,65,0,0
"13677","8",12,9,4,1,3,-2,0,4,4,-1,0,4,4,1,-8,-1,0,0,0
"13678","8",294,7,1,0,3,226,5,2,2,-1,2,0,2,1,-6,227,3,2,0
"13679","8",314,1,4,0,1,-244,14,4,-4,-235,11,4,-4,1,0,-9,3,0,0
"13680","8",287,7,4,1,3,116,1,2,2,3,9,1,1,1,-6,113,-8,1,1
"13681","8",283,5,1,0,1,-126,38,-3,0,-71,-125,-2,1,1,-4,-55,163,-1,-1
"13682","8",28,3,4,0,1,-203,18,-2,-2,85,61,-2,-2,1,-2,-288,-43,0,0
"13683","8",13,1,4,0,1,-68,-59,0,-4,-111,47,-1,-4,1,0,43,-106,1,0
"13684","8",349,4,4,1,1,-52,-65,0,-1,-159,-109,-1,-2,1,-3,107,44,1,1
"13685","8",345,7,1,0,0,-184,34,-4,2,-196,77,-4,2,1,-6,12,-43,0,0
"13686","8",196,1,3,1,0,1,-30,-4,-4,114,123,1,4,1,0,-113,-153,-5,-8
"13687","8",119,7,3,1,3,85,109,1,2,-98,-96,2,2,1,-6,183,205,-1,0
"13688","8",115,6,3,1,3,-4,4,0,1,-240,2,-1,2,1,-5,236,2,1,-1
"13689","8",313,2,3,1,0,-209,-178,-4,-3,-214,-213,-3,-3,1,-1,5,35,-1,0
"13690","8",31,3,1,0,0,-134,-66,-2,-2,-186,95,-2,-2,1,-2,52,-161,0,0
"13691","8",261,9,1,0,3,210,191,4,4,210,214,4,4,1,-8,0,-23,0,0
"13692","8",258,1,3,1,0,-33,0,-4,-4,-64,-1,-3,-4,1,0,31,1,-1,0
"13693","8",254,6,2,0,3,74,-19,3,1,182,-104,-3,-1,1,-5,-108,85,6,2
"13694","8",226,1,1,0,0,-65,1,-2,-4,170,3,2,-4,1,0,-235,-2,-4,0
"13695","8",327,6,4,0,3,31,-163,2,1,20,76,1,-1,1,-5,11,-239,1,2
"13696","8",323,1,4,1,1,-45,3,-4,-4,144,-1,0,-4,1,0,-189,4,-4,0
"13697","8",24,1,2,0,2,-245,1,0,-4,241,3,0,4,1,0,-486,-2,0,-8
"13698","8",163,4,3,1,1,-27,-103,2,-1,-33,-104,2,0,1,-3,6,1,0,-1
"13699","8",312,5,4,1,1,-52,70,0,0,-54,-144,-1,-1,1,-4,2,214,1,1
"13700","8",309,3,4,1,2,-54,39,-1,-2,198,161,0,-2,1,-2,-252,-122,-1,0
"13701","8",382,4,4,1,2,-89,2,-1,-1,0,2,0,0,1,-3,-89,0,-1,-1
"13702","8",379,3,3,0,1,32,-63,-1,-2,85,61,1,0,1,-2,-53,-124,-2,-2
"13703","8",301,7,4,1,1,1,-80,2,2,-103,0,2,2,1,-6,104,-80,0,0
"13704","8",225,4,2,1,2,58,-75,1,-1,88,-60,1,1,1,-3,-30,-15,0,-2
"13705","8",347,6,1,0,3,116,-143,2,1,-167,111,1,-4,1,-5,283,-254,1,5
"13706","8",198,3,1,0,1,-186,138,-1,-2,2,-30,0,1,1,-2,-188,168,-1,-3
"13707","8",120,4,3,0,1,-50,-50,-1,-1,79,-22,0,0,1,-3,-129,-28,-1,-1
"13708","8",295,5,1,0,1,1,1,0,0,1,-1,0,0,1,-4,0,2,0,0
"13709","8",315,9,3,1,3,242,13,4,4,233,13,4,4,1,-8,9,0,0,0
"13710","8",288,7,2,0,2,-111,65,1,2,-96,67,0,1,1,-6,-15,-2,1,1
"13711","8",284,2,3,1,1,-111,-153,0,-3,-160,-119,-3,-4,1,-1,49,-34,3,1
"13712","8",280,6,2,0,1,-176,-1,2,1,2,167,-2,2,1,-5,-178,-168,4,-1
"13713","8",130,9,1,0,3,198,21,4,4,86,-52,4,4,1,-8,112,73,0,0
"13714","8",35,3,1,0,3,49,158,2,-2,121,140,2,-2,1,-2,-72,18,0,0
"13715","8",329,1,4,1,3,32,11,-3,-4,114,57,-1,3,1,0,-82,-46,-2,-7
"13716","8",325,9,1,0,1,-29,-42,-1,4,-64,-58,-2,4,1,-8,35,16,1,0
"13717","8",241,3,4,1,2,99,31,1,-2,188,173,2,0,1,-2,-89,-142,-1,-2
"13718","8",116,8,2,0,3,87,-57,1,3,122,-10,2,2,1,-7,-35,-47,-1,1
"13719","8",318,1,2,0,2,-194,191,-4,-4,181,186,-4,0,1,0,-375,5,0,-4
"13720","8",310,1,4,1,2,-164,4,-4,-4,76,-2,2,-1,1,0,-240,6,-6,-3
"13721","8",262,7,4,1,3,71,72,1,2,121,121,1,2,1,-6,-50,-49,0,0
"13722","8",259,1,3,0,1,-125,57,4,-4,-3,-1,2,-4,1,0,-122,58,2,0
"13723","8",255,5,3,0,1,-106,-108,0,0,-152,-144,0,0,1,-4,46,36,0,0
"13724","8",227,7,3,0,3,-117,-12,0,2,-159,-48,1,2,1,-6,42,36,-1,0
"13725","8",328,4,3,1,1,-38,11,-1,-1,8,9,1,1,1,-3,-46,2,-2,-2
"13726","8",324,1,2,0,0,-239,4,-4,-4,-186,2,-3,-3,1,0,-53,2,-1,-1
"13727","8",240,7,2,1,1,167,11,0,2,107,9,1,-1,1,-6,60,2,-1,3
"13728","8",164,6,2,1,2,8,-25,1,1,-148,-42,-3,-3,1,-5,156,17,4,4
"13729","8",317,1,4,1,2,-188,200,-4,-4,-191,187,-4,-4,1,0,3,13,0,0
"13730","8",29,1,4,1,0,-199,96,-4,-4,240,204,-2,-1,1,0,-439,-108,-2,-3
"13731","8",383,5,4,1,1,1,3,0,0,1,3,0,0,1,-4,0,0,0,0
"13732","8",38,5,4,1,3,6,-15,0,0,6,-15,0,0,1,-4,0,0,0,0
"13733","8",302,3,1,0,0,-139,-25,-3,-2,217,216,-4,-2,1,-2,-356,-241,1,0
"13734","8",351,1,1,0,0,-246,-246,-4,-4,244,244,-4,-4,1,0,-490,-490,0,0
"13735","8",348,2,3,0,1,-78,-1,0,-3,54,44,0,-2,1,-1,-132,-45,0,-1
"13736","8",199,2,4,1,2,-232,34,0,-3,-105,15,-1,-1,1,-1,-127,19,1,-2
"13737","8",121,1,1,0,0,-242,234,-4,-4,238,-234,4,-4,1,0,-480,468,-8,0
"13738","8",296,6,1,0,3,-37,-3,1,1,20,195,2,2,1,-5,-57,-198,-1,-1
"13739","8",316,4,3,1,0,-136,-67,-1,-1,-129,-100,-1,-1,1,-3,-7,33,0,0
"13740","8",289,8,1,0,3,150,145,3,3,213,231,3,3,1,-7,-63,-86,0,0
"13741","8",285,6,2,0,1,-122,113,-2,1,-141,130,-4,-2,1,-5,19,-17,2,3
"13742","8",281,1,4,1,2,-234,2,-4,-4,-245,3,-4,-4,1,0,11,-1,0,0
"13743","8",131,7,4,0,3,-148,194,-4,2,23,0,0,2,1,-6,-171,194,-4,0
"13744","8",350,1,4,1,1,-244,7,-4,-4,247,-4,4,2,1,0,-491,11,-8,-6
"13745","8",33,7,3,1,1,1,0,-1,2,-126,-22,-3,1,1,-6,127,22,2,1
"13746","8",326,2,4,1,2,-196,-150,-3,-3,-224,-107,-2,-2,1,-1,28,-43,-1,-1
"13747","8",242,3,4,0,2,-25,-1,-1,-2,-22,0,-1,-3,1,-2,-3,-1,0,1
"13748","8",117,3,4,1,2,-169,-1,-2,-2,-119,-4,-3,-3,1,-2,-50,3,1,1
"13749","8",319,6,1,0,1,75,8,2,1,-138,2,-1,-1,1,-5,213,6,3,2
"13750","8",311,1,2,0,2,-176,-1,-4,-4,200,17,4,-4,1,0,-376,-18,-8,0
"13751","8",263,1,4,1,0,-246,-5,-3,-4,-242,-4,-4,-4,1,0,-4,-1,1,0
"13752","8",26,1,1,0,0,-210,-42,-4,-4,-220,-157,-4,-4,1,0,10,115,0,0
"13753","8",256,6,3,1,1,75,1,1,1,87,23,1,1,1,-5,-12,-22,0,0
"13754","8",228,1,4,1,2,-81,-149,-4,-4,18,43,4,4,1,0,-99,-192,-8,-8
"13755","8",297,1,3,1,2,-35,57,1,-4,-182,132,2,-4,1,0,147,-75,-1,0
"13756","8",260,2,3,1,0,-237,-240,-3,-3,-221,-221,-2,-2,1,-1,-16,-19,-1,-1
"13757","8",390,1,2,0,2,-247,169,-4,-4,249,230,4,4,1,0,-496,-61,-8,-8
"13758","8",165,5,1,0,1,64,37,0,0,80,103,1,1,1,-4,-16,-66,-1,-1
"13759","8",282,9,3,0,3,31,-75,1,4,164,85,1,4,1,-8,-133,-160,0,0
"13760","8",391,5,2,0,3,148,109,1,0,96,79,0,0,1,-4,52,30,1,0
"13761","8",384,1,1,0,0,-233,106,-2,-4,0,1,0,-4,1,0,-233,105,-2,0
"13762","8",380,3,4,0,1,-216,-47,3,-2,-192,-109,3,-3,1,-2,-24,62,0,1
"13763","8",303,1,3,1,2,-198,-196,-4,-4,-165,-150,-2,-3,1,0,-33,-46,-2,-1
"13764","8",352,4,2,0,1,13,-93,0,-1,18,-111,0,-1,1,-3,-5,18,0,0
"13765","8",118,5,3,1,1,-29,18,-2,0,1,-17,-2,1,1,-4,-30,35,0,-1
"13766","8",381,1,2,0,2,-215,-201,-4,-4,194,195,4,4,1,0,-409,-396,-8,-8
"13767","8",39,4,3,1,1,17,-10,1,-1,234,242,4,4,1,-3,-217,-252,-3,-5
"13768","8",264,1,4,0,2,0,0,-4,-4,-236,-238,-2,-4,1,0,236,238,-2,0
"13769","8",320,1,2,0,2,-247,126,-4,-4,-248,137,-4,-4,1,0,1,-11,0,0
"13770","8",257,1,1,0,0,-228,17,-4,-4,43,17,2,-4,1,0,-271,0,-6,0
"13771","8",286,6,1,0,3,79,-7,0,1,56,-4,0,1,1,-5,23,-3,0,0
"13772","8",321,2,1,0,0,-204,-242,-3,-3,-55,-42,-2,-3,1,-1,-149,-200,-1,0
"13773","8",132,6,4,1,1,-63,-5,-1,1,67,-9,1,1,1,-5,-130,4,-2,0
"13774","8",23,9,1,0,3,209,221,4,4,210,211,4,4,1,-8,-1,10,0,0
"13775","8",166,2,4,1,2,-49,-16,1,-3,174,164,-1,1,1,-1,-223,-180,2,-4
"13776","8",36,9,3,1,3,186,-68,4,4,100,-52,3,-2,1,-8,86,-16,1,6
"13777","8",392,3,1,0,0,-146,54,-2,-2,-131,77,-2,-2,1,-2,-15,-23,0,0
"13778","8",385,4,4,1,1,-37,-80,-1,-1,-129,-90,0,0,1,-3,92,10,-1,-1
"13779","8",32,5,1,0,1,-11,-1,0,0,186,-192,1,-4,1,-4,-197,191,-1,4
"13780","8",304,4,2,0,2,122,-31,-2,-1,31,-34,1,1,1,-3,91,3,-3,-2
"13781","8",353,4,2,0,2,-241,47,-4,-1,230,116,-4,1,1,-3,-471,-69,0,-2
"13782","8",386,1,1,0,0,-247,197,-4,-4,-2,9,-1,-2,1,0,-245,188,-3,-2
"13783","8",361,1,1,0,0,-249,0,-3,-4,1,219,4,4,1,0,-250,-219,-7,-8
"13784","8",229,7,1,0,1,123,-39,2,2,60,43,2,2,1,-6,63,-82,0,0
"13785","8",387,1,3,1,1,-204,-189,-3,-4,172,175,2,3,1,0,-376,-364,-5,-7
"13786","8",362,2,4,1,3,-186,103,4,-3,89,82,2,-1,1,-1,-275,21,2,-2
"13787","8",306,5,3,1,3,126,137,1,0,116,145,1,0,1,-4,10,-8,0,0
"13788","8",388,4,4,1,0,-239,4,1,-1,-241,4,1,-1,1,-3,2,0,0,0
"13789","8",322,5,4,1,3,-1,1,0,0,187,-182,2,2,1,-4,-188,183,-2,-2
"13790","8",356,6,4,1,1,63,1,1,1,131,6,2,2,1,-5,-68,-5,-1,-1
"13791","8",230,4,1,0,0,-245,16,-4,-1,-243,13,-4,-1,1,-3,-2,3,0,0
"13792","8",389,2,3,1,2,140,-22,-3,-3,70,-2,1,1,1,-1,70,-20,-4,-4
"13793","8",360,1,3,0,0,-208,-51,0,-4,68,56,0,-4,1,0,-276,-107,0,0
"13794","8",393,1,1,0,0,-212,-60,-4,-4,-56,-172,-4,-4,1,0,-156,112,0,0
"13795","8",231,6,4,1,0,-224,0,-4,1,-233,3,-4,2,1,-5,9,-3,0,-1
"13796","8",307,1,4,1,2,0,0,-4,-4,-176,236,-4,-4,1,0,176,-236,0,0
"13797","8",394,1,3,0,0,-249,245,-4,-4,-250,247,-4,-4,1,0,1,-2,0,0
"13798","8",354,2,1,0,0,-235,239,-2,-3,171,137,2,3,1,-1,-406,102,-4,-6
"13799","8",357,5,4,1,2,-205,-12,-1,0,181,78,4,-4,1,-4,-386,-90,-5,4
"13800","8",308,1,4,0,0,-247,-246,-4,-4,247,247,2,3,1,0,-494,-493,-6,-7
"13801","8",355,1,2,0,2,-213,184,-4,-4,-191,140,-4,-3,1,0,-22,44,0,-1
"13802","8",305,6,4,1,3,-4,69,1,1,-16,33,1,1,1,-5,12,36,0,0
"13803","8",358,1,4,0,2,-245,223,-4,-4,-239,196,-4,-4,1,0,-6,27,0,0
"13804","8",359,2,4,0,3,-169,-26,4,-3,222,27,4,3,1,-1,-391,-53,0,-6
"13805","9",140,5,1,0,1,-23,-35,0,0,-99,64,0,0,1,-4,76,-99,0,0
"13806","9",147,8,2,0,3,42,118,1,3,-146,-117,2,-1,1,-7,188,235,-1,4
"13807","9",145,5,1,0,1,1,3,0,0,-36,-70,0,0,1,-4,37,73,0,0
"13808","9",141,1,1,0,0,-193,-232,-3,-4,-243,-241,-4,-4,1,0,50,9,1,0
"13809","9",447,3,4,1,2,-84,6,-2,-2,112,2,1,-1,1,-2,-196,4,-3,-1
"13810","9",146,2,2,0,0,-177,-169,-3,-3,-174,-167,-3,-3,1,-1,-3,-2,0,0
"13811","9",142,4,2,1,2,-190,19,-4,-1,-125,23,-4,1,1,-3,-65,-4,0,-2
"13812","9",116,7,2,0,3,146,3,2,2,118,10,2,0,1,-6,28,-7,0,2
"13813","9",112,8,4,1,3,173,57,3,3,236,-16,3,3,1,-7,-63,73,0,0
"13814","9",143,8,1,0,3,83,43,3,3,55,-110,3,3,1,-7,28,153,0,0
"13815","9",134,6,2,0,2,0,-3,0,1,2,-12,1,0,1,-5,-2,9,-1,1
"13816","9",170,1,2,0,0,-242,-245,-4,-4,10,12,0,0,1,0,-252,-257,-4,-4
"13817","9",150,5,3,0,1,4,4,0,0,161,3,1,0,1,-4,-157,1,-1,0
"13818","9",135,5,1,0,1,-167,-51,0,0,-220,-18,1,1,1,-4,53,-33,-1,-1
"13819","9",349,6,4,1,1,-1,-5,0,1,104,80,2,3,1,-5,-105,-85,-2,-2
"13820","9",148,1,1,0,1,-186,-72,2,-4,-187,-82,2,-4,1,0,1,10,0,0
"13821","9",144,1,3,1,0,-73,-240,-4,-4,-2,-245,-4,-4,1,0,-71,5,0,0
"13822","9",136,1,1,0,0,-181,210,-4,-4,-242,239,-4,-4,1,0,61,-29,0,0
"13823","9",443,4,1,0,0,-109,9,-1,-1,62,9,1,1,1,-3,-171,0,-2,-2
"13824","9",133,4,2,0,1,219,-211,1,-1,38,9,1,-1,1,-3,181,-220,0,0
"13825","9",152,1,1,0,0,-90,-7,-3,-4,-19,-1,-2,-4,1,0,-71,-6,-1,0
"13826","9",448,9,2,0,2,241,-6,4,4,198,1,2,4,1,-8,43,-7,2,0
"13827","9",15,8,4,1,3,137,32,2,3,73,63,2,3,1,-7,64,-31,0,0
"13828","9",100,8,4,1,3,186,-1,3,3,-2,-49,2,2,1,-7,188,48,1,1
"13829","9",117,1,4,1,2,-240,5,-3,-4,-99,2,-2,-3,1,0,-141,3,-1,-1
"13830","9",167,7,1,0,3,108,-107,2,2,-187,-131,-2,-2,1,-6,295,24,4,4
"13831","9",2,4,4,1,1,-47,-29,-4,-1,2,1,1,-1,1,-3,-49,-30,-5,0
"13832","9",118,6,3,1,1,-101,21,-2,1,-16,-18,-2,1,1,-5,-85,39,0,0
"13833","9",345,8,1,0,0,-216,16,-4,3,-229,13,-4,2,1,-7,13,3,0,1
"13834","9",115,5,3,0,3,-2,-7,0,0,69,-2,0,0,1,-4,-71,-5,0,0
"13835","9",20,3,3,0,0,-222,-235,-4,-2,61,65,0,0,1,-2,-283,-300,-4,-2
"13836","9",35,2,1,1,3,68,169,3,-3,132,130,2,-1,1,-1,-64,39,1,-2
"13837","9",149,7,3,0,1,-247,3,-3,2,245,4,-2,1,1,-6,-492,-1,-1,1
"13838","9",44,1,2,0,2,-234,135,-3,-4,206,-63,-2,-4,1,0,-440,198,-1,0
"13839","9",137,2,1,0,1,-243,239,3,-3,243,243,1,-3,1,-1,-486,-4,2,0
"13840","9",444,1,2,0,2,-247,1,-4,-4,-250,1,-4,-4,1,0,3,0,0,0
"13841","9",21,2,4,0,2,-128,-109,-2,-3,116,75,0,-2,1,-1,-244,-184,-2,-1
"13842","9",331,1,1,0,0,-227,-240,-4,-4,-248,-247,-4,-4,1,0,21,7,0,0
"13843","9",113,2,2,0,2,-55,36,-3,-3,-179,-39,-2,-2,1,-1,124,75,-1,-1
"13844","9",175,6,4,1,1,-97,58,0,1,-56,-13,-3,-1,1,-5,-41,71,3,2
"13845","9",101,1,3,1,0,-233,234,-4,-4,212,225,-3,-3,1,0,-445,9,-1,-1
"13846","9",171,6,1,0,1,90,45,1,1,24,22,0,0,1,-5,66,23,1,1
"13847","9",151,1,2,0,1,-240,10,0,-4,-243,12,0,-4,1,0,3,-2,0,0
"13848","9",341,9,1,0,3,248,-42,4,4,240,-22,3,4,1,-8,8,-20,1,0
"13849","9",119,7,3,1,3,72,-25,1,2,76,106,1,2,1,-6,-4,-131,0,0
"13850","9",346,7,3,1,0,-249,-189,-4,2,239,0,3,3,1,-6,-488,-189,-7,-1
"13851","9",334,1,4,1,0,-219,0,-4,-4,-241,18,-4,1,1,0,22,-18,0,-5
"13852","9",330,5,2,0,2,-245,-1,0,0,192,142,1,1,1,-4,-437,-143,-1,-1
"13853","9",213,6,2,0,1,-4,156,1,1,2,-26,1,0,1,-5,-6,182,0,1
"13854","9",174,6,4,1,3,43,-12,0,1,26,93,1,1,1,-5,17,-105,-1,0
"13855","9",153,8,1,0,3,-105,-16,0,3,-76,-21,1,1,1,-7,-29,5,-1,2
"13856","9",449,6,4,1,3,13,80,1,1,1,81,1,1,1,-5,12,-1,0,0
"13857","9",445,7,4,1,3,182,-28,2,2,80,-35,2,2,1,-6,102,7,0,0
"13858","9",441,4,4,0,2,-200,-17,-3,-1,-166,-25,-3,-2,1,-3,-34,8,0,1
"13859","9",139,1,4,1,2,-241,0,-4,-4,-233,0,-4,-4,1,0,-8,0,0,0
"13860","9",168,6,1,0,3,91,-88,1,1,153,-145,2,3,1,-5,-62,57,-1,-2
"13861","9",211,7,3,1,1,20,22,-4,2,18,24,-1,2,1,-6,2,-2,-3,0
"13862","9",232,1,1,0,0,-246,-245,-4,-4,-244,-244,-4,-4,1,0,-2,-1,0,0
"13863","9",111,2,1,0,0,-118,-136,-2,-3,56,-62,2,-1,1,-1,-174,-74,-4,-2
"13864","9",177,3,4,1,1,-226,-54,1,-2,55,132,3,-2,1,-2,-281,-186,-2,0
"13865","9",200,1,3,1,0,-238,-155,-4,-4,-229,-39,-4,-4,1,0,-9,-116,0,0
"13866","9",350,5,4,1,1,-245,6,-1,0,-4,-245,1,0,1,-4,-241,251,-2,0
"13867","9",347,6,1,0,3,170,-83,2,1,106,-121,2,1,1,-5,64,38,0,0
"13868","9",440,2,3,0,0,-171,-3,-3,-3,-164,2,-3,-3,1,-1,-7,-5,0,0
"13869","9",138,6,3,0,1,89,-22,1,1,41,-22,0,0,1,-5,48,0,1,1
"13870","9",214,9,1,0,3,215,5,4,4,219,6,4,4,1,-8,-4,-1,0,0
"13871","9",210,3,4,0,2,-197,-16,1,-2,-198,65,1,-1,1,-2,1,-81,0,-1
"13872","9",332,1,1,0,0,-249,73,-4,-4,-250,103,-3,-3,1,0,1,-30,-1,-1
"13873","9",114,6,4,1,1,48,21,1,1,94,85,1,-3,1,-5,-46,-64,0,4
"13874","9",176,8,1,0,1,-168,-23,-3,3,195,4,-2,1,1,-7,-363,-27,-1,2
"13875","9",102,6,4,1,3,-127,-101,1,1,-219,-109,3,3,1,-5,92,8,-2,-2
"13876","9",172,8,2,0,3,-1,166,3,3,-140,140,3,3,1,-7,139,26,0,0
"13877","9",169,1,3,1,0,-221,229,-4,-4,-247,233,-4,-4,1,0,26,-4,0,0
"13878","9",342,4,3,1,1,-17,-12,0,-1,-20,27,-1,0,1,-3,3,-39,1,-1
"13879","9",12,9,4,1,3,-1,-1,4,4,-1,0,4,4,1,-8,0,-1,0,0
"13880","9",339,2,3,1,1,-74,-73,-4,-3,-141,-74,-2,-2,1,-1,67,1,-2,-1
"13881","9",335,4,2,0,1,-69,33,-1,-1,26,24,2,-1,1,-3,-95,9,-3,0
"13882","9",234,4,3,1,3,139,42,1,-1,143,20,0,-1,1,-3,-4,22,1,0
"13883","9",182,6,4,0,3,5,-106,2,1,-1,-169,2,2,1,-5,6,63,0,-1
"13884","9",179,5,1,0,1,-1,-5,0,0,-4,168,2,-1,1,-4,3,-173,-2,1
"13885","9",154,6,4,1,3,117,-7,1,1,145,-111,1,1,1,-5,-28,104,0,0
"13886","9",45,3,3,1,0,-72,-22,-2,-2,-22,-33,1,-1,1,-2,-50,11,-3,-1
"13887","9",446,4,4,1,1,82,31,0,-1,85,55,0,0,1,-3,-3,-24,0,-1
"13888","9",442,6,4,1,1,-32,28,-1,1,42,57,1,1,1,-5,-74,-29,-2,0
"13889","9",14,2,3,0,1,-18,-2,0,-3,165,-37,3,2,1,-1,-183,35,-3,-5
"13890","9",338,1,3,1,2,112,106,-4,-4,92,-170,-2,1,1,0,20,276,-2,-5
"13891","9",212,3,1,0,1,-98,-148,4,-2,-201,-148,4,-3,1,-2,103,0,0,1
"13892","9",233,5,2,0,2,-235,24,0,0,-66,12,0,0,1,-4,-169,12,0,0
"13893","9",181,3,4,1,3,-77,109,-4,-2,-86,-53,-2,1,1,-2,9,162,-2,-3
"13894","9",178,5,1,0,1,1,4,0,0,1,-2,0,0,1,-4,0,6,0,0
"13895","9",201,2,3,1,1,-38,0,2,-3,43,1,1,-3,1,-1,-81,-1,1,0
"13896","9",351,1,1,0,0,-247,-247,-4,-4,246,245,-4,-4,1,0,-493,-492,0,0
"13897","9",348,2,3,1,1,4,0,-4,-3,68,44,0,-2,1,-1,-64,-44,-4,-1
"13898","9",344,6,4,0,3,181,-28,2,1,-140,-64,1,1,1,-5,321,36,1,0
"13899","9",121,1,1,0,0,-213,161,-4,-4,238,-229,4,-4,1,0,-451,390,-8,0
"13900","9",215,2,1,0,0,-154,52,-2,-3,-133,52,-2,-3,1,-1,-21,0,0,0
"13901","9",337,7,2,0,3,-38,22,2,2,234,-18,4,4,1,-6,-272,40,-2,-2
"13902","9",333,5,4,1,1,-112,-126,-1,0,105,56,-1,-1,1,-4,-217,-182,0,1
"13903","9",184,7,3,0,3,164,1,2,2,142,-3,2,3,1,-6,22,4,0,-1
"13904","9",180,3,2,1,2,17,-5,0,-2,-89,-2,-2,-3,1,-2,106,-3,2,1
"13905","9",103,1,2,0,3,227,-2,4,-4,131,-98,3,4,1,0,96,96,1,-8
"13906","9",173,5,4,0,3,231,13,0,0,133,11,0,0,1,-4,98,2,0,0
"13907","9",17,1,3,1,0,61,30,-1,-4,133,94,-1,-4,1,0,-72,-64,0,0
"13908","9",343,4,2,0,2,-72,-1,-1,-1,-67,3,0,-1,1,-3,-5,-4,-1,0
"13909","9",120,4,3,1,1,-102,-56,-1,-1,-35,-114,-1,-1,1,-3,-67,58,0,0
"13910","9",34,2,4,0,2,-149,127,-3,-3,-124,132,-3,-3,1,-1,-25,-5,0,0
"13911","9",336,2,4,1,3,-197,134,3,-3,189,120,3,-2,1,-1,-386,14,0,-1
"13912","9",235,6,3,1,0,34,2,1,1,51,51,1,1,1,-5,-17,-49,0,0
"13913","9",183,2,4,0,1,-176,-38,1,-3,44,118,1,-2,1,-1,-220,-156,0,-1
"13914","9",18,2,3,0,1,-38,-212,1,-3,83,25,0,-2,1,-1,-121,-237,1,-1
"13915","9",155,5,2,0,1,-85,0,0,0,0,-4,0,0,1,-4,-85,4,0,0
"13916","9",450,7,4,1,3,213,-1,0,2,1,179,1,2,1,-6,212,-180,-1,0
"13917","9",374,4,4,1,2,-82,-21,-1,-1,41,13,1,1,1,-3,-123,-34,-2,-2
"13918","9",298,1,1,0,0,-248,-3,-1,-4,4,-247,1,1,1,0,-252,244,-2,-5
"13919","9",220,1,4,1,2,-225,122,-4,-4,99,120,-2,-2,1,0,-324,2,-2,-2
"13920","9",217,2,4,1,2,-30,20,-1,-3,-40,25,-1,-3,1,-1,10,-5,0,0
"13921","9",436,4,4,1,3,0,-117,4,-1,47,119,1,-1,1,-3,-47,-236,3,0
"13922","9",432,5,2,0,1,17,-14,0,0,31,-38,0,0,1,-4,-14,24,0,0
"13923","9",429,1,2,0,0,-225,-197,-4,-4,-203,-196,-4,-4,1,0,-22,-1,0,0
"13924","9",206,3,4,1,0,88,73,-3,-2,100,37,-2,2,1,-2,-12,36,-1,-4
"13925","9",202,4,1,0,1,-80,25,1,-1,26,83,-2,-1,1,-3,-106,-58,3,0
"13926","9",352,4,2,0,1,13,-114,0,-1,6,-53,0,-1,1,-3,7,-61,0,0
"13927","9",276,6,4,0,3,110,14,3,1,42,-114,1,1,1,-5,68,128,2,0
"13928","9",66,1,1,0,1,-241,1,-1,-4,220,0,1,0,1,0,-461,1,-2,-4
"13929","9",122,1,1,1,0,-247,-248,-4,-4,221,216,4,4,1,0,-468,-464,-8,-8
"13930","9",216,4,3,1,1,-82,-61,1,-1,77,-49,1,-1,1,-3,-159,-12,0,0
"13931","9",265,9,1,0,3,162,2,3,4,-6,-7,0,0,1,-8,168,9,3,4
"13932","9",189,3,1,0,1,-194,19,2,-2,-213,41,3,-2,1,-2,19,-22,-1,0
"13933","9",185,1,4,1,2,-149,-9,-4,-4,20,-13,-2,1,1,0,-169,4,-2,-5
"13934","9",108,8,2,0,3,234,35,3,3,236,38,4,4,1,-7,-2,-3,-1,-1
"13935","9",104,1,1,0,0,-233,-2,-4,-4,233,1,1,-3,1,0,-466,-3,-5,-1
"13936","9",254,6,2,0,3,208,-21,3,1,43,-22,1,0,1,-5,165,1,2,1
"13937","9",250,6,1,0,3,93,26,1,1,76,19,1,1,1,-5,17,7,0,0
"13938","9",247,4,3,0,0,-165,-6,-1,-1,73,-8,0,0,1,-3,-238,2,-1,-1
"13939","9",243,3,2,0,2,-249,-48,-3,-2,-244,-73,-4,-1,1,-2,-5,25,1,-1
"13940","9",340,4,1,0,1,-95,-20,0,-1,98,17,0,0,1,-3,-193,-37,0,-1
"13941","9",24,1,2,0,2,-248,246,0,-4,249,-1,4,4,1,0,-497,247,-4,-8
"13942","9",236,5,1,0,1,-16,-17,0,0,-17,-7,0,0,1,-4,1,-10,0,0
"13943","9",386,1,1,0,0,-238,206,-4,-4,-13,-14,0,0,1,0,-225,220,-4,-4
"13944","9",309,5,4,1,2,-25,12,0,0,182,185,-1,-2,1,-4,-207,-173,1,2
"13945","9",156,4,2,0,1,-54,-1,-1,-1,-6,-2,0,0,1,-3,-48,1,-1,-1
"13946","9",451,1,1,0,0,-204,-194,-4,-4,-186,-118,-4,-3,1,0,-18,-76,0,-1
"13947","9",375,4,3,1,1,-12,11,-1,-1,-1,1,0,0,1,-3,-11,10,-1,-1
"13948","9",299,7,4,0,1,226,18,2,2,190,-102,0,0,1,-6,36,120,2,2
"13949","9",221,4,4,1,1,5,-4,-1,-1,5,4,0,0,1,-3,0,-8,-1,-1
"13950","9",218,8,4,1,3,-98,182,4,3,-187,226,4,3,1,-7,89,-44,0,0
"13951","9",437,3,1,0,0,-218,4,-2,-2,-223,-1,-3,-3,1,-2,5,5,1,1
"13952","9",433,1,1,0,0,-209,-229,-4,-4,229,230,4,4,1,0,-438,-459,-8,-8
"13953","9",43,1,3,1,0,-248,0,-4,-4,23,2,-1,-3,1,0,-271,-2,-3,-1
"13954","9",207,6,1,0,0,-1,1,-4,1,-3,249,4,4,1,-5,2,-248,-8,-3
"13955","9",203,9,4,1,3,-14,20,4,4,-21,-227,4,4,1,-8,7,247,0,0
"13956","9",353,3,2,0,2,-245,68,-4,-2,238,139,-4,0,1,-2,-483,-71,0,-2
"13957","9",277,1,4,1,1,-29,-2,4,-4,18,-90,3,-4,1,0,-47,88,1,0
"13958","9",67,5,1,0,0,-20,24,-3,0,116,-123,1,2,1,-4,-136,147,-4,-2
"13959","9",123,2,4,1,2,-196,38,-3,-3,-193,35,-3,-3,1,-1,-3,3,0,0
"13960","9",419,4,4,1,3,22,28,-2,-1,17,106,0,-1,1,-3,5,-78,-2,0
"13961","9",266,4,1,1,1,-108,-1,-1,-1,-154,-2,-2,0,1,-3,46,1,1,-1
"13962","9",19,3,2,0,2,-192,-135,1,-2,-108,-92,1,-1,1,-2,-84,-43,0,-1
"13963","9",186,5,2,0,2,-5,7,0,0,12,14,0,0,1,-4,-17,-7,0,0
"13964","9",109,1,1,0,1,10,-231,3,-4,-46,1,-4,-4,1,0,56,-232,7,0
"13965","9",105,1,1,0,0,-229,32,-4,-4,228,85,2,0,1,0,-457,-53,-6,-4
"13966","9",255,5,3,1,1,-64,-58,0,0,-156,-57,0,0,1,-4,92,-1,0,0
"13967","9",251,5,3,1,1,1,-242,4,0,1,6,4,3,1,-4,0,-248,0,-3
"13968","9",248,5,4,0,3,9,3,0,0,38,59,0,0,1,-4,-29,-56,0,0
"13969","9",244,1,4,1,2,-125,-188,-1,-4,231,230,4,4,1,0,-356,-418,-5,-8
"13970","9",418,3,2,0,2,-218,87,-3,-2,-212,-145,2,-2,1,-2,-6,232,-5,0
"13971","9",240,1,2,1,1,-138,-185,-2,-4,159,62,2,-2,1,0,-297,-247,-4,-2
"13972","9",237,4,2,0,2,-248,1,-2,-1,83,1,-2,0,1,-3,-331,0,0,-1
"13973","9",387,1,3,1,1,-195,-180,-4,-4,110,139,2,1,1,0,-305,-319,-6,-5
"13974","9",31,1,1,0,0,-167,-66,-4,-4,-109,-61,-4,-4,1,0,-58,-5,0,0
"13975","9",157,1,3,1,2,-50,-155,-4,-4,135,97,-2,0,1,0,-185,-252,-2,-4
"13976","9",452,3,3,1,1,-233,3,-4,-2,-26,9,0,0,1,-2,-207,-6,-4,-2
"13977","9",376,4,4,1,1,6,-156,-1,-1,74,-165,1,-1,1,-3,-68,9,-2,0
"13978","9",3,1,3,0,0,-2,3,-4,-4,246,246,4,4,1,0,-248,-243,-8,-8
"13979","9",222,1,1,0,0,-246,2,-4,-4,-239,-11,-4,-4,1,0,-7,13,0,0
"13980","9",219,5,4,1,3,249,3,4,0,248,2,1,0,1,-4,1,1,3,0
"13981","9",438,5,4,1,3,8,-11,4,0,23,-1,4,0,1,-4,-15,-10,0,0
"13982","9",434,7,4,0,3,27,-70,2,2,-72,-64,1,2,1,-6,99,-6,1,0
"13983","9",430,5,2,0,1,37,-20,0,0,33,-33,1,1,1,-4,4,13,-1,-1
"13984","9",208,4,4,1,2,-124,-118,-1,-1,94,92,-4,1,1,-3,-218,-210,3,-2
"13985","9",204,5,3,0,1,-46,-58,0,0,69,-74,0,0,1,-4,-115,16,0,0
"13986","9",354,3,1,0,0,-235,187,1,-2,126,170,2,3,1,-2,-361,17,-1,-5
"13987","9",278,1,4,1,1,-242,-242,4,-4,-1,-229,4,-4,1,0,-241,-13,0,0
"13988","9",68,2,4,1,0,3,6,-3,-3,197,10,-2,-2,1,-1,-194,-4,-1,-1
"13989","9",124,6,1,0,3,75,-250,0,1,248,0,1,2,1,-5,-173,-250,-1,-1
"13990","9",42,3,3,0,1,-55,-16,-1,-2,-39,12,1,-2,1,-2,-16,-28,-2,0
"13991","9",267,5,3,1,1,52,0,0,0,52,0,1,1,1,-4,0,0,-1,-1
"13992","9",190,7,4,1,3,211,178,2,2,249,192,2,2,1,-6,-38,-14,0,0
"13993","9",187,3,4,1,2,-189,-25,-2,-2,-103,29,-1,-1,1,-2,-86,-54,-1,-1
"13994","9",11,4,4,1,1,-12,-8,0,-1,10,-7,-2,-1,1,-3,-22,-1,2,0
"13995","9",106,3,2,1,1,-85,-40,-2,-2,-196,-138,-1,-1,1,-2,111,98,-1,-1
"13996","9",256,5,3,1,1,55,3,0,0,129,92,2,1,1,-4,-74,-89,-2,-1
"13997","9",252,4,4,0,1,-30,-119,0,-1,-113,-148,0,0,1,-3,83,29,0,-1
"13998","9",249,1,3,1,0,-51,-43,-4,-4,35,-38,1,-4,1,0,-86,-5,-5,0
"13999","9",245,1,1,0,0,-241,63,-4,-4,-241,-5,-4,-4,1,0,0,68,0,0
"14000","9",321,1,1,0,0,-207,-186,-4,-4,-215,-204,-3,-3,1,0,8,18,-1,-1
"14001","9",241,5,4,1,2,129,39,1,0,199,175,2,0,1,-4,-70,-136,-1,0
"14002","9",238,1,3,1,1,-44,-32,-4,-4,151,72,2,2,1,0,-195,-104,-6,-6
"14003","9",388,5,4,1,0,-9,239,0,0,-234,4,1,-1,1,-4,225,235,-1,1
"14004","9",310,1,4,1,2,-174,-3,-4,-4,140,-1,3,-2,1,0,-314,-2,-7,-2
"14005","9",158,1,3,0,0,-240,-13,-4,-4,-226,-26,-4,-4,1,0,-14,13,0,0
"14006","9",453,3,4,1,2,1,0,1,-2,-6,-164,1,1,1,-2,7,164,0,-3
"14007","9",377,1,1,0,0,-245,9,-4,-4,-243,7,-4,-4,1,0,-2,2,0,0
"14008","9",30,1,2,1,2,0,0,4,-4,-130,-12,-4,-4,1,0,130,12,8,0
"14009","9",223,5,1,0,1,0,-1,0,0,-1,1,0,0,1,-4,1,-2,0,0
"14010","9",22,4,3,1,1,-21,8,-1,-1,-125,2,-1,-1,1,-3,104,6,0,0
"14011","9",439,5,2,0,1,0,1,0,0,0,3,0,0,1,-4,0,-2,0,0
"14012","9",435,6,4,0,1,-4,-110,0,1,-163,-8,-2,-1,1,-5,159,-102,2,2
"14013","9",431,3,3,1,0,-39,2,-2,-2,32,37,-1,-1,1,-2,-71,-35,-1,-1
"14014","9",209,7,4,1,3,147,24,1,2,213,6,2,1,1,-6,-66,18,-1,1
"14015","9",205,7,1,0,2,249,1,1,2,234,4,3,3,1,-6,15,-3,-2,-1
"14016","9",355,1,2,0,2,-222,125,-4,-4,-200,139,-4,-4,1,0,-22,-14,0,0
"14017","9",279,6,4,1,3,-114,-21,3,1,-82,-23,2,1,1,-5,-32,2,1,0
"14018","9",69,5,4,1,1,-47,135,0,0,-90,33,-1,-3,1,-4,43,102,1,3
"14019","9",125,5,4,1,0,-175,-31,-1,0,-178,-31,-3,-1,1,-4,3,0,2,1
"14020","9",420,3,4,0,3,-106,1,-1,-2,3,0,0,2,1,-2,-109,1,-1,-4
"14021","9",268,8,4,0,3,161,67,3,3,86,-104,2,2,1,-7,75,171,1,1
"14022","9",191,3,1,0,0,-186,-30,-2,-2,-189,-45,-2,-3,1,-2,3,15,0,1
"14023","9",188,8,2,0,3,210,6,3,3,127,1,2,2,1,-7,83,5,1,1
"14024","9",110,7,1,0,1,-127,92,-4,2,133,-103,-3,2,1,-6,-260,195,-1,0
"14025","9",107,3,2,1,3,121,99,2,-2,106,-100,2,1,1,-2,15,199,0,-3
"14026","9",257,1,1,0,0,-248,-9,3,-4,-225,46,2,-2,1,0,-23,-55,1,-2
"14027","9",253,9,3,1,3,228,234,4,4,239,245,4,4,1,-8,-11,-11,0,0
"14028","9",25,1,4,1,2,-104,-119,-4,-4,-90,-105,-4,-4,1,0,-14,-14,0,0
"14029","9",246,7,4,1,3,11,3,3,2,0,-98,3,3,1,-6,11,101,0,-1
"14030","9",322,5,4,1,3,-11,12,0,0,170,-162,2,2,1,-4,-181,174,-2,-2
"14031","9",242,3,4,0,2,-25,-1,0,-2,28,-1,1,-2,1,-2,-53,0,-1,0
"14032","9",239,1,1,1,1,-221,-175,-4,-4,-85,5,-1,-1,1,0,-136,-180,-3,-3
"14033","9",389,4,3,1,2,-138,-1,-1,-1,-192,-102,3,-2,1,-3,54,101,-4,1
"14034","9",311,1,2,0,2,184,19,-4,-4,195,22,4,-2,1,0,-11,-3,-8,-2
"14035","9",159,1,3,1,2,-229,3,-4,-4,247,-7,3,4,1,0,-476,10,-7,-8
"14036","9",454,8,4,0,3,250,4,3,3,247,1,3,3,1,-7,3,3,0,0
"14037","9",378,4,4,1,1,-122,0,-1,-1,-106,8,-1,-1,1,-3,-16,-8,0,0
"14038","9",300,2,1,0,0,-191,65,-2,-3,43,49,1,1,1,-1,-234,16,-3,-4
"14039","9",224,2,2,0,2,-82,-35,-3,-3,177,56,2,1,1,-1,-259,-91,-5,-4
"14040","9",91,2,2,0,3,-63,-8,-3,-3,152,-3,1,2,1,-1,-215,-5,-4,-5
"14041","9",88,1,4,1,2,-239,-17,-4,-4,213,-200,4,4,1,0,-452,183,-8,-8
"14042","9",363,8,3,1,3,0,0,3,3,249,1,3,3,1,-7,-249,-1,0,0
"14043","9",290,2,1,0,1,-165,62,-2,-3,80,-44,0,0,1,-1,-245,106,-2,-3
"14044","9",287,6,4,0,3,200,-3,2,1,-60,-14,3,2,1,-5,260,11,-1,-1
"14045","9",77,4,3,0,1,-93,4,-1,-1,-132,-3,-1,-1,1,-3,39,7,0,0
"14046","9",356,6,4,1,1,72,4,1,1,36,9,1,0,1,-5,36,-5,0,1
"14047","9",28,5,4,1,1,-107,157,1,0,-125,146,-1,-2,1,-4,18,11,2,2
"14048","9",7,6,1,1,3,65,98,1,1,40,87,1,2,1,-5,25,11,0,-1
"14049","9",126,1,2,0,2,-194,-125,-4,-4,-33,-29,-4,-4,1,0,-161,-96,0,0
"14050","9",421,4,3,1,1,-74,19,0,-1,24,22,0,0,1,-3,-98,-3,0,-1
"14051","9",269,2,4,0,2,-248,124,0,-3,-250,152,0,-3,1,-1,2,-28,0,0
"14052","9",192,4,4,1,1,94,0,-1,-1,129,4,1,1,1,-3,-35,-4,-2,-2
"14053","9",59,3,1,0,0,-25,12,-2,-2,-67,-44,1,-1,1,-2,42,56,-3,-1
"14054","9",55,6,4,0,1,-22,-7,1,1,5,-4,0,0,1,-5,-27,-3,1,1
"14055","9",407,2,2,0,2,-242,-58,-3,-3,155,65,2,2,1,-1,-397,-123,-5,-5
"14056","9",258,3,3,0,0,20,3,1,-2,92,6,2,-2,1,-2,-72,-3,-1,0
"14057","9",48,1,3,1,0,5,-5,-4,-4,83,-76,-4,-4,1,0,-78,71,0,0
"14058","9",473,4,3,1,0,-209,-15,-1,-1,-187,-33,-2,-2,1,-3,-22,18,1,1
"14059","9",397,8,4,1,3,100,-2,3,3,159,-151,3,3,1,-7,-59,149,0,0
"14060","9",323,1,4,1,1,-2,-190,-1,-4,224,4,4,-4,1,0,-226,-194,-5,0
"14061","9",32,5,1,0,1,3,0,0,0,175,-191,1,-4,1,-4,-172,191,-1,4
"14062","9",462,9,3,1,3,230,121,4,4,199,205,4,4,1,-8,31,-84,0,0
"14063","9",39,1,3,1,1,-39,11,-4,-4,32,-17,0,-2,1,0,-71,28,-4,-2
"14064","9",312,5,4,1,1,-58,91,0,0,15,101,0,0,1,-4,-73,-10,0,0
"14065","9",16,1,1,0,0,-228,21,-2,-4,76,10,2,-2,1,0,-304,11,-4,-2
"14066","9",455,2,2,1,2,233,4,-3,-3,-249,8,-3,-3,1,-1,482,-4,0,0
"14067","9",379,1,3,0,1,-69,-116,2,-4,-60,-117,0,0,1,0,-9,1,2,-4
"14068","9",301,7,4,0,1,76,-2,2,2,67,-1,2,3,1,-6,9,-1,0,-1
"14069","9",225,6,2,0,2,-38,-63,-1,1,-116,-138,0,-1,1,-5,78,75,-1,2
"14070","9",92,4,4,1,2,-187,-162,-1,-1,-154,-179,-1,-1,1,-3,-33,17,0,0
"14071","9",89,1,3,1,0,-245,3,-4,-4,-243,3,-4,-4,1,0,-2,0,0,0
"14072","9",364,5,3,1,1,-52,0,0,0,-4,-5,-1,-1,1,-4,-48,5,1,1
"14073","9",291,2,4,1,2,-16,26,-3,-3,55,-2,-3,-3,1,-1,-71,28,0,0
"14074","9",288,2,2,1,2,-108,-1,-2,-3,21,2,-1,0,1,-1,-129,-3,-1,-3
"14075","9",78,2,4,0,0,-199,0,-2,-3,-203,-9,-3,-3,1,-1,4,9,1,0
"14076","9",357,1,4,1,2,-206,-18,-4,-4,137,118,-4,-4,1,0,-343,-136,0,0
"14077","9",280,4,2,0,1,-238,-235,-4,-1,238,-234,4,3,1,-3,-476,-1,-8,-4
"14078","9",70,1,2,0,2,-238,-222,4,-4,-34,95,-3,-4,1,0,-204,-317,7,0
"14079","9",127,1,1,1,0,-215,3,-4,-4,-2,-1,2,-3,1,0,-213,4,-6,-1
"14080","9",422,5,3,1,1,-59,-180,4,0,-76,-184,4,-3,1,-4,17,4,0,3
"14081","9",27,3,2,0,2,-157,47,-2,-2,-98,45,-1,-2,1,-2,-59,2,-1,0
"14082","9",193,1,1,0,0,-237,-27,-3,-4,198,137,1,1,1,0,-435,-164,-4,-5
"14083","9",6,9,4,0,2,248,1,4,4,237,73,4,4,1,-8,11,-72,0,0
"14084","9",56,4,3,1,1,44,-122,-2,-1,40,-121,-2,-1,1,-3,4,-1,0,0
"14085","9",408,1,1,0,0,-229,3,-3,-4,-200,-9,0,0,1,0,-29,12,-3,-4
"14086","9",259,1,3,0,1,-132,70,4,-4,22,-1,4,-4,1,0,-154,71,0,0
"14087","9",49,7,4,1,1,149,46,2,2,161,55,2,2,1,-6,-12,-9,0,0
"14088","9",474,1,1,0,0,2,-67,0,-4,4,-63,0,-4,1,0,-2,-4,0,0
"14089","9",398,2,4,0,2,-169,-157,-3,-3,-153,-119,-3,-3,1,-1,-16,-38,0,0
"14090","9",324,1,2,0,0,-191,-141,-4,-4,-212,-2,-4,-4,1,0,21,-139,0,0
"14091","9",320,1,2,0,2,-248,124,-4,-4,-248,127,-4,-4,1,0,0,-3,0,0
"14092","9",463,8,4,0,3,-244,-2,0,3,248,-3,1,-2,1,-7,-492,1,-1,5
"14093","9",390,1,2,0,2,-191,223,-4,-4,46,-7,0,0,1,0,-237,230,-4,-4
"14094","9",313,2,3,1,0,-217,-198,-3,-3,-216,-199,-3,-3,1,-1,-1,1,0,0
"14095","9",160,7,2,0,0,-189,-2,-4,2,-31,-2,-4,2,1,-6,-158,0,0,0
"14096","9",456,1,1,0,0,-127,-165,-2,-4,123,-42,1,-2,1,0,-250,-123,-3,-2
"14097","9",38,5,4,1,3,4,-18,0,0,-5,-92,0,0,1,-4,9,74,0,0
"14098","9",302,3,1,0,0,-126,-32,-3,-2,210,48,-2,-2,1,-2,-336,-80,-1,0
"14099","9",226,1,1,1,0,-148,1,-2,-4,240,0,3,-4,1,0,-388,1,-5,0
"14100","9",93,5,1,0,1,-122,89,-2,0,-93,65,-2,0,1,-4,-29,24,0,0
"14101","9",9,3,4,1,2,-103,51,-1,-2,30,46,1,-1,1,-2,-133,5,-2,-1
"14102","9",365,5,3,1,1,-42,5,0,0,-79,6,0,-4,1,-4,37,-1,0,4
"14103","9",292,9,3,1,1,-5,-8,4,4,-56,2,-1,-1,1,-8,51,-10,5,5
"14104","9",289,8,1,0,3,233,240,3,3,196,195,3,3,1,-7,37,45,0,0
"14105","9",79,1,4,1,2,-234,-20,-2,-4,-236,-11,-4,-4,1,0,2,-9,2,0
"14106","9",358,1,4,0,2,-244,231,-4,-4,-244,198,-4,-4,1,0,0,33,0,0
"14107","9",281,1,4,1,2,-249,-6,-4,-4,-244,4,-4,-4,1,0,-5,-10,0,0
"14108","9",71,4,3,1,1,-131,21,-1,-1,25,18,-1,0,1,-3,-156,3,0,-1
"14109","9",128,6,1,0,3,142,1,1,1,142,1,1,1,1,-5,0,0,0,0
"14110","9",423,3,1,0,3,110,-27,2,-2,-191,-50,3,3,1,-2,301,23,-1,-5
"14111","9",270,5,3,1,1,1,57,1,0,66,1,2,1,1,-4,-65,56,-1,-1
"14112","9",194,9,1,0,0,-228,-83,-4,4,-232,-83,-4,4,1,-8,4,0,0,0
"14113","9",60,8,1,0,3,2,124,3,3,-1,-133,4,3,1,-7,3,257,-1,0
"14114","9",57,1,4,1,1,-47,-234,-2,-4,-25,-205,-3,-4,1,0,-22,-29,1,0
"14115","9",409,2,4,0,2,-164,-95,3,-3,106,111,2,2,1,-1,-270,-206,1,-5
"14116","9",26,1,1,0,0,-242,-172,-4,-4,-173,-72,-3,-4,1,0,-69,-100,-1,0
"14117","9",5,1,2,0,2,-235,227,-2,-4,-218,177,-3,-4,1,0,-17,50,1,0
"14118","9",475,5,3,0,3,-64,56,-2,0,-123,-173,-2,-2,1,-4,59,229,0,2
"14119","9",399,6,4,1,3,-99,8,1,1,-100,17,-1,-1,1,-5,1,-9,2,2
"14120","9",325,9,1,0,1,-86,-117,-3,4,-62,-56,-2,4,1,-8,-24,-61,-1,0
"14121","9",468,6,1,0,3,106,-119,3,1,69,63,1,0,1,-5,37,-182,2,1
"14122","9",464,6,1,0,1,-21,27,1,1,19,5,1,1,1,-5,-40,22,0,0
"14123","9",391,5,2,1,3,134,137,0,0,151,-160,-1,0,1,-4,-17,297,1,0
"14124","9",314,1,4,0,1,-243,8,4,-4,-243,7,4,-4,1,0,0,1,0,0
"14125","9",161,1,2,0,2,-242,183,-4,-4,47,23,0,-4,1,0,-289,160,-4,0
"14126","9",457,5,3,0,1,136,102,0,0,6,-204,1,0,1,-4,130,306,-1,0
"14127","9",380,3,4,0,1,-62,-142,3,-2,-138,-129,3,-3,1,-2,76,-13,0,1
"14128","9",303,1,3,1,2,-187,-208,-4,-4,-179,-181,-3,-3,1,0,-8,-27,-1,-1
"14129","9",227,8,3,0,3,64,-10,2,3,129,27,2,2,1,-7,-65,-37,0,1
"14130","9",94,1,4,1,1,-239,-234,-4,-4,236,-236,0,4,1,0,-475,2,-4,-8
"14131","9",90,2,4,1,0,-241,13,-3,-3,-239,7,-4,-4,1,-1,-2,6,1,1
"14132","9",366,9,4,1,3,175,-43,3,4,80,-64,2,1,1,-8,95,21,1,3
"14133","9",293,1,4,1,0,-217,25,-4,-4,-239,11,-4,-4,1,0,22,14,0,0
"14134","9",29,1,4,1,0,-248,244,-4,-4,-208,195,-4,-4,1,0,-40,49,0,0
"14135","9",8,7,3,1,1,228,-20,-2,2,210,149,-2,2,1,-6,18,-169,0,0
"14136","9",359,1,4,1,3,-88,-126,1,-4,207,37,4,-3,1,0,-295,-163,-3,-1
"14137","9",282,9,3,0,3,25,-133,1,4,193,72,1,4,1,-8,-168,-205,0,0
"14138","9",72,2,1,0,0,-78,17,-2,-3,203,207,3,3,1,-1,-281,-190,-5,-6
"14139","9",129,6,4,1,1,33,3,2,1,33,1,2,0,1,-5,0,2,0,1
"14140","9",424,3,2,0,2,-100,-68,-2,-2,35,7,1,-1,1,-2,-135,-75,-3,-1
"14141","9",271,2,3,1,1,128,0,-1,-3,169,0,3,1,1,-1,-41,0,-4,-4
"14142","9",195,1,1,0,1,-226,234,4,-4,19,-27,2,0,1,0,-245,261,2,-4
"14143","9",61,1,1,0,3,233,4,4,-4,-214,-161,4,-4,1,0,447,165,0,0
"14144","9",58,6,4,1,1,-242,0,-3,1,-3,247,4,3,1,-5,-239,-247,-7,-2
"14145","9",41,6,2,0,3,11,84,3,1,25,79,3,1,1,-5,-14,5,0,0
"14146","9",260,2,3,1,0,-245,-246,-3,-3,-235,-231,-3,-3,1,-1,-10,-15,0,0
"14147","9",50,3,2,0,1,-44,0,0,-2,38,-126,1,-2,1,-2,-82,126,-1,0
"14148","9",476,4,3,1,0,-179,-173,0,-1,-53,-199,1,1,1,-3,-126,26,-1,-2
"14149","9",4,3,3,0,1,-61,-2,-1,-2,164,1,3,3,1,-2,-225,-3,-4,-5
"14150","9",326,3,4,1,2,-196,-163,-2,-2,-153,-117,-2,-2,1,-2,-43,-46,0,0
"14151","9",469,1,4,1,0,-143,79,-3,-4,35,6,-4,-4,1,0,-178,73,1,0
"14152","9",465,8,4,0,3,7,-239,3,3,43,-228,3,2,1,-7,-36,-11,0,1
"14153","9",392,3,1,0,0,-161,127,-2,-2,-162,100,-2,-3,1,-2,1,27,0,1
"14154","9",315,3,3,1,3,235,11,4,-2,238,18,4,4,1,-2,-3,-7,0,-6
"14155","9",162,9,3,0,3,245,-20,4,4,207,115,4,4,1,-8,38,-135,0,0
"14156","9",458,2,1,0,1,-63,-69,0,-3,75,80,-1,-2,1,-1,-138,-149,1,-1
"14157","9",381,1,2,0,2,-241,216,-4,-4,5,-4,0,0,1,0,-246,220,-4,-4
"14158","9",304,3,2,0,2,1,-8,2,-2,54,-84,0,0,1,-2,-53,76,2,-2
"14159","9",228,1,4,1,2,-75,-99,-4,-4,106,-193,0,0,1,0,-181,94,-4,-4
"14160","9",95,1,4,1,2,-246,4,-4,-4,-245,0,-4,-4,1,0,-1,4,0,0
"14161","9",370,9,1,0,3,241,-13,4,4,-238,-16,-4,-4,1,-8,479,3,8,8
"14162","9",367,5,3,0,1,-169,-148,1,0,-126,-94,2,-1,1,-4,-43,-54,-1,1
"14163","9",294,5,1,0,3,-1,1,0,0,-1,1,0,0,1,-4,0,0,0,0
"14164","9",84,7,4,0,3,148,2,2,2,-102,2,3,-1,1,-6,250,0,-1,3
"14165","9",80,8,4,1,3,206,2,3,3,227,-4,3,-3,1,-7,-21,6,0,6
"14166","9",36,8,3,1,3,-193,210,3,3,204,222,4,4,1,-7,-397,-12,-1,-1
"14167","9",283,4,1,1,1,-103,53,-3,-1,-116,-104,-1,0,1,-3,13,157,-2,-1
"14168","9",73,7,4,0,2,-109,130,1,2,-62,73,-4,-4,1,-6,-47,57,5,6
"14169","9",13,1,4,0,1,-119,-72,1,-4,-106,56,2,-3,1,0,-13,-128,-1,-1
"14170","9",425,4,4,1,2,-79,-62,-1,-1,-37,-139,0,0,1,-3,-42,77,-1,-1
"14171","9",272,3,4,1,2,1,0,-1,-2,13,14,-1,-2,1,-2,-12,-14,0,0
"14172","9",196,2,3,1,0,-177,-38,-3,-3,189,224,2,-1,1,-1,-366,-262,-5,-2
"14173","9",62,9,2,0,3,229,212,4,4,234,228,4,4,1,-8,-5,-16,0,0
"14174","9",414,2,1,1,0,-121,-113,-3,-3,-109,-89,-1,-1,1,-1,-12,-24,-2,-2
"14175","9",410,1,1,0,0,-48,-23,0,-4,200,24,1,-1,1,0,-248,-47,-1,-3
"14176","9",261,9,1,0,3,134,125,4,4,85,-94,4,4,1,-8,49,219,0,0
"14177","9",51,5,4,1,1,69,0,1,0,78,30,2,1,1,-4,-9,-30,-1,-1
"14178","9",403,2,1,0,0,-224,-11,1,-3,-166,-90,1,-1,1,-1,-58,79,0,-2
"14179","9",40,1,1,0,2,-185,170,-4,-4,188,189,-4,3,1,0,-373,-19,0,-7
"14180","9",327,6,4,0,3,32,-143,3,1,20,-118,1,-1,1,-5,12,-25,2,2
"14181","9",47,7,4,1,3,196,0,1,2,47,1,0,1,1,-6,149,-1,1,1
"14182","9",466,2,3,0,0,-93,-33,-2,-3,-99,-78,-2,-2,1,-1,6,45,0,-1
"14183","9",393,1,1,0,0,-246,-1,-4,-4,-92,-34,-4,-4,1,0,-154,33,0,0
"14184","9",316,2,3,1,0,-189,-145,-3,-3,-170,-108,-3,-3,1,-1,-19,-37,0,0
"14185","9",163,4,3,1,1,131,-56,1,-1,37,65,1,1,1,-3,94,-121,0,-2
"14186","9",459,1,3,0,1,-146,-209,3,-4,-47,-184,3,-4,1,0,-99,-25,0,0
"14187","9",382,4,4,1,2,-26,-3,-1,-1,20,0,0,0,1,-3,-46,-3,-1,-1
"14188","9",305,5,4,1,3,51,33,3,0,25,35,1,1,1,-4,26,-2,2,-1
"14189","9",229,6,1,0,1,-43,-100,-1,1,-128,141,-2,-2,1,-5,85,-241,1,3
"14190","9",96,2,1,0,0,-213,-27,-3,-3,-148,-34,-2,-2,1,-1,-65,7,-1,-1
"14191","9",371,2,3,0,0,-233,-122,-3,-3,0,-158,-2,-2,1,-1,-233,36,-1,-1
"14192","9",368,9,3,1,3,-146,150,4,4,-152,93,4,4,1,-8,6,57,0,0
"14193","9",295,5,1,0,1,-9,4,0,0,-9,0,0,0,1,-4,0,4,0,0
"14194","9",85,2,2,0,2,-135,-102,-2,-3,124,-100,1,0,1,-1,-259,-2,-3,-3
"14195","9",81,8,1,0,0,-209,75,4,3,-174,210,4,1,1,-7,-35,-135,0,2
"14196","9",360,1,3,1,0,-221,-125,-3,-4,31,-1,0,-4,1,0,-252,-124,-3,0
"14197","9",284,2,3,1,1,-162,-80,-4,-3,-205,-144,-4,-4,1,-1,43,64,0,1
"14198","9",74,1,3,0,0,-243,-82,-4,-4,120,93,2,0,1,0,-363,-175,-6,-4
"14199","9",130,9,1,0,3,34,74,4,4,104,-46,4,4,1,-8,-70,120,0,0
"14200","9",426,2,4,1,3,-249,5,-2,-3,-4,-239,4,1,1,-1,-245,244,-6,-4
"14201","9",273,3,1,0,0,238,7,-1,-2,1,1,1,1,1,-2,237,6,-2,-3
"14202","9",197,9,4,0,3,158,-67,-1,4,97,-78,2,4,1,-8,61,11,-3,0
"14203","9",63,5,4,0,1,1,1,0,0,-1,-3,-1,-1,1,-4,2,4,1,1
"14204","9",415,1,2,0,2,-214,-208,0,-4,114,197,0,3,1,0,-328,-405,0,-7
"14205","9",411,1,2,0,2,-5,-245,-4,-4,-227,-223,-4,-4,1,0,222,-22,0,0
"14206","9",262,6,4,1,3,157,17,2,1,143,38,1,0,1,-5,14,-21,1,1
"14207","9",52,3,3,0,0,-199,4,1,-2,-83,1,1,-2,1,-2,-116,3,0,0
"14208","9",404,4,1,0,1,55,-52,-1,-1,39,-42,1,0,1,-3,16,-10,-2,-1
"14209","9",400,5,4,1,2,-115,79,-4,0,88,-107,-2,-2,1,-4,-203,186,-2,2
"14210","9",328,4,3,1,1,-31,12,-1,-1,6,8,1,1,1,-3,-37,4,-2,-2
"14211","9",470,4,1,0,1,-55,30,-1,-1,-80,37,-1,-1,1,-3,25,-7,0,0
"14212","9",467,5,1,0,3,-118,-189,4,0,138,160,4,0,1,-4,-256,-349,0,0
"14213","9",394,1,3,1,0,-250,247,-4,-4,-247,243,-4,-4,1,0,-3,4,0,0
"14214","9",317,1,4,0,2,-172,177,-4,-4,-194,187,-4,-4,1,0,22,-10,0,0
"14215","9",164,5,2,0,2,-1,1,0,0,-57,-3,-1,-1,1,-4,56,4,1,1
"14216","9",46,1,1,0,0,-28,-209,2,-4,-1,-241,-1,-2,1,0,-27,32,3,-2
"14217","9",383,5,4,1,1,-1,1,0,0,3,-1,0,0,1,-4,-4,2,0,0
"14218","9",306,5,3,1,3,146,108,1,0,125,150,1,0,1,-4,21,-42,0,0
"14219","9",23,9,1,0,3,212,211,4,4,206,194,4,4,1,-8,6,17,0,0
"14220","9",97,2,1,0,1,-226,28,3,-3,80,17,3,-3,1,-1,-306,11,0,0
"14221","9",372,1,3,0,0,-236,-242,-4,-4,2,1,-4,-4,1,0,-238,-243,0,0
"14222","9",369,3,4,1,0,-171,1,-4,-2,42,-2,0,0,1,-2,-213,3,-4,-2
"14223","9",296,6,1,0,3,4,195,1,1,191,12,3,2,1,-5,-187,183,-2,-1
"14224","9",86,8,4,0,3,164,-2,2,3,159,7,2,3,1,-7,5,-9,0,0
"14225","9",82,1,4,1,2,-18,-42,4,-4,81,-84,-4,-4,1,0,-99,42,8,0
"14226","9",361,1,1,0,0,-249,-6,-4,-4,249,-10,4,4,1,0,-498,4,-8,-8
"14227","9",285,5,2,0,1,-129,142,0,0,-158,163,2,2,1,-4,29,-21,-2,-2
"14228","9",75,3,4,1,2,205,66,2,-2,190,36,1,-2,1,-2,15,30,1,0
"14229","9",131,7,4,0,3,-128,142,0,2,64,24,0,2,1,-6,-192,118,0,0
"14230","9",427,1,4,0,1,-239,-33,4,-4,-243,-31,4,-4,1,0,4,-2,0,0
"14231","9",274,5,4,0,2,-51,52,0,0,-70,38,1,1,1,-4,19,14,-1,-1
"14232","9",198,5,1,0,1,-155,28,-1,0,79,-150,-1,2,1,-4,-234,178,0,-2
"14233","9",64,9,1,0,1,214,-207,4,4,233,-25,4,4,1,-8,-19,-182,0,0
"14234","9",416,1,4,1,0,-227,233,-4,-4,-224,204,-4,4,1,0,-3,29,0,-8
"14235","9",412,9,1,0,0,-246,2,-4,4,242,1,4,4,1,-8,-488,1,-8,0
"14236","9",263,1,4,1,0,-240,-3,-4,-4,-243,3,-4,-4,1,0,3,-6,0,0
"14237","9",53,6,4,1,3,193,0,1,1,219,-1,2,2,1,-5,-26,1,-1,-1
"14238","9",405,3,4,1,1,-135,30,0,-2,84,61,1,-2,1,-2,-219,-31,-1,0
"14239","9",401,4,2,0,1,-86,16,2,-1,53,11,1,0,1,-3,-139,5,1,-1
"14240","9",329,1,4,1,3,110,95,-4,-4,-120,222,-4,3,1,0,230,-127,0,-7
"14241","9",471,5,3,1,2,-18,14,0,0,-82,123,-1,-1,1,-4,64,-109,1,1
"14242","9",1,4,1,0,1,-222,-231,-4,-1,-153,-124,0,0,1,-3,-69,-107,-4,-1
"14243","9",395,6,3,1,1,-190,25,-2,1,95,18,-2,3,1,-5,-285,7,0,-2
"14244","9",318,1,2,0,2,-191,-181,-4,-4,188,196,-4,0,1,0,-379,-377,0,-4
"14245","9",165,2,1,0,1,-112,5,-3,-3,117,13,0,1,1,-1,-229,-8,-3,-4
"14246","9",460,2,1,0,0,-189,14,-3,-3,116,20,-3,2,1,-1,-305,-6,0,-5
"14247","9",384,1,1,0,0,-249,247,-4,-4,-204,124,-2,-4,1,0,-45,123,-2,0
"14248","9",307,1,4,1,2,-114,204,-4,-4,-212,198,-4,-4,1,0,98,6,0,0
"14249","9",230,4,1,0,0,-245,12,-4,-1,-244,27,-4,-1,1,-3,-1,-15,0,0
"14250","9",98,1,3,0,0,-232,-21,-4,-4,194,-157,2,2,1,0,-426,136,-6,-6
"14251","9",373,1,3,1,0,-232,-232,-2,-4,-190,-236,0,-4,1,0,-42,4,-2,0
"14252","9",37,1,1,0,0,-224,105,-4,-4,-218,29,-4,-4,1,0,-6,76,0,0
"14253","9",297,1,3,1,2,-238,230,-2,-4,-221,26,-1,-4,1,0,-17,204,-1,0
"14254","9",87,8,4,1,3,249,2,1,3,-1,-248,1,1,1,-7,250,250,0,2
"14255","9",83,6,1,0,3,134,-141,1,1,132,-99,2,1,1,-5,2,-42,-1,0
"14256","9",362,3,4,1,3,-105,103,4,-2,-140,152,4,-2,1,-2,35,-49,0,0
"14257","9",286,6,1,0,3,81,-1,2,1,51,4,1,1,1,-5,30,-5,1,0
"14258","9",76,5,4,1,3,7,1,0,0,6,-1,0,0,1,-4,1,2,0,0
"14259","9",132,7,4,1,1,11,-20,0,2,20,111,1,2,1,-6,-9,-131,-1,0
"14260","9",428,1,1,0,0,-238,245,-4,-4,-241,242,-4,-4,1,0,3,3,0,0
"14261","9",275,1,4,0,2,-218,2,-4,-4,-240,-2,-1,-1,1,0,22,4,-3,-3
"14262","9",199,3,4,1,2,-221,27,-2,-2,-142,32,-2,-2,1,-2,-79,-5,0,0
"14263","9",65,7,1,0,3,69,47,2,2,34,29,2,2,1,-6,35,18,0,0
"14264","9",417,5,2,0,2,-220,-233,0,0,227,228,0,0,1,-4,-447,-461,0,0
"14265","9",413,3,1,0,1,-187,4,-2,-2,-199,-14,-2,-2,1,-2,12,18,0,0
"14266","9",264,1,4,1,2,-222,-229,-4,-4,-234,-230,-3,-4,1,0,12,1,-1,0
"14267","9",54,5,4,1,1,-210,12,0,0,171,33,0,0,1,-4,-381,-21,0,0
"14268","9",406,8,2,1,2,-145,-123,2,3,16,-27,2,1,1,-7,-161,-96,0,2
"14269","9",402,1,3,1,0,-227,2,-4,-4,175,-1,3,-1,1,0,-402,3,-7,-3
"14270","9",33,6,3,0,1,28,-28,-1,1,-153,-44,-2,-2,1,-5,181,16,1,3
"14271","9",472,1,1,0,0,-231,237,-4,-4,-245,230,-4,-4,1,0,14,7,0,0
"14272","9",10,5,3,1,1,-205,1,-1,0,-167,-1,1,-2,1,-4,-38,2,-2,2
"14273","9",396,1,1,0,1,-247,245,4,-4,-213,64,4,-4,1,0,-34,181,0,0
"14274","9",319,6,1,0,1,113,1,2,1,72,-73,1,1,1,-5,41,74,1,0
"14275","9",166,1,4,1,2,-109,-45,-1,-4,220,216,1,1,1,0,-329,-261,-2,-5
"14276","9",461,3,4,1,2,-41,22,-2,-2,69,22,-2,-2,1,-2,-110,0,0,0
"14277","9",385,5,4,1,1,-53,32,-1,0,0,4,0,0,1,-4,-53,28,-1,0
"14278","9",308,1,4,0,0,-247,-249,-4,-4,143,162,1,2,1,0,-390,-411,-5,-6
"14279","9",231,6,4,0,0,-240,-1,-4,1,-238,-1,-4,-1,1,-5,-2,0,0,2
"14280","9",99,8,4,1,3,222,-1,3,3,144,-114,3,3,1,-7,78,113,0,0
